,x1,x2,x1_label,x2_label,class_label
0,0,1,5,0,-5
1,1,2,0,4,4
2,2,3,4,1,-3
3,3,4,1,9,8
4,4,5,9,2,-7
5,5,6,2,1,-1
6,6,7,1,3,2
7,7,8,3,1,-2
8,8,9,1,4,3
9,9,10,4,3,-1
10,10,11,3,5,2
11,11,12,5,3,-2
12,12,13,3,6,3
13,13,14,6,1,-5
14,14,15,1,7,6
15,15,16,7,2,-5
16,16,17,2,8,6
17,17,18,8,6,-2
18,18,19,6,9,3
19,19,20,9,4,-5
20,20,21,4,0,-4
21,21,22,0,9,9
22,22,23,9,1,-8
23,23,24,1,1,0
24,24,25,1,2,1
25,25,26,2,4,2
26,26,27,4,3,-1
27,27,28,3,2,-1
28,28,29,2,7,5
29,29,30,7,3,-4
30,30,31,3,8,5
31,31,32,8,6,-2
32,32,33,6,9,3
33,33,34,9,0,-9
34,34,35,0,5,5
35,35,36,5,6,1
36,36,37,6,0,-6
37,37,38,0,7,7
38,38,39,7,6,-1
39,39,40,6,1,-5
40,40,41,1,8,7
41,41,42,8,7,-1
42,42,43,7,9,2
43,43,44,9,3,-6
44,44,45,3,9,6
45,45,46,9,8,-1
46,46,47,8,5,-3
47,47,48,5,9,4
48,48,49,9,3,-6
49,49,50,3,3,0
50,50,51,3,0,-3
51,51,52,0,7,7
52,52,53,7,4,-3
53,53,54,4,9,5
54,54,55,9,8,-1
55,55,56,8,0,-8
56,56,57,0,9,9
57,57,58,9,4,-5
58,58,59,4,1,-3
59,59,60,1,4,3
60,60,61,4,4,0
61,61,62,4,6,2
62,62,63,6,0,-6
63,63,64,0,4,4
64,64,65,4,5,1
65,65,66,5,6,1
66,66,67,6,1,-5
67,67,68,1,0,-1
68,68,69,0,0,0
69,69,70,0,1,1
70,70,71,1,7,6
71,71,72,7,1,-6
72,72,73,1,6,5
73,73,74,6,3,-3
74,74,75,3,0,-3
75,75,76,0,2,2
76,76,77,2,1,-1
77,77,78,1,1,0
78,78,79,1,7,6
79,79,80,7,9,2
80,80,81,9,0,-9
81,81,82,0,2,2
82,82,83,2,6,4
83,83,84,6,7,1
84,84,85,7,8,1
85,85,86,8,3,-5
86,86,87,3,9,6
87,87,88,9,0,-9
88,88,89,0,4,4
89,89,90,4,6,2
90,90,91,6,7,1
91,91,92,7,4,-3
92,92,93,4,6,2
93,93,94,6,8,2
94,94,95,8,0,-8
95,95,96,0,7,7
96,96,97,7,8,1
97,97,98,8,3,-5
98,98,99,3,1,-2
99,99,100,1,5,4
100,100,101,5,7,2
101,101,102,7,1,-6
102,102,103,1,7,6
103,103,104,7,1,-6
104,104,105,1,1,0
105,105,106,1,6,5
106,106,107,6,3,-3
107,107,108,3,0,-3
108,108,109,0,2,2
109,109,110,2,9,7
110,110,111,9,3,-6
111,111,112,3,1,-2
112,112,113,1,1,0
113,113,114,1,0,-1
114,114,115,0,4,4
115,115,116,4,9,5
116,116,117,9,2,-7
117,117,118,2,0,-2
118,118,119,0,0,0
119,119,120,0,2,2
120,120,121,2,0,-2
121,121,122,0,2,2
122,122,123,2,7,5
123,123,124,7,1,-6
124,124,125,1,8,7
125,125,126,8,6,-2
126,126,127,6,4,-2
127,127,128,4,1,-3
128,128,129,1,6,5
129,129,130,6,3,-3
130,130,131,3,4,1
131,131,132,4,5,1
132,132,133,5,9,4
133,133,134,9,1,-8
134,134,135,1,3,2
135,135,136,3,3,0
136,136,137,3,8,5
137,137,138,8,5,-3
138,138,139,5,4,-1
139,139,140,4,7,3
140,140,141,7,7,0
141,141,142,7,4,-3
142,142,143,4,2,-2
143,143,144,2,8,6
144,144,145,8,5,-3
145,145,146,5,8,3
146,146,147,8,6,-2
147,147,148,6,7,1
148,148,149,7,3,-4
149,149,150,3,4,1
150,150,151,4,6,2
151,151,152,6,1,-5
152,152,153,1,9,8
153,153,154,9,9,0
154,154,155,9,6,-3
155,155,156,6,0,-6
156,156,157,0,3,3
157,157,158,3,7,4
158,158,159,7,2,-5
159,159,160,2,8,6
160,160,161,8,2,-6
161,161,162,2,9,7
162,162,163,9,4,-5
163,163,164,4,4,0
164,164,165,4,6,2
165,165,166,6,4,-2
166,166,167,4,9,5
167,167,168,9,7,-2
168,168,169,7,0,-7
169,169,170,0,9,9
170,170,171,9,2,-7
171,171,172,2,9,7
172,172,173,9,5,-4
173,173,174,5,1,-4
174,174,175,1,5,4
175,175,176,5,9,4
176,176,177,9,1,-8
177,177,178,1,2,1
178,178,179,2,3,1
179,179,180,3,2,-1
180,180,181,2,3,1
181,181,182,3,5,2
182,182,183,5,9,4
183,183,184,9,1,-8
184,184,185,1,7,6
185,185,186,7,6,-1
186,186,187,6,2,-4
187,187,188,2,8,6
188,188,189,8,2,-6
189,189,190,2,2,0
190,190,191,2,5,3
191,191,192,5,0,-5
192,192,193,0,7,7
193,193,194,7,4,-3
194,194,195,4,9,5
195,195,196,9,7,-2
196,196,197,7,8,1
197,197,198,8,3,-5
198,198,199,3,2,-1
199,199,200,2,1,-1
200,200,201,1,1,0
201,201,202,1,8,7
202,202,203,8,3,-5
203,203,204,3,6,3
204,204,205,6,1,-5
205,205,206,1,0,-1
206,206,207,0,3,3
207,207,208,3,1,-2
208,208,209,1,0,-1
209,209,210,0,0,0
210,210,211,0,1,1
211,211,212,1,7,6
212,212,213,7,2,-5
213,213,214,2,7,5
214,214,215,7,3,-4
215,215,216,3,0,-3
216,216,217,0,4,4
217,217,218,4,6,2
218,218,219,6,5,-1
219,219,220,5,2,-3
220,220,221,2,6,4
221,221,222,6,4,-2
222,222,223,4,7,3
223,223,224,7,1,-6
224,224,225,1,8,7
225,225,226,8,9,1
226,226,227,9,9,0
227,227,228,9,3,-6
228,228,229,3,0,-3
229,229,230,0,7,7
230,230,231,7,1,-6
231,231,232,1,0,-1
232,232,233,0,2,2
233,233,234,2,0,-2
234,234,235,0,3,3
235,235,236,3,5,2
236,236,237,5,4,-1
237,237,238,4,6,2
238,238,239,6,5,-1
239,239,240,5,8,3
240,240,241,8,6,-2
241,241,242,6,3,-3
242,242,243,3,7,4
243,243,244,7,5,-2
244,244,245,5,8,3
245,245,246,8,0,-8
246,246,247,0,9,9
247,247,248,9,1,-8
248,248,249,1,0,-1
249,249,250,0,3,3
250,250,251,3,1,-2
251,251,252,1,2,1
252,252,253,2,2,0
253,253,254,2,3,1
254,254,255,3,3,0
255,255,256,3,6,3
256,256,257,6,4,-2
257,257,258,4,7,3
258,258,259,7,5,-2
259,259,260,5,0,-5
260,260,261,0,6,6
261,261,262,6,2,-4
262,262,263,2,7,5
263,263,264,7,9,2
264,264,265,9,8,-1
265,265,266,8,5,-3
266,266,267,5,9,4
267,267,268,9,2,-7
268,268,269,2,1,-1
269,269,270,1,1,0
270,270,271,1,4,3
271,271,272,4,4,0
272,272,273,4,5,1
273,273,274,5,6,1
274,274,275,6,4,-2
275,275,276,4,1,-3
276,276,277,1,2,1
277,277,278,2,5,3
278,278,279,5,3,-2
279,279,280,3,9,6
280,280,281,9,3,-6
281,281,282,3,9,6
282,282,283,9,0,-9
283,283,284,0,5,5
284,284,285,5,9,4
285,285,286,9,6,-3
286,286,287,6,5,-1
287,287,288,5,7,2
288,288,289,7,4,-3
289,289,290,4,1,-3
290,290,291,1,3,2
291,291,292,3,4,1
292,292,293,4,0,-4
293,293,294,0,4,4
294,294,295,4,8,4
295,295,296,8,0,-8
296,296,297,0,4,4
297,297,298,4,3,-1
298,298,299,3,6,3
299,299,300,6,8,2
300,300,301,8,7,-1
301,301,302,7,6,-1
302,302,303,6,0,-6
303,303,304,0,9,9
304,304,305,9,7,-2
305,305,306,7,5,-2
306,306,307,5,7,2
307,307,308,7,2,-5
308,308,309,2,1,-1
309,309,310,1,1,0
310,310,311,1,6,5
311,311,312,6,8,2
312,312,313,8,9,1
313,313,314,9,4,-5
314,314,315,4,1,-3
315,315,316,1,5,4
316,316,317,5,2,-3
317,317,318,2,2,0
318,318,319,2,9,7
319,319,320,9,0,-9
320,320,321,0,3,3
321,321,322,3,9,6
322,322,323,9,6,-3
323,323,324,6,7,1
324,324,325,7,2,-5
325,325,326,2,0,-2
326,326,327,0,3,3
327,327,328,3,5,2
328,328,329,5,4,-1
329,329,330,4,3,-1
330,330,331,3,6,3
331,331,332,6,5,-1
332,332,333,5,8,3
333,333,334,8,9,1
334,334,335,9,5,-4
335,335,336,5,4,-1
336,336,337,4,7,3
337,337,338,7,4,-3
338,338,339,4,2,-2
339,339,340,2,7,5
340,340,341,7,3,-4
341,341,342,3,4,1
342,342,343,4,8,4
343,343,344,8,9,1
344,344,345,9,1,-8
345,345,346,1,9,8
346,346,347,9,2,-7
347,347,348,2,8,6
348,348,349,8,7,-1
349,349,350,7,9,2
350,350,351,9,1,-8
351,351,352,1,8,7
352,352,353,8,7,-1
353,353,354,7,4,-3
354,354,355,4,1,-3
355,355,356,1,3,2
356,356,357,3,1,-2
357,357,358,1,1,0
358,358,359,1,0,-1
359,359,360,0,2,2
360,360,361,2,3,1
361,361,362,3,9,6
362,362,363,9,4,-5
363,363,364,4,9,5
364,364,365,9,2,-7
365,365,366,2,1,-1
366,366,367,1,6,5
367,367,368,6,8,2
368,368,369,8,4,-4
369,369,370,4,7,3
370,370,371,7,7,0
371,371,372,7,4,-3
372,372,373,4,4,0
373,373,374,4,9,5
374,374,375,9,2,-7
375,375,376,2,5,3
376,376,377,5,7,2
377,377,378,7,2,-5
378,378,379,2,4,2
379,379,380,4,4,0
380,380,381,4,2,-2
381,381,382,2,1,-1
382,382,383,1,9,8
383,383,384,9,7,-2
384,384,385,7,2,-5
385,385,386,2,8,6
386,386,387,8,7,-1
387,387,388,7,6,-1
388,388,389,6,9,3
389,389,390,9,2,-7
390,390,391,2,2,0
391,391,392,2,3,1
392,392,393,3,8,5
393,393,394,8,1,-7
394,394,395,1,6,5
395,395,396,6,5,-1
396,396,397,5,1,-4
397,397,398,1,1,0
398,398,399,1,0,-1
399,399,400,0,2,2
400,400,401,2,6,4
401,401,402,6,4,-2
402,402,403,4,5,1
403,403,404,5,8,3
404,404,405,8,3,-5
405,405,406,3,1,-2
406,406,407,1,5,4
407,407,408,5,1,-4
408,408,409,1,9,8
409,409,410,9,2,-7
410,410,411,2,7,5
411,411,412,7,4,-3
412,412,413,4,4,0
413,413,414,4,4,0
414,414,415,4,8,4
415,415,416,8,1,-7
416,416,417,1,5,4
417,417,418,5,8,3
418,418,419,8,9,1
419,419,420,9,5,-4
420,420,421,5,6,1
421,421,422,6,7,1
422,422,423,7,9,2
423,423,424,9,9,0
424,424,425,9,3,-6
425,425,426,3,7,4
426,426,427,7,0,-7
427,427,428,0,9,9
428,428,429,9,0,-9
429,429,430,0,6,6
430,430,431,6,6,0
431,431,432,6,2,-4
432,432,433,2,3,1
433,433,434,3,9,6
434,434,435,9,0,-9
435,435,436,0,7,7
436,436,437,7,5,-2
437,437,438,5,4,-1
438,438,439,4,8,4
439,439,440,8,0,-8
440,440,441,0,9,9
441,441,442,9,4,-5
442,442,443,4,1,-3
443,443,444,1,2,1
444,444,445,2,8,6
445,445,446,8,7,-1
446,446,447,7,1,-6
447,447,448,1,2,1
448,448,449,2,6,4
449,449,450,6,1,-5
450,450,451,1,0,-1
451,451,452,0,3,3
452,452,453,3,0,-3
453,453,454,0,1,1
454,454,455,1,1,0
455,455,456,1,8,7
456,456,457,8,2,-6
457,457,458,2,0,-2
458,458,459,0,3,3
459,459,460,3,9,6
460,460,461,9,4,-5
461,461,462,4,0,-4
462,462,463,0,5,5
463,463,464,5,0,-5
464,464,465,0,6,6
465,465,466,6,1,-5
466,466,467,1,7,6
467,467,468,7,7,0
468,468,469,7,8,1
469,469,470,8,1,-7
470,470,471,1,9,8
471,471,472,9,2,-7
472,472,473,2,0,-2
473,473,474,0,5,5
474,474,475,5,1,-4
475,475,476,1,2,1
476,476,477,2,2,0
477,477,478,2,7,5
478,478,479,7,3,-4
479,479,480,3,5,2
480,480,481,5,4,-1
481,481,482,4,9,5
482,482,483,9,7,-2
483,483,484,7,1,-6
484,484,485,1,8,7
485,485,486,8,3,-5
486,486,487,3,9,6
487,487,488,9,6,-3
488,488,489,6,0,-6
489,489,490,0,3,3
490,490,491,3,1,-2
491,491,492,1,1,0
492,492,493,1,2,1
493,493,494,2,6,4
494,494,495,6,3,-3
495,495,496,3,5,2
496,496,497,5,7,2
497,497,498,7,6,-1
498,498,499,6,8,2
499,499,500,8,3,-5
500,500,501,3,9,6
501,501,502,9,5,-4
502,502,503,5,8,3
503,503,504,8,5,-3
504,504,505,5,7,2
505,505,506,7,6,-1
506,506,507,6,1,-5
507,507,508,1,1,0
508,508,509,1,3,2
509,509,510,3,1,-2
510,510,511,1,7,6
511,511,512,7,5,-2
512,512,513,5,5,0
513,513,514,5,5,0
514,514,515,5,2,-3
515,515,516,2,5,3
516,516,517,5,8,3
517,517,518,8,7,-1
518,518,519,7,0,-7
519,519,520,0,9,9
520,520,521,9,7,-2
521,521,522,7,7,0
522,522,523,7,5,-2
523,523,524,5,0,-5
524,524,525,0,9,9
525,525,526,9,0,-9
526,526,527,0,0,0
527,527,528,0,8,8
528,528,529,8,9,1
529,529,530,9,2,-7
530,530,531,2,4,2
531,531,532,4,8,4
532,532,533,8,1,-7
533,533,534,1,6,5
534,534,535,6,1,-5
535,535,536,1,6,5
536,536,537,6,5,-1
537,537,538,5,1,-4
538,538,539,1,8,7
539,539,540,8,3,-5
540,540,541,3,4,1
541,541,542,4,0,-4
542,542,543,0,5,5
543,543,544,5,5,0
544,544,545,5,8,3
545,545,546,8,3,-5
546,546,547,3,6,3
547,547,548,6,2,-4
548,548,549,2,3,1
549,549,550,3,9,6
550,550,551,9,2,-7
551,551,552,2,1,-1
552,552,553,1,1,0
553,553,554,1,5,4
554,554,555,5,2,-3
555,555,556,2,1,-1
556,556,557,1,3,2
557,557,558,3,2,-1
558,558,559,2,8,6
559,559,560,8,7,-1
560,560,561,7,3,-4
561,561,562,3,7,4
562,562,563,7,2,-5
563,563,564,2,4,2
564,564,565,4,6,2
565,565,566,6,9,3
566,566,567,9,7,-2
567,567,568,7,2,-5
568,568,569,2,4,2
569,569,570,4,2,-2
570,570,571,2,8,6
571,571,572,8,1,-7
572,572,573,1,1,0
573,573,574,1,3,2
574,574,575,3,8,5
575,575,576,8,4,-4
576,576,577,4,0,-4
577,577,578,0,6,6
578,578,579,6,5,-1
579,579,580,5,9,4
580,580,581,9,3,-6
581,581,582,3,0,-3
582,582,583,0,9,9
583,583,584,9,2,-7
584,584,585,2,4,2
585,585,586,4,7,3
586,586,587,7,1,-6
587,587,588,1,2,1
588,588,589,2,9,7
589,589,590,9,4,-5
590,590,591,4,2,-2
591,591,592,2,6,4
592,592,593,6,1,-5
593,593,594,1,8,7
594,594,595,8,9,1
595,595,596,9,0,-9
596,596,597,0,6,6
597,597,598,6,6,0
598,598,599,6,7,1
599,599,600,7,9,2
600,600,601,9,9,0
601,601,602,9,8,-1
602,602,603,8,0,-8
603,603,604,0,1,1
604,604,605,1,4,3
605,605,606,4,4,0
606,606,607,4,6,2
607,607,608,6,7,1
608,608,609,7,1,-6
609,609,610,1,5,4
610,610,611,5,7,2
611,611,612,7,0,-7
612,612,613,0,3,3
613,613,614,3,5,2
614,614,615,5,8,3
615,615,616,8,4,-4
616,616,617,4,7,3
617,617,618,7,1,-6
618,618,619,1,2,1
619,619,620,2,5,3
620,620,621,5,9,4
621,621,622,9,5,-4
622,622,623,5,6,1
623,623,624,6,7,1
624,624,625,7,5,-2
625,625,626,5,9,4
626,626,627,9,8,-1
627,627,628,8,8,0
628,628,629,8,3,-5
629,629,630,3,6,3
630,630,631,6,9,3
631,631,632,9,7,-2
632,632,633,7,0,-7
633,633,634,0,7,7
634,634,635,7,5,-2
635,635,636,5,7,2
636,636,637,7,1,-6
637,637,638,1,1,0
638,638,639,1,0,-1
639,639,640,0,7,7
640,640,641,7,9,2
641,641,642,9,2,-7
642,642,643,2,3,1
643,643,644,3,7,4
644,644,645,7,3,-4
645,645,646,3,2,-1
646,646,647,2,4,2
647,647,648,4,1,-3
648,648,649,1,6,5
649,649,650,6,2,-4
650,650,651,2,7,5
651,651,652,7,5,-2
652,652,653,5,5,0
653,653,654,5,7,2
654,654,655,7,4,-3
655,655,656,4,0,-4
656,656,657,0,2,2
657,657,658,2,6,4
658,658,659,6,3,-3
659,659,660,3,6,3
660,660,661,6,4,-2
661,661,662,4,0,-4
662,662,663,0,4,4
663,663,664,4,2,-2
664,664,665,2,6,4
665,665,666,6,0,-6
666,666,667,0,0,0
667,667,668,0,0,0
668,668,669,0,0,0
669,669,670,0,3,3
670,670,671,3,1,-2
671,671,672,1,6,5
672,672,673,6,2,-4
673,673,674,2,2,0
674,674,675,2,3,1
675,675,676,3,1,-2
676,676,677,1,4,3
677,677,678,4,1,-3
678,678,679,1,5,4
679,679,680,5,4,-1
680,680,681,4,6,2
681,681,682,6,4,-2
682,682,683,4,7,3
683,683,684,7,2,-5
684,684,685,2,8,6
685,685,686,8,7,-1
686,686,687,7,9,2
687,687,688,9,2,-7
688,688,689,2,0,-2
689,689,690,0,5,5
690,690,691,5,1,-4
691,691,692,1,4,3
692,692,693,4,2,-2
693,693,694,2,8,6
694,694,695,8,3,-5
695,695,696,3,2,-1
696,696,697,2,4,2
697,697,698,4,1,-3
698,698,699,1,5,4
699,699,700,5,4,-1
700,700,701,4,6,2
701,701,702,6,0,-6
702,702,703,0,7,7
703,703,704,7,9,2
704,704,705,9,8,-1
705,705,706,8,4,-4
706,706,707,4,9,5
707,707,708,9,8,-1
708,708,709,8,0,-8
709,709,710,0,1,1
710,710,711,1,1,0
711,711,712,1,0,-1
712,712,713,0,2,2
713,713,714,2,2,0
714,714,715,2,3,1
715,715,716,3,2,-1
716,716,717,2,4,2
717,717,718,4,4,0
718,718,719,4,5,1
719,719,720,5,8,3
720,720,721,8,6,-2
721,721,722,6,5,-1
722,722,723,5,7,2
723,723,724,7,7,0
724,724,725,7,8,1
725,725,726,8,8,0
726,726,727,8,9,1
727,727,728,9,7,-2
728,728,729,7,4,-3
729,729,730,4,7,3
730,730,731,7,3,-4
731,731,732,3,2,-1
732,732,733,2,0,-2
733,733,734,0,8,8
734,734,735,8,6,-2
735,735,736,6,8,2
736,736,737,8,6,-2
737,737,738,6,1,-5
738,738,739,1,6,5
739,739,740,6,8,2
740,740,741,8,9,1
741,741,742,9,4,-5
742,742,743,4,0,-4
743,743,744,0,9,9
744,744,745,9,0,-9
745,745,746,0,4,4
746,746,747,4,1,-3
747,747,748,1,5,4
748,748,749,5,4,-1
749,749,750,4,7,3
750,750,751,7,5,-2
751,751,752,5,3,-2
752,752,753,3,7,4
753,753,754,7,4,-3
754,754,755,4,9,5
755,755,756,9,8,-1
756,756,757,8,5,-3
757,757,758,5,8,3
758,758,759,8,6,-2
759,759,760,6,3,-3
760,760,761,3,8,5
761,761,762,8,6,-2
762,762,763,6,9,3
763,763,764,9,9,0
764,764,765,9,1,-8
765,765,766,1,8,7
766,766,767,8,3,-5
767,767,768,3,5,2
768,768,769,5,8,3
769,769,770,8,6,-2
770,770,771,6,5,-1
771,771,772,5,9,4
772,772,773,9,7,-2
773,773,774,7,2,-5
774,774,775,2,5,3
775,775,776,5,0,-5
776,776,777,0,8,8
777,777,778,8,5,-3
778,778,779,5,1,-4
779,779,780,1,1,0
780,780,781,1,0,-1
781,781,782,0,9,9
782,782,783,9,1,-8
783,783,784,1,8,7
784,784,785,8,6,-2
785,785,786,6,7,1
786,786,787,7,0,-7
787,787,788,0,9,9
788,788,789,9,3,-6
789,789,790,3,0,-3
790,790,791,0,8,8
791,791,792,8,8,0
792,792,793,8,9,1
793,793,794,9,6,-3
794,794,795,6,7,1
795,795,796,7,8,1
796,796,797,8,4,-4
797,797,798,4,7,3
798,798,799,7,5,-2
799,799,800,5,9,4
800,800,801,9,2,-7
801,801,802,2,6,4
802,802,803,6,7,1
803,803,804,7,4,-3
804,804,805,4,5,1
805,805,806,5,9,4
806,806,807,9,2,-7
807,807,808,2,3,1
808,808,809,3,1,-2
809,809,810,1,6,5
810,810,811,6,3,-3
811,811,812,3,9,6
812,812,813,9,2,-7
813,813,814,2,2,0
814,814,815,2,5,3
815,815,816,5,6,1
816,816,817,6,8,2
817,817,818,8,0,-8
818,818,819,0,7,7
819,819,820,7,7,0
820,820,821,7,1,-6
821,821,822,1,9,8
822,822,823,9,8,-1
823,823,824,8,7,-1
824,824,825,7,0,-7
825,825,826,0,9,9
826,826,827,9,9,0
827,827,828,9,4,-5
828,828,829,4,6,2
829,829,830,6,2,-4
830,830,831,2,8,6
831,831,832,8,5,-3
832,832,833,5,1,-4
833,833,834,1,4,3
834,834,835,4,1,-3
835,835,836,1,5,4
836,836,837,5,5,0
837,837,838,5,1,-4
838,838,839,1,7,6
839,839,840,7,3,-4
840,840,841,3,6,3
841,841,842,6,4,-2
842,842,843,4,3,-1
843,843,844,3,2,-1
844,844,845,2,5,3
845,845,846,5,6,1
846,846,847,6,4,-2
847,847,848,4,4,0
848,848,849,4,0,-4
849,849,850,0,4,4
850,850,851,4,4,0
851,851,852,4,6,2
852,852,853,6,7,1
853,853,854,7,2,-5
854,854,855,2,4,2
855,855,856,4,3,-1
856,856,857,3,3,0
857,857,858,3,8,5
858,858,859,8,0,-8
859,859,860,0,0,0
860,860,861,0,3,3
861,861,862,3,2,-1
862,862,863,2,2,0
863,863,864,2,9,7
864,864,865,9,8,-1
865,865,866,8,2,-6
866,866,867,2,3,1
867,867,868,3,7,4
868,868,869,7,0,-7
869,869,870,0,1,1
870,870,871,1,1,0
871,871,872,1,0,-1
872,872,873,0,2,2
873,873,874,2,3,1
874,874,875,3,3,0
875,875,876,3,8,5
876,876,877,8,4,-4
877,877,878,4,3,-1
878,878,879,3,5,2
879,879,880,5,7,2
880,880,881,7,6,-1
881,881,882,6,4,-2
882,882,883,4,7,3
883,883,884,7,7,0
884,884,885,7,8,1
885,885,886,8,5,-3
886,886,887,5,9,4
887,887,888,9,7,-2
888,888,889,7,0,-7
889,889,890,0,3,3
890,890,891,3,1,-2
891,891,892,1,6,5
892,892,893,6,2,-4
893,893,894,2,4,2
894,894,895,4,3,-1
895,895,896,3,4,1
896,896,897,4,4,0
897,897,898,4,7,3
898,898,899,7,5,-2
899,899,900,5,9,4
900,900,901,9,6,-3
901,901,902,6,9,3
902,902,903,9,0,-9
903,903,904,0,7,7
904,904,905,7,1,-6
905,905,906,1,4,3
906,906,907,4,2,-2
907,907,908,2,7,5
908,908,909,7,3,-4
909,909,910,3,6,3
910,910,911,6,7,1
911,911,912,7,5,-2
912,912,913,5,8,3
913,913,914,8,4,-4
914,914,915,4,5,1
915,915,916,5,5,0
916,916,917,5,2,-3
917,917,918,2,7,5
918,918,919,7,1,-6
919,919,920,1,1,0
920,920,921,1,5,4
921,921,922,5,6,1
922,922,923,6,8,2
923,923,924,8,5,-3
924,924,925,5,8,3
925,925,926,8,4,-4
926,926,927,4,0,-4
927,927,928,0,7,7
928,928,929,7,9,2
929,929,930,9,9,0
930,930,931,9,2,-7
931,931,932,2,9,7
932,932,933,9,7,-2
933,933,934,7,7,0
934,934,935,7,8,1
935,935,936,8,7,-1
936,936,937,7,4,-3
937,937,938,4,2,-2
938,938,939,2,6,4
939,939,940,6,9,3
940,940,941,9,1,-8
941,941,942,1,7,6
942,942,943,7,0,-7
943,943,944,0,6,6
944,944,945,6,4,-2
945,945,946,4,2,-2
946,946,947,2,5,3
947,947,948,5,7,2
948,948,949,7,0,-7
949,949,950,0,7,7
950,950,951,7,1,-6
951,951,952,1,0,-1
952,952,953,0,3,3
953,953,954,3,7,4
954,954,955,7,6,-1
955,955,956,6,5,-1
956,956,957,5,0,-5
957,957,958,0,6,6
958,958,959,6,1,-5
959,959,960,1,5,4
960,960,961,5,1,-4
961,961,962,1,7,6
962,962,963,7,8,1
963,963,964,8,5,-3
964,964,965,5,0,-5
965,965,966,0,3,3
966,966,967,3,4,1
967,967,968,4,7,3
968,968,969,7,7,0
969,969,970,7,5,-2
970,970,971,5,7,2
971,971,972,7,8,1
972,972,973,8,6,-2
973,973,974,6,9,3
974,974,975,9,3,-6
975,975,976,3,8,5
976,976,977,8,6,-2
977,977,978,6,1,-5
978,978,979,1,0,-1
979,979,980,0,9,9
980,980,981,9,7,-2
981,981,982,7,1,-6
982,982,983,1,3,2
983,983,984,3,0,-3
984,984,985,0,5,5
985,985,986,5,6,1
986,986,987,6,4,-2
987,987,988,4,4,0
988,988,989,4,2,-2
989,989,990,2,4,2
990,990,991,4,4,0
991,991,992,4,3,-1
992,992,993,3,1,-2
993,993,994,1,7,6
994,994,995,7,7,0
995,995,996,7,6,-1
996,996,997,6,0,-6
997,997,998,0,3,3
998,998,999,3,6,3
999,999,1000,6,0,-6
1000,1000,1001,0,7,7
1001,1001,1002,7,1,-6
1002,1002,1003,1,1,0
1003,1003,1004,1,4,3
1004,1004,1005,4,9,5
1005,1005,1006,9,4,-5
1006,1006,1007,4,3,-1
1007,1007,1008,3,4,1
1008,1008,1009,4,8,4
1009,1009,1010,8,2,-6
1010,1010,1011,2,2,0
1011,1011,1012,2,1,-1
1012,1012,1013,1,8,7
1013,1013,1014,8,7,-1
1014,1014,1015,7,0,-7
1015,1015,1016,0,8,8
1016,1016,1017,8,1,-7
1017,1017,1018,1,0,-1
1018,1018,1019,0,7,7
1019,1019,1020,7,6,-1
1020,1020,1021,6,3,-3
1021,1021,1022,3,7,4
1022,1022,1023,7,7,0
1023,1023,1024,7,5,-2
1024,1024,1025,5,8,3
1025,1025,1026,8,8,0
1026,1026,1027,8,9,1
1027,1027,1028,9,0,-9
1028,1028,1029,0,0,0
1029,1029,1030,0,4,4
1030,1030,1031,4,1,-3
1031,1031,1032,1,5,4
1032,1032,1033,5,2,-3
1033,1033,1034,2,2,0
1034,1034,1035,2,3,1
1035,1035,1036,3,9,6
1036,1036,1037,9,4,-5
1037,1037,1038,4,9,5
1038,1038,1039,9,5,-4
1039,1039,1040,5,0,-5
1040,1040,1041,0,6,6
1041,1041,1042,6,7,1
1042,1042,1043,7,7,0
1043,1043,1044,7,1,-6
1044,1044,1045,1,8,7
1045,1045,1046,8,0,-8
1046,1046,1047,0,2,2
1047,1047,1048,2,2,0
1048,1048,1049,2,0,-2
1049,1049,1050,0,4,4
1050,1050,1051,4,1,-3
1051,1051,1052,1,1,0
1052,1052,1053,1,2,1
1053,1053,1054,2,7,5
1054,1054,1055,7,3,-4
1055,1055,1056,3,9,6
1056,1056,1057,9,7,-2
1057,1057,1058,7,2,-5
1058,1058,1059,2,8,6
1059,1059,1060,8,1,-7
1060,1060,1061,1,9,8
1061,1061,1062,9,5,-4
1062,1062,1063,5,8,3
1063,1063,1064,8,8,0
1064,1064,1065,8,1,-7
1065,1065,1066,1,9,8
1066,1066,1067,9,8,-1
1067,1067,1068,8,3,-5
1068,1068,1069,3,1,-2
1069,1069,1070,1,6,5
1070,1070,1071,6,5,-1
1071,1071,1072,5,7,2
1072,1072,1073,7,4,-3
1073,1073,1074,4,2,-2
1074,1074,1075,2,7,5
1075,1075,1076,7,0,-7
1076,1076,1077,0,3,3
1077,1077,1078,3,0,-3
1078,1078,1079,0,4,4
1079,1079,1080,4,1,-3
1080,1080,1081,1,1,0
1081,1081,1082,1,7,6
1082,1082,1083,7,9,2
1083,1083,1084,9,1,-8
1084,1084,1085,1,1,0
1085,1085,1086,1,8,7
1086,1086,1087,8,5,-3
1087,1087,1088,5,7,2
1088,1088,1089,7,5,-2
1089,1089,1090,5,0,-5
1090,1090,1091,0,6,6
1091,1091,1092,6,6,0
1092,1092,1093,6,0,-6
1093,1093,1094,0,4,4
1094,1094,1095,4,1,-3
1095,1095,1096,1,2,1
1096,1096,1097,2,3,1
1097,1097,1098,3,4,1
1098,1098,1099,4,4,0
1099,1099,1100,4,6,2
1100,1100,1101,6,8,2
1101,1101,1102,8,0,-8
1102,1102,1103,0,9,9
1103,1103,1104,9,5,-4
1104,1104,1105,5,8,3
1105,1105,1106,8,7,-1
1106,1106,1107,7,0,-7
1107,1107,1108,0,3,3
1108,1108,1109,3,5,2
1109,1109,1110,5,4,-1
1110,1110,1111,4,5,1
1111,1111,1112,5,9,4
1112,1112,1113,9,6,-3
1113,1113,1114,6,7,1
1114,1114,1115,7,1,-6
1115,1115,1116,1,9,8
1116,1116,1117,9,6,-3
1117,1117,1118,6,1,-5
1118,1118,1119,1,3,2
1119,1119,1120,3,8,5
1120,1120,1121,8,3,-5
1121,1121,1122,3,9,6
1122,1122,1123,9,1,-8
1123,1123,1124,1,2,1
1124,1124,1125,2,7,5
1125,1125,1126,7,7,0
1126,1126,1127,7,7,0
1127,1127,1128,7,0,-7
1128,1128,1129,0,2,2
1129,1129,1130,2,3,1
1130,1130,1131,3,1,-2
1131,1131,1132,1,1,0
1132,1132,1133,1,4,3
1133,1133,1134,4,2,-2
1134,1134,1135,2,5,3
1135,1135,1136,5,6,1
1136,1136,1137,6,0,-6
1137,1137,1138,0,9,9
1138,1138,1139,9,6,-3
1139,1139,1140,6,2,-4
1140,1140,1141,2,8,6
1141,1141,1142,8,9,1
1142,1142,1143,9,2,-7
1143,1143,1144,2,3,1
1144,1144,1145,3,3,0
1145,1145,1146,3,6,3
1146,1146,1147,6,9,3
1147,1147,1148,9,1,-8
1148,1148,1149,1,4,3
1149,1149,1150,4,3,-1
1150,1150,1151,3,3,0
1151,1151,1152,3,0,-3
1152,1152,1153,0,7,7
1153,1153,1154,7,7,0
1154,1154,1155,7,1,-6
1155,1155,1156,1,7,6
1156,1156,1157,7,7,0
1157,1157,1158,7,3,-4
1158,1158,1159,3,6,3
1159,1159,1160,6,4,-2
1160,1160,1161,4,9,5
1161,1161,1162,9,5,-4
1162,1162,1163,5,4,-1
1163,1163,1164,4,4,0
1164,1164,1165,4,2,-2
1165,1165,1166,2,7,5
1166,1166,1167,7,9,2
1167,1167,1168,9,0,-9
1168,1168,1169,0,9,9
1169,1169,1170,9,8,-1
1170,1170,1171,8,4,-4
1171,1171,1172,4,4,0
1172,1172,1173,4,9,5
1173,1173,1174,9,1,-8
1174,1174,1175,1,2,1
1175,1175,1176,2,4,2
1176,1176,1177,4,9,5
1177,1177,1178,9,3,-6
1178,1178,1179,3,0,-3
1179,1179,1180,0,4,4
1180,1180,1181,4,1,-3
1181,1181,1182,1,6,5
1182,1182,1183,6,2,-4
1183,1183,1184,2,6,4
1184,1184,1185,6,3,-3
1185,1185,1186,3,7,4
1186,1186,1187,7,4,-3
1187,1187,1188,4,2,-2
1188,1188,1189,2,6,4
1189,1189,1190,6,6,0
1190,1190,1191,6,7,1
1191,1191,1192,7,1,-6
1192,1192,1193,1,8,7
1193,1193,1194,8,9,1
1194,1194,1195,9,0,-9
1195,1195,1196,0,4,4
1196,1196,1197,4,1,-3
1197,1197,1198,1,4,3
1198,1198,1199,4,2,-2
1199,1199,1200,2,1,-1
1200,1200,1201,1,3,2
1201,1201,1202,3,6,3
1202,1202,1203,6,4,-2
1203,1203,1204,4,6,2
1204,1204,1205,6,7,1
1205,1205,1206,7,5,-2
1206,1206,1207,5,8,3
1207,1207,1208,8,7,-1
1208,1208,1209,7,0,-7
1209,1209,1210,0,5,5
1210,1210,1211,5,1,-4
1211,1211,1212,1,4,3
1212,1212,1213,4,2,-2
1213,1213,1214,2,8,6
1214,1214,1215,8,4,-4
1215,1215,1216,4,7,3
1216,1216,1217,7,7,0
1217,1217,1218,7,3,-4
1218,1218,1219,3,8,5
1219,1219,1220,8,4,-4
1220,1220,1221,4,9,5
1221,1221,1222,9,5,-4
1222,1222,1223,5,8,3
1223,1223,1224,8,6,-2
1224,1224,1225,6,7,1
1225,1225,1226,7,3,-4
1226,1226,1227,3,4,1
1227,1227,1228,4,6,2
1228,1228,1229,6,7,1
1229,1229,1230,7,1,-6
1230,1230,1231,1,7,6
1231,1231,1232,7,4,-3
1232,1232,1233,4,3,-1
1233,1233,1234,3,3,0
1234,1234,1235,3,9,6
1235,1235,1236,9,8,-1
1236,1236,1237,8,8,0
1237,1237,1238,8,1,-7
1238,1238,1239,1,8,7
1239,1239,1240,8,6,-2
1240,1240,1241,6,3,-3
1241,1241,1242,3,1,-2
1242,1242,1243,1,1,0
1243,1243,1244,1,3,2
1244,1244,1245,3,5,2
1245,1245,1246,5,2,-3
1246,1246,1247,2,8,6
1247,1247,1248,8,4,-4
1248,1248,1249,4,2,-2
1249,1249,1250,2,9,7
1250,1250,1251,9,7,-2
1251,1251,1252,7,1,-6
1252,1252,1253,1,4,3
1253,1253,1254,4,8,4
1254,1254,1255,8,2,-6
1255,1255,1256,2,9,7
1256,1256,1257,9,6,-3
1257,1257,1258,6,4,-2
1258,1258,1259,4,1,-3
1259,1259,1260,1,3,2
1260,1260,1261,3,4,1
1261,1261,1262,4,2,-2
1262,1262,1263,2,5,3
1263,1263,1264,5,2,-3
1264,1264,1265,2,5,3
1265,1265,1266,5,6,1
1266,1266,1267,6,8,2
1267,1267,1268,8,0,-8
1268,1268,1269,0,6,6
1269,1269,1270,6,2,-4
1270,1270,1271,2,4,2
1271,1271,1272,4,9,5
1272,1272,1273,9,4,-5
1273,1273,1274,4,9,5
1274,1274,1275,9,4,-5
1275,1275,1276,4,5,1
1276,1276,1277,5,1,-4
1277,1277,1278,1,5,4
1278,1278,1279,5,8,3
1279,1279,1280,8,4,-4
1280,1280,1281,4,7,3
1281,1281,1282,7,9,2
1282,1282,1283,9,5,-4
1283,1283,1284,5,9,4
1284,1284,1285,9,5,-4
1285,1285,1286,5,9,4
1286,1286,1287,9,1,-8
1287,1287,1288,1,5,4
1288,1288,1289,5,8,3
1289,1289,1290,8,3,-5
1290,1290,1291,3,9,6
1291,1291,1292,9,9,0
1292,1292,1293,9,1,-8
1293,1293,1294,1,8,7
1294,1294,1295,8,3,-5
1295,1295,1296,3,8,5
1296,1296,1297,8,6,-2
1297,1297,1298,6,5,-1
1298,1298,1299,5,2,-3
1299,1299,1300,2,7,5
1300,1300,1301,7,2,-5
1301,1301,1302,2,7,5
1302,1302,1303,7,6,-1
1303,1303,1304,6,0,-6
1304,1304,1305,0,9,9
1305,1305,1306,9,7,-2
1306,1306,1307,7,9,2
1307,1307,1308,9,4,-5
1308,1308,1309,4,6,2
1309,1309,1310,6,0,-6
1310,1310,1311,0,5,5
1311,1311,1312,5,3,-2
1312,1312,1313,3,5,2
1313,1313,1314,5,7,2
1314,1314,1315,7,3,-4
1315,1315,1316,3,9,6
1316,1316,1317,9,3,-6
1317,1317,1318,3,6,3
1318,1318,1319,6,8,2
1319,1319,1320,8,3,-5
1320,1320,1321,3,1,-2
1321,1321,1322,1,7,6
1322,1322,1323,7,6,-1
1323,1323,1324,6,5,-1
1324,1324,1325,5,5,0
1325,1325,1326,5,7,2
1326,1326,1327,7,6,-1
1327,1327,1328,6,5,-1
1328,1328,1329,5,8,3
1329,1329,1330,8,2,-6
1330,1330,1331,2,1,-1
1331,1331,1332,1,7,6
1332,1332,1333,7,9,2
1333,1333,1334,9,2,-7
1334,1334,1335,2,7,5
1335,1335,1336,7,3,-4
1336,1336,1337,3,6,3
1337,1337,1338,6,7,1
1338,1338,1339,7,8,1
1339,1339,1340,8,5,-3
1340,1340,1341,5,3,-2
1341,1341,1342,3,7,4
1342,1342,1343,7,7,0
1343,1343,1344,7,8,1
1344,1344,1345,8,4,-4
1345,1345,1346,4,0,-4
1346,1346,1347,0,7,7
1347,1347,1348,7,3,-4
1348,1348,1349,3,0,-3
1349,1349,1350,0,6,6
1350,1350,1351,6,3,-3
1351,1351,1352,3,9,6
1352,1352,1353,9,7,-2
1353,1353,1354,7,1,-6
1354,1354,1355,1,9,8
1355,1355,1356,9,5,-4
1356,1356,1357,5,3,-2
1357,1357,1358,3,6,3
1358,1358,1359,6,0,-6
1359,1359,1360,0,9,9
1360,1360,1361,9,2,-7
1361,1361,1362,2,8,6
1362,1362,1363,8,0,-8
1363,1363,1364,0,9,9
1364,1364,1365,9,1,-8
1365,1365,1366,1,6,5
1366,1366,1367,6,0,-6
1367,1367,1368,0,0,0
1368,1368,1369,0,1,1
1369,1369,1370,1,9,8
1370,1370,1371,9,0,-9
1371,1371,1372,0,0,0
1372,1372,1373,0,4,4
1373,1373,1374,4,2,-2
1374,1374,1375,2,1,-1
1375,1375,1376,1,7,6
1376,1376,1377,7,0,-7
1377,1377,1378,0,3,3
1378,1378,1379,3,4,1
1379,1379,1380,4,4,0
1380,1380,1381,4,7,3
1381,1381,1382,7,5,-2
1382,1382,1383,5,9,4
1383,1383,1384,9,8,-1
1384,1384,1385,8,2,-6
1385,1385,1386,2,0,-2
1386,1386,1387,0,0,0
1387,1387,1388,0,8,8
1388,1388,1389,8,6,-2
1389,1389,1390,6,2,-4
1390,1390,1391,2,2,0
1391,1391,1392,2,7,5
1392,1392,1393,7,6,-1
1393,1393,1394,6,1,-5
1394,1394,1395,1,2,1
1395,1395,1396,2,9,7
1396,1396,1397,9,2,-7
1397,1397,1398,2,6,4
1398,1398,1399,6,9,3
1399,1399,1400,9,7,-2
1400,1400,1401,7,9,2
1401,1401,1402,9,5,-4
1402,1402,1403,5,0,-5
1403,1403,1404,0,8,8
1404,1404,1405,8,1,-7
1405,1405,1406,1,5,4
1406,1406,1407,5,2,-3
1407,1407,1408,2,4,2
1408,1408,1409,4,3,-1
1409,1409,1410,3,9,6
1410,1410,1411,9,4,-5
1411,1411,1412,4,7,3
1412,1412,1413,7,5,-2
1413,1413,1414,5,6,1
1414,1414,1415,6,6,0
1415,1415,1416,6,7,1
1416,1416,1417,7,7,0
1417,1417,1418,7,6,-1
1418,1418,1419,6,8,2
1419,1419,1420,8,5,-3
1420,1420,1421,5,9,4
1421,1421,1422,9,7,-2
1422,1422,1423,7,0,-7
1423,1423,1424,0,6,6
1424,1424,1425,6,1,-5
1425,1425,1426,1,9,8
1426,1426,1427,9,2,-7
1427,1427,1428,2,3,1
1428,1428,1429,3,3,0
1429,1429,1430,3,5,2
1430,1430,1431,5,4,-1
1431,1431,1432,4,3,-1
1432,1432,1433,3,5,2
1433,1433,1434,5,8,3
1434,1434,1435,8,6,-2
1435,1435,1436,6,3,-3
1436,1436,1437,3,7,4
1437,1437,1438,7,2,-5
1438,1438,1439,2,8,6
1439,1439,1440,8,4,-4
1440,1440,1441,4,9,5
1441,1441,1442,9,5,-4
1442,1442,1443,5,0,-5
1443,1443,1444,0,2,2
1444,1444,1445,2,1,-1
1445,1445,1446,1,4,3
1446,1446,1447,4,2,-2
1447,1447,1448,2,4,2
1448,1448,1449,4,3,-1
1449,1449,1450,3,1,-2
1450,1450,1451,1,7,6
1451,1451,1452,7,1,-6
1452,1452,1453,1,8,7
1453,1453,1454,8,0,-8
1454,1454,1455,0,9,9
1455,1455,1456,9,6,-3
1456,1456,1457,6,8,2
1457,1457,1458,8,1,-7
1458,1458,1459,1,9,8
1459,1459,1460,9,4,-5
1460,1460,1461,4,4,0
1461,1461,1462,4,9,5
1462,1462,1463,9,1,-8
1463,1463,1464,1,8,7
1464,1464,1465,8,9,1
1465,1465,1466,9,6,-3
1466,1466,1467,6,5,-1
1467,1467,1468,5,5,0
1468,1468,1469,5,3,-2
1469,1469,1470,3,3,0
1470,1470,1471,3,0,-3
1471,1471,1472,0,1,1
1472,1472,1473,1,4,3
1473,1473,1474,4,3,-1
1474,1474,1475,3,8,5
1475,1475,1476,8,3,-5
1476,1476,1477,3,4,1
1477,1477,1478,4,2,-2
1478,1478,1479,2,0,-2
1479,1479,1480,0,7,7
1480,1480,1481,7,5,-2
1481,1481,1482,5,5,0
1482,1482,1483,5,1,-4
1483,1483,1484,1,8,7
1484,1484,1485,8,5,-3
1485,1485,1486,5,3,-2
1486,1486,1487,3,4,1
1487,1487,1488,4,6,2
1488,1488,1489,6,0,-6
1489,1489,1490,0,5,5
1490,1490,1491,5,7,2
1491,1491,1492,7,2,-5
1492,1492,1493,2,6,4
1493,1493,1494,6,6,0
1494,1494,1495,6,0,-6
1495,1495,1496,0,1,1
1496,1496,1497,1,1,0
1497,1497,1498,1,4,3
1498,1498,1499,4,7,3
1499,1499,1500,7,9,2
1500,1500,1501,9,0,-9
1501,1501,1502,0,0,0
1502,1502,1503,0,6,6
1503,1503,1504,6,6,0
1504,1504,1505,6,8,2
1505,1505,1506,8,6,-2
1506,1506,1507,6,9,3
1507,1507,1508,9,4,-5
1508,1508,1509,4,5,1
1509,1509,1510,5,2,-3
1510,1510,1511,2,4,2
1511,1511,1512,4,0,-4
1512,1512,1513,0,7,7
1513,1513,1514,7,5,-2
1514,1514,1515,5,6,1
1515,1515,1516,6,5,-1
1516,1516,1517,5,0,-5
1517,1517,1518,0,9,9
1518,1518,1519,9,8,-1
1519,1519,1520,8,6,-2
1520,1520,1521,6,1,-5
1521,1521,1522,1,9,8
1522,1522,1523,9,7,-2
1523,1523,1524,7,5,-2
1524,1524,1525,5,7,2
1525,1525,1526,7,5,-2
1526,1526,1527,5,1,-4
1527,1527,1528,1,1,0
1528,1528,1529,1,3,2
1529,1529,1530,3,0,-3
1530,1530,1531,0,2,2
1531,1531,1532,2,0,-2
1532,1532,1533,0,3,3
1533,1533,1534,3,8,5
1534,1534,1535,8,1,-7
1535,1535,1536,1,6,5
1536,1536,1537,6,4,-2
1537,1537,1538,4,6,2
1538,1538,1539,6,2,-4
1539,1539,1540,2,6,4
1540,1540,1541,6,4,-2
1541,1541,1542,4,8,4
1542,1542,1543,8,8,0
1543,1543,1544,8,1,-7
1544,1544,1545,1,4,3
1545,1545,1546,4,4,0
1546,1546,1547,4,7,3
1547,1547,1548,7,1,-6
1548,1548,1549,1,2,1
1549,1549,1550,2,2,0
1550,1550,1551,2,3,1
1551,1551,1552,3,9,6
1552,1552,1553,9,6,-3
1553,1553,1554,6,4,-2
1554,1554,1555,4,9,5
1555,1555,1556,9,5,-4
1556,1556,1557,5,6,1
1557,1557,1558,6,2,-4
1558,1558,1559,2,3,1
1559,1559,1560,3,9,6
1560,1560,1561,9,2,-7
1561,1561,1562,2,6,4
1562,1562,1563,6,2,-4
1563,1563,1564,2,7,5
1564,1564,1565,7,4,-3
1565,1565,1566,4,3,-1
1566,1566,1567,3,6,3
1567,1567,1568,6,4,-2
1568,1568,1569,4,9,5
1569,1569,1570,9,7,-2
1570,1570,1571,7,0,-7
1571,1571,1572,0,2,2
1572,1572,1573,2,2,0
1573,1573,1574,2,9,7
1574,1574,1575,9,5,-4
1575,1575,1576,5,4,-1
1576,1576,1577,4,5,1
1577,1577,1578,5,0,-5
1578,1578,1579,0,1,1
1579,1579,1580,1,4,3
1580,1580,1581,4,3,-1
1581,1581,1582,3,6,3
1582,1582,1583,6,3,-3
1583,1583,1584,3,2,-1
1584,1584,1585,2,9,7
1585,1585,1586,9,7,-2
1586,1586,1587,7,5,-2
1587,1587,1588,5,3,-2
1588,1588,1589,3,7,4
1589,1589,1590,7,0,-7
1590,1590,1591,0,9,9
1591,1591,1592,9,5,-4
1592,1592,1593,5,8,3
1593,1593,1594,8,3,-5
1594,1594,1595,3,2,-1
1595,1595,1596,2,0,-2
1596,1596,1597,0,1,1
1597,1597,1598,1,8,7
1598,1598,1599,8,3,-5
1599,1599,1600,3,0,-3
1600,1600,1601,0,1,1
1601,1601,1602,1,2,1
1602,1602,1603,2,3,1
1603,1603,1604,3,4,1
1604,1604,1605,4,0,-4
1605,1605,1606,0,0,0
1606,1606,1607,0,1,1
1607,1607,1608,1,7,6
1608,1608,1609,7,2,-5
1609,1609,1610,2,9,7
1610,1610,1611,9,3,-6
1611,1611,1612,3,9,6
1612,1612,1613,9,4,-5
1613,1613,1614,4,2,-2
1614,1614,1615,2,5,3
1615,1615,1616,5,8,3
1616,1616,1617,8,6,-2
1617,1617,1618,6,7,1
1618,1618,1619,7,7,0
1619,1619,1620,7,9,2
1620,1620,1621,9,8,-1
1621,1621,1622,8,9,1
1622,1622,1623,9,9,0
1623,1623,1624,9,2,-7
1624,1624,1625,2,0,-2
1625,1625,1626,0,0,0
1626,1626,1627,0,1,1
1627,1627,1628,1,4,3
1628,1628,1629,4,2,-2
1629,1629,1630,2,4,2
1630,1630,1631,4,3,-1
1631,1631,1632,3,9,6
1632,1632,1633,9,4,-5
1633,1633,1634,4,3,-1
1634,1634,1635,3,5,2
1635,1635,1636,5,7,2
1636,1636,1637,7,6,-1
1637,1637,1638,6,5,-1
1638,1638,1639,5,7,2
1639,1639,1640,7,1,-6
1640,1640,1641,1,8,7
1641,1641,1642,8,6,-2
1642,1642,1643,6,9,3
1643,1643,1644,9,3,-6
1644,1644,1645,3,0,-3
1645,1645,1646,0,4,4
1646,1646,1647,4,1,-3
1647,1647,1648,1,2,1
1648,1648,1649,2,2,0
1649,1649,1650,2,5,3
1650,1650,1651,5,3,-2
1651,1651,1652,3,7,4
1652,1652,1653,7,4,-3
1653,1653,1654,4,1,-3
1654,1654,1655,1,7,6
1655,1655,1656,7,7,0
1656,1656,1657,7,8,1
1657,1657,1658,8,1,-7
1658,1658,1659,1,9,8
1659,1659,1660,9,2,-7
1660,1660,1661,2,3,1
1661,1661,1662,3,2,-1
1662,1662,1663,2,4,2
1663,1663,1664,4,0,-4
1664,1664,1665,0,1,1
1665,1665,1666,1,8,7
1666,1666,1667,8,4,-4
1667,1667,1668,4,3,-1
1668,1668,1669,3,6,3
1669,1669,1670,6,5,-1
1670,1670,1671,5,6,1
1671,1671,1672,6,4,-2
1672,1672,1673,4,7,3
1673,1673,1674,7,9,2
1674,1674,1675,9,3,-6
1675,1675,1676,3,1,-2
1676,1676,1677,1,3,2
1677,1677,1678,3,0,-3
1678,1678,1679,0,2,2
1679,1679,1680,2,1,-1
1680,1680,1681,1,1,0
1681,1681,1682,1,0,-1
1682,1682,1683,0,9,9
1683,1683,1684,9,9,0
1684,1684,1685,9,4,-5
1685,1685,1686,4,6,2
1686,1686,1687,6,7,1
1687,1687,1688,7,6,-1
1688,1688,1689,6,3,-3
1689,1689,1690,3,5,2
1690,1690,1691,5,5,0
1691,1691,1692,5,4,-1
1692,1692,1693,4,4,0
1693,1693,1694,4,6,2
1694,1694,1695,6,9,3
1695,1695,1696,9,1,-8
1696,1696,1697,1,1,0
1697,1697,1698,1,3,2
1698,1698,1699,3,1,-2
1699,1699,1700,1,1,0
1700,1700,1701,1,0,-1
1701,1701,1702,0,5,5
1702,1702,1703,5,1,-4
1703,1703,1704,1,4,3
1704,1704,1705,4,4,0
1705,1705,1706,4,6,2
1706,1706,1707,6,6,0
1707,1707,1708,6,6,0
1708,1708,1709,6,0,-6
1709,1709,1710,0,1,1
1710,1710,1711,1,2,1
1711,1711,1712,2,0,-2
1712,1712,1713,0,8,8
1713,1713,1714,8,2,-6
1714,1714,1715,2,2,0
1715,1715,1716,2,1,-1
1716,1716,1717,1,1,0
1717,1717,1718,1,3,2
1718,1718,1719,3,7,4
1719,1719,1720,7,9,2
1720,1720,1721,9,5,-4
1721,1721,1722,5,3,-2
1722,1722,1723,3,0,-3
1723,1723,1724,0,2,2
1724,1724,1725,2,0,-2
1725,1725,1726,0,6,6
1726,1726,1727,6,2,-4
1727,1727,1728,2,9,7
1728,1728,1729,9,0,-9
1729,1729,1730,0,7,7
1730,1730,1731,7,6,-1
1731,1731,1732,6,9,3
1732,1732,1733,9,9,0
1733,1733,1734,9,1,-8
1734,1734,1735,1,2,1
1735,1735,1736,2,9,7
1736,1736,1737,9,3,-6
1737,1737,1738,3,4,1
1738,1738,1739,4,7,3
1739,1739,1740,7,9,2
1740,1740,1741,9,6,-3
1741,1741,1742,6,0,-6
1742,1742,1743,0,9,9
1743,1743,1744,9,4,-5
1744,1744,1745,4,8,4
1745,1745,1746,8,7,-1
1746,1746,1747,7,7,0
1747,1747,1748,7,9,2
1748,1748,1749,9,8,-1
1749,1749,1750,8,6,-2
1750,1750,1751,6,9,3
1751,1751,1752,9,5,-4
1752,1752,1753,5,2,-3
1753,1753,1754,2,2,0
1754,1754,1755,2,2,0
1755,1755,1756,2,3,1
1756,1756,1757,3,9,6
1757,1757,1758,9,8,-1
1758,1758,1759,8,8,0
1759,1759,1760,8,8,0
1760,1760,1761,8,6,-2
1761,1761,1762,6,4,-2
1762,1762,1763,4,4,0
1763,1763,1764,4,4,0
1764,1764,1765,4,4,0
1765,1765,1766,4,2,-2
1766,1766,1767,2,4,2
1767,1767,1768,4,6,2
1768,1768,1769,6,0,-6
1769,1769,1770,0,7,7
1770,1770,1771,7,0,-7
1771,1771,1772,0,7,7
1772,1772,1773,7,8,1
1773,1773,1774,8,2,-6
1774,1774,1775,2,0,-2
1775,1775,1776,0,8,8
1776,1776,1777,8,8,0
1777,1777,1778,8,3,-5
1778,1778,1779,3,6,3
1779,1779,1780,6,8,2
1780,1780,1781,8,6,-2
1781,1781,1782,6,6,0
1782,1782,1783,6,8,2
1783,1783,1784,8,6,-2
1784,1784,1785,6,5,-1
1785,1785,1786,5,1,-4
1786,1786,1787,1,1,0
1787,1787,1788,1,8,7
1788,1788,1789,8,7,-1
1789,1789,1790,7,8,1
1790,1790,1791,8,3,-5
1791,1791,1792,3,6,3
1792,1792,1793,6,8,2
1793,1793,1794,8,9,1
1794,1794,1795,9,5,-4
1795,1795,1796,5,0,-5
1796,1796,1797,0,0,0
1797,1797,1798,0,0,0
1798,1798,1799,0,3,3
1799,1799,1800,3,2,-1
1800,1800,1801,2,6,4
1801,1801,1802,6,6,0
1802,1802,1803,6,7,1
1803,1803,1804,7,8,1
1804,1804,1805,8,3,-5
1805,1805,1806,3,5,2
1806,1806,1807,5,1,-4
1807,1807,1808,1,4,3
1808,1808,1809,4,3,-1
1809,1809,1810,3,5,2
1810,1810,1811,5,9,4
1811,1811,1812,9,4,-5
1812,1812,1813,4,5,1
1813,1813,1814,5,4,-1
1814,1814,1815,4,1,-3
1815,1815,1816,1,1,0
1816,1816,1817,1,5,4
1817,1817,1818,5,4,-1
1818,1818,1819,4,0,-4
1819,1819,1820,0,9,9
1820,1820,1821,9,7,-2
1821,1821,1822,7,1,-6
1822,1822,1823,1,2,1
1823,1823,1824,2,5,3
1824,1824,1825,5,7,2
1825,1825,1826,7,9,2
1826,1826,1827,9,4,-5
1827,1827,1828,4,0,-4
1828,1828,1829,0,3,3
1829,1829,1830,3,6,3
1830,1830,1831,6,1,-5
1831,1831,1832,1,7,6
1832,1832,1833,7,7,0
1833,1833,1834,7,5,-2
1834,1834,1835,5,6,1
1835,1835,1836,6,3,-3
1836,1836,1837,3,0,-3
1837,1837,1838,0,1,1
1838,1838,1839,1,1,0
1839,1839,1840,1,4,3
1840,1840,1841,4,2,-2
1841,1841,1842,2,4,2
1842,1842,1843,4,3,-1
1843,1843,1844,3,6,3
1844,1844,1845,6,4,-2
1845,1845,1846,4,7,3
1846,1846,1847,7,5,-2
1847,1847,1848,5,7,2
1848,1848,1849,7,6,-1
1849,1849,1850,6,9,3
1850,1850,1851,9,7,-2
1851,1851,1852,7,2,-5
1852,1852,1853,2,8,6
1853,1853,1854,8,4,-4
1854,1854,1855,4,9,5
1855,1855,1856,9,8,-1
1856,1856,1857,8,0,-8
1857,1857,1858,0,7,7
1858,1858,1859,7,1,-6
1859,1859,1860,1,1,0
1860,1860,1861,1,2,1
1861,1861,1862,2,3,1
1862,1862,1863,3,3,0
1863,1863,1864,3,5,2
1864,1864,1865,5,4,-1
1865,1865,1866,4,6,2
1866,1866,1867,6,5,-1
1867,1867,1868,5,0,-5
1868,1868,1869,0,6,6
1869,1869,1870,6,3,-3
1870,1870,1871,3,7,4
1871,1871,1872,7,3,-4
1872,1872,1873,3,8,5
1873,1873,1874,8,2,-6
1874,1874,1875,2,9,7
1875,1875,1876,9,0,-9
1876,1876,1877,0,0,0
1877,1877,1878,0,9,9
1878,1878,1879,9,1,-8
1879,1879,1880,1,2,1
1880,1880,1881,2,2,0
1881,1881,1882,2,9,7
1882,1882,1883,9,3,-6
1883,1883,1884,3,9,6
1884,1884,1885,9,4,-5
1885,1885,1886,4,6,2
1886,1886,1887,6,5,-1
1887,1887,1888,5,2,-3
1888,1888,1889,2,6,4
1889,1889,1890,6,6,0
1890,1890,1891,6,7,1
1891,1891,1892,7,6,-1
1892,1892,1893,6,8,2
1893,1893,1894,8,2,-6
1894,1894,1895,2,9,7
1895,1895,1896,9,2,-7
1896,1896,1897,2,0,-2
1897,1897,1898,0,6,6
1898,1898,1899,6,7,1
1899,1899,1900,7,2,-5
1900,1900,1901,2,8,6
1901,1901,1902,8,6,-2
1902,1902,1903,6,9,3
1903,1903,1904,9,0,-9
1904,1904,1905,0,9,9
1905,1905,1906,9,6,-3
1906,1906,1907,6,0,-6
1907,1907,1908,0,3,3
1908,1908,1909,3,1,-2
1909,1909,1910,1,1,0
1910,1910,1911,1,4,3
1911,1911,1912,4,9,5
1912,1912,1913,9,5,-4
1913,1913,1914,5,8,3
1914,1914,1915,8,1,-7
1915,1915,1916,1,0,-1
1916,1916,1917,0,6,6
1917,1917,1918,6,6,0
1918,1918,1919,6,7,1
1919,1919,1920,7,2,-5
1920,1920,1921,2,3,1
1921,1921,1922,3,4,1
1922,1922,1923,4,2,-2
1923,1923,1924,2,3,1
1924,1924,1925,3,9,6
1925,1925,1926,9,0,-9
1926,1926,1927,0,0,0
1927,1927,1928,0,4,4
1928,1928,1929,4,5,1
1929,1929,1930,5,0,-5
1930,1930,1931,0,6,6
1931,1931,1932,6,4,-2
1932,1932,1933,4,7,3
1933,1933,1934,7,4,-3
1934,1934,1935,4,3,-1
1935,1935,1936,3,1,-2
1936,1936,1937,1,9,8
1937,1937,1938,9,3,-6
1938,1938,1939,3,9,6
1939,1939,1940,9,9,0
1940,1940,1941,9,3,-6
1941,1941,1942,3,1,-2
1942,1942,1943,1,8,7
1943,1943,1944,8,7,-1
1944,1944,1945,7,1,-6
1945,1945,1946,1,7,6
1946,1946,1947,7,2,-5
1947,1947,1948,2,8,6
1948,1948,1949,8,9,1
1949,1949,1950,9,9,0
1950,1950,1951,9,6,-3
1951,1951,1952,6,2,-4
1952,1952,1953,2,7,5
1953,1953,1954,7,2,-5
1954,1954,1955,2,5,3
1955,1955,1956,5,0,-5
1956,1956,1957,0,6,6
1957,1957,1958,6,7,1
1958,1958,1959,7,3,-4
1959,1959,1960,3,9,6
1960,1960,1961,9,5,-4
1961,1961,1962,5,9,4
1962,1962,1963,9,0,-9
1963,1963,1964,0,8,8
1964,1964,1965,8,5,-3
1965,1965,1966,5,8,3
1966,1966,1967,8,4,-4
1967,1967,1968,4,9,5
1968,1968,1969,9,0,-9
1969,1969,1970,0,5,5
1970,1970,1971,5,3,-2
1971,1971,1972,3,2,-1
1972,1972,1973,2,4,2
1973,1973,1974,4,8,4
1974,1974,1975,8,7,-1
1975,1975,1976,7,4,-3
1976,1976,1977,4,1,-3
1977,1977,1978,1,5,4
1978,1978,1979,5,4,-1
1979,1979,1980,4,6,2
1980,1980,1981,6,3,-3
1981,1981,1982,3,7,4
1982,1982,1983,7,7,0
1983,1983,1984,7,9,2
1984,1984,1985,9,6,-3
1985,1985,1986,6,6,0
1986,1986,1987,6,2,-4
1987,1987,1988,2,2,0
1988,1988,1989,2,1,-1
1989,1989,1990,1,6,5
1990,1990,1991,6,5,-1
1991,1991,1992,5,4,-1
1992,1992,1993,4,5,1
1993,1993,1994,5,3,-2
1994,1994,1995,3,0,-3
1995,1995,1996,0,5,5
1996,1996,1997,5,5,0
1997,1997,1998,5,2,-3
1998,1998,1999,2,0,-2
1999,1999,2000,0,5,5
2000,2000,2001,5,8,3
2001,2001,2002,8,8,0
2002,2002,2003,8,4,-4
2003,2003,2004,4,2,-2
2004,2004,2005,2,6,4
2005,2005,2006,6,9,3
2006,2006,2007,9,7,-2
2007,2007,2008,7,1,-6
2008,2008,2009,1,0,-1
2009,2009,2010,0,2,2
2010,2010,2011,2,3,1
2011,2011,2012,3,1,-2
2012,2012,2013,1,8,7
2013,2013,2014,8,7,-1
2014,2014,2015,7,1,-6
2015,2015,2016,1,8,7
2016,2016,2017,8,2,-6
2017,2017,2018,2,7,5
2018,2018,2019,7,2,-5
2019,2019,2020,2,6,4
2020,2020,2021,6,3,-3
2021,2021,2022,3,2,-1
2022,2022,2023,2,3,1
2023,2023,2024,3,7,4
2024,2024,2025,7,6,-1
2025,2025,2026,6,8,2
2026,2026,2027,8,7,-1
2027,2027,2028,7,5,-2
2028,2028,2029,5,3,-2
2029,2029,2030,3,8,5
2030,2030,2031,8,4,-4
2031,2031,2032,4,4,0
2032,2032,2033,4,9,5
2033,2033,2034,9,4,-5
2034,2034,2035,4,6,2
2035,2035,2036,6,4,-2
2036,2036,2037,4,5,1
2037,2037,2038,5,5,0
2038,2038,2039,5,1,-4
2039,2039,2040,1,1,0
2040,2040,2041,1,9,8
2041,2041,2042,9,3,-6
2042,2042,2043,3,8,5
2043,2043,2044,8,6,-2
2044,2044,2045,6,1,-5
2045,2045,2046,1,4,3
2046,2046,2047,4,1,-3
2047,2047,2048,1,7,6
2048,2048,2049,7,5,-2
2049,2049,2050,5,4,-1
2050,2050,2051,4,0,-4
2051,2051,2052,0,4,4
2052,2052,2053,4,2,-2
2053,2053,2054,2,7,5
2054,2054,2055,7,7,0
2055,2055,2056,7,5,-2
2056,2056,2057,5,8,3
2057,2057,2058,8,0,-8
2058,2058,2059,0,6,6
2059,2059,2060,6,9,3
2060,2060,2061,9,6,-3
2061,2061,2062,6,6,0
2062,2062,2063,6,8,2
2063,2063,2064,8,7,-1
2064,2064,2065,7,2,-5
2065,2065,2066,2,0,-2
2066,2066,2067,0,8,8
2067,2067,2068,8,8,0
2068,2068,2069,8,4,-4
2069,2069,2070,4,8,4
2070,2070,2071,8,4,-4
2071,2071,2072,4,4,0
2072,2072,2073,4,2,-2
2073,2073,2074,2,3,1
2074,2074,2075,3,2,-1
2075,2075,2076,2,3,1
2076,2076,2077,3,8,5
2077,2077,2078,8,2,-6
2078,2078,2079,2,0,-2
2079,2079,2080,0,5,5
2080,2080,2081,5,0,-5
2081,2081,2082,0,0,0
2082,2082,2083,0,1,1
2083,2083,2084,1,0,-1
2084,2084,2085,0,2,2
2085,2085,2086,2,1,-1
2086,2086,2087,1,3,2
2087,2087,2088,3,3,0
2088,2088,2089,3,4,1
2089,2089,2090,4,7,3
2090,2090,2091,7,5,-2
2091,2091,2092,5,3,-2
2092,2092,2093,3,6,3
2093,2093,2094,6,1,-5
2094,2094,2095,1,7,6
2095,2095,2096,7,6,-1
2096,2096,2097,6,8,2
2097,2097,2098,8,3,-5
2098,2098,2099,3,9,6
2099,2099,2100,9,0,-9
2100,2100,2101,0,0,0
2101,2101,2102,0,7,7
2102,2102,2103,7,1,-6
2103,2103,2104,1,2,1
2104,2104,2105,2,2,0
2105,2105,2106,2,4,2
2106,2106,2107,4,3,-1
2107,2107,2108,3,7,4
2108,2108,2109,7,4,-3
2109,2109,2110,4,1,-3
2110,2110,2111,1,5,4
2111,2111,2112,5,0,-5
2112,2112,2113,0,6,6
2113,2113,2114,6,3,-3
2114,2114,2115,3,7,4
2115,2115,2116,7,9,2
2116,2116,2117,9,8,-1
2117,2117,2118,8,7,-1
2118,2118,2119,7,9,2
2119,2119,2120,9,5,-4
2120,2120,2121,5,0,-5
2121,2121,2122,0,1,1
2122,2122,2123,1,1,0
2123,2123,2124,1,8,7
2124,2124,2125,8,2,-6
2125,2125,2126,2,6,4
2126,2126,2127,6,3,-3
2127,2127,2128,3,3,0
2128,2128,2129,3,4,1
2129,2129,2130,4,3,-1
2130,2130,2131,3,5,2
2131,2131,2132,5,3,-2
2132,2132,2133,3,7,4
2133,2133,2134,7,1,-6
2134,2134,2135,1,8,7
2135,2135,2136,8,1,-7
2136,2136,2137,1,9,8
2137,2137,2138,9,6,-3
2138,2138,2139,6,8,2
2139,2139,2140,8,9,1
2140,2140,2141,9,9,0
2141,2141,2142,9,7,-2
2142,2142,2143,7,5,-2
2143,2143,2144,5,0,-5
2144,2144,2145,0,7,7
2145,2145,2146,7,3,-4
2146,2146,2147,3,0,-3
2147,2147,2148,0,6,6
2148,2148,2149,6,3,-3
2149,2149,2150,3,8,5
2150,2150,2151,8,1,-7
2151,2151,2152,1,6,5
2152,2152,2153,6,6,0
2153,2153,2154,6,1,-5
2154,2154,2155,1,8,7
2155,2155,2156,8,6,-2
2156,2156,2157,6,4,-2
2157,2157,2158,4,6,2
2158,2158,2159,6,1,-5
2159,2159,2160,1,0,-1
2160,2160,2161,0,7,7
2161,2161,2162,7,1,-6
2162,2162,2163,1,6,5
2163,2163,2164,6,4,-2
2164,2164,2165,4,5,1
2165,2165,2166,5,1,-4
2166,2166,2167,1,6,5
2167,2167,2168,6,7,1
2168,2168,2169,7,4,-3
2169,2169,2170,4,8,4
2170,2170,2171,8,2,-6
2171,2171,2172,2,5,3
2172,2172,2173,5,7,2
2173,2173,2174,7,3,-4
2174,2174,2175,3,8,5
2175,2175,2176,8,4,-4
2176,2176,2177,4,1,-3
2177,2177,2178,1,6,5
2178,2178,2179,6,3,-3
2179,2179,2180,3,3,0
2180,2180,2181,3,4,1
2181,2181,2182,4,5,1
2182,2182,2183,5,3,-2
2183,2183,2184,3,2,-1
2184,2184,2185,2,4,2
2185,2185,2186,4,5,1
2186,2186,2187,5,7,2
2187,2187,2188,7,1,-6
2188,2188,2189,1,2,1
2189,2189,2190,2,4,2
2190,2190,2191,4,0,-4
2191,2191,2192,0,0,0
2192,2192,2193,0,5,5
2193,2193,2194,5,8,3
2194,2194,2195,8,0,-8
2195,2195,2196,0,6,6
2196,2196,2197,6,1,-5
2197,2197,2198,1,1,0
2198,2198,2199,1,9,8
2199,2199,2200,9,3,-6
2200,2200,2201,3,2,-1
2201,2201,2202,2,1,-1
2202,2202,2203,1,3,2
2203,2203,2204,3,4,1
2204,2204,2205,4,2,-2
2205,2205,2206,2,4,2
2206,2206,2207,4,3,-1
2207,2207,2208,3,4,1
2208,2208,2209,4,5,1
2209,2209,2210,5,8,3
2210,2210,2211,8,5,-3
2211,2211,2212,5,6,1
2212,2212,2213,6,7,1
2213,2213,2214,7,6,-1
2214,2214,2215,6,8,2
2215,2215,2216,8,9,1
2216,2216,2217,9,4,-5
2217,2217,2218,4,0,-4
2218,2218,2219,0,9,9
2219,2219,2220,9,4,-5
2220,2220,2221,4,9,5
2221,2221,2222,9,4,-5
2222,2222,2223,4,7,3
2223,2223,2224,7,4,-3
2224,2224,2225,4,1,-3
2225,2225,2226,1,6,5
2226,2226,2227,6,1,-5
2227,2227,2228,1,3,2
2228,2228,2229,3,7,4
2229,2229,2230,7,3,-4
2230,2230,2231,3,8,5
2231,2231,2232,8,3,-5
2232,2232,2233,3,3,0
2233,2233,2234,3,2,-1
2234,2234,2235,2,4,2
2235,2235,2236,4,4,0
2236,2236,2237,4,8,4
2237,2237,2238,8,7,-1
2238,2238,2239,7,6,-1
2239,2239,2240,6,4,-2
2240,2240,2241,4,3,-1
2241,2241,2242,3,6,3
2242,2242,2243,6,8,2
2243,2243,2244,8,7,-1
2244,2244,2245,7,0,-7
2245,2245,2246,0,7,7
2246,2246,2247,7,9,2
2247,2247,2248,9,5,-4
2248,2248,2249,5,6,1
2249,2249,2250,6,5,-1
2250,2250,2251,5,2,-3
2251,2251,2252,2,3,1
2252,2252,2253,3,0,-3
2253,2253,2254,0,4,4
2254,2254,2255,4,1,-3
2255,2255,2256,1,4,3
2256,2256,2257,4,0,-4
2257,2257,2258,0,5,5
2258,2258,2259,5,6,1
2259,2259,2260,6,1,-5
2260,2260,2261,1,2,1
2261,2261,2262,2,6,4
2262,2262,2263,6,3,-3
2263,2263,2264,3,4,1
2264,2264,2265,4,8,4
2265,2265,2266,8,5,-3
2266,2266,2267,5,9,4
2267,2267,2268,9,5,-4
2268,2268,2269,5,0,-5
2269,2269,2270,0,2,2
2270,2270,2271,2,7,5
2271,2271,2272,7,5,-2
2272,2272,2273,5,2,-3
2273,2273,2274,2,9,7
2274,2274,2275,9,3,-6
2275,2275,2276,3,4,1
2276,2276,2277,4,4,0
2277,2277,2278,4,0,-4
2278,2278,2279,0,5,5
2279,2279,2280,5,2,-3
2280,2280,2281,2,5,3
2281,2281,2282,5,5,0
2282,2282,2283,5,2,-3
2283,2283,2284,2,9,7
2284,2284,2285,9,8,-1
2285,2285,2286,8,3,-5
2286,2286,2287,3,5,2
2287,2287,2288,5,2,-3
2288,2288,2289,2,4,2
2289,2289,2290,4,4,0
2290,2290,2291,4,6,2
2291,2291,2292,6,7,1
2292,2292,2293,7,6,-1
2293,2293,2294,6,4,-2
2294,2294,2295,4,6,2
2295,2295,2296,6,6,0
2296,2296,2297,6,7,1
2297,2297,2298,7,0,-7
2298,2298,2299,0,9,9
2299,2299,2300,9,6,-3
2300,2300,2301,6,1,-5
2301,2301,2302,1,8,7
2302,2302,2303,8,8,0
2303,2303,2304,8,5,-3
2304,2304,2305,5,2,-3
2305,2305,2306,2,1,-1
2306,2306,2307,1,1,0
2307,2307,2308,1,5,4
2308,2308,2309,5,2,-3
2309,2309,2310,2,0,-2
2310,2310,2311,0,6,6
2311,2311,2312,6,9,3
2312,2312,2313,9,5,-4
2313,2313,2314,5,2,-3
2314,2314,2315,2,3,1
2315,2315,2316,3,1,-2
2316,2316,2317,1,4,3
2317,2317,2318,4,1,-3
2318,2318,2319,1,7,6
2319,2319,2320,7,6,-1
2320,2320,2321,6,9,3
2321,2321,2322,9,2,-7
2322,2322,2323,2,4,2
2323,2323,2324,4,6,2
2324,2324,2325,6,0,-6
2325,2325,2326,0,1,1
2326,2326,2327,1,0,-1
2327,2327,2328,0,5,5
2328,2328,2329,5,5,0
2329,2329,2330,5,5,0
2330,2330,2331,5,9,4
2331,2331,2332,9,2,-7
2332,2332,2333,2,0,-2
2333,2333,2334,0,4,4
2334,2334,2335,4,1,-3
2335,2335,2336,1,1,0
2336,2336,2337,1,2,1
2337,2337,2338,2,4,2
2338,2338,2339,4,3,-1
2339,2339,2340,3,0,-3
2340,2340,2341,0,4,4
2341,2341,2342,4,2,-2
2342,2342,2343,2,5,3
2343,2343,2344,5,7,2
2344,2344,2345,7,6,-1
2345,2345,2346,6,2,-4
2346,2346,2347,2,7,5
2347,2347,2348,7,7,0
2348,2348,2349,7,8,1
2349,2349,2350,8,3,-5
2350,2350,2351,3,9,6
2351,2351,2352,9,0,-9
2352,2352,2353,0,0,0
2353,2353,2354,0,2,2
2354,2354,2355,2,1,-1
2355,2355,2356,1,1,0
2356,2356,2357,1,2,1
2357,2357,2358,2,8,6
2358,2358,2359,8,3,-5
2359,2359,2360,3,4,1
2360,2360,2361,4,4,0
2361,2361,2362,4,1,-3
2362,2362,2363,1,5,4
2363,2363,2364,5,9,4
2364,2364,2365,9,6,-3
2365,2365,2366,6,1,-5
2366,2366,2367,1,7,6
2367,2367,2368,7,5,-2
2368,2368,2369,5,8,3
2369,2369,2370,8,9,1
2370,2370,2371,9,9,0
2371,2371,2372,9,6,-3
2372,2372,2373,6,0,-6
2373,2373,2374,0,1,1
2374,2374,2375,1,1,0
2375,2375,2376,1,7,6
2376,2376,2377,7,2,-5
2377,2377,2378,2,8,6
2378,2378,2379,8,3,-5
2379,2379,2380,3,7,4
2380,2380,2381,7,7,0
2381,2381,2382,7,8,1
2382,2382,2383,8,8,0
2383,2383,2384,8,8,0
2384,2384,2385,8,9,1
2385,2385,2386,9,7,-2
2386,2386,2387,7,6,-1
2387,2387,2388,6,8,2
2388,2388,2389,8,2,-6
2389,2389,2390,2,4,2
2390,2390,2391,4,7,3
2391,2391,2392,7,4,-3
2392,2392,2393,4,1,-3
2393,2393,2394,1,8,7
2394,2394,2395,8,5,-3
2395,2395,2396,5,0,-5
2396,2396,2397,0,6,6
2397,2397,2398,6,9,3
2398,2398,2399,9,2,-7
2399,2399,2400,2,8,6
2400,2400,2401,8,5,-3
2401,2401,2402,5,2,-3
2402,2402,2403,2,0,-2
2403,2403,2404,0,0,0
2404,2404,2405,0,5,5
2405,2405,2406,5,4,-1
2406,2406,2407,4,4,0
2407,2407,2408,4,3,-1
2408,2408,2409,3,2,-1
2409,2409,2410,2,1,-1
2410,2410,2411,1,0,-1
2411,2411,2412,0,5,5
2412,2412,2413,5,8,3
2413,2413,2414,8,5,-3
2414,2414,2415,5,1,-4
2415,2415,2416,1,4,3
2416,2416,2417,4,7,3
2417,2417,2418,7,2,-5
2418,2418,2419,2,1,-1
2419,2419,2420,1,4,3
2420,2420,2421,4,8,4
2421,2421,2422,8,6,-2
2422,2422,2423,6,3,-3
2423,2423,2424,3,4,1
2424,2424,2425,4,8,4
2425,2425,2426,8,1,-7
2426,2426,2427,1,7,6
2427,2427,2428,7,5,-2
2428,2428,2429,5,1,-4
2429,2429,2430,1,3,2
2430,2430,2431,3,7,4
2431,2431,2432,7,1,-6
2432,2432,2433,1,7,6
2433,2433,2434,7,9,2
2434,2434,2435,9,0,-9
2435,2435,2436,0,0,0
2436,2436,2437,0,1,1
2437,2437,2438,1,9,8
2438,2438,2439,9,4,-5
2439,2439,2440,4,0,-4
2440,2440,2441,0,4,4
2441,2441,2442,4,8,4
2442,2442,2443,8,4,-4
2443,2443,2444,4,8,4
2444,2444,2445,8,5,-3
2445,2445,2446,5,1,-4
2446,2446,2447,1,7,6
2447,2447,2448,7,1,-6
2448,2448,2449,1,4,3
2449,2449,2450,4,2,-2
2450,2450,2451,2,4,2
2451,2451,2452,4,4,0
2452,2452,2453,4,9,5
2453,2453,2454,9,2,-7
2454,2454,2455,2,7,5
2455,2455,2456,7,3,-4
2456,2456,2457,3,2,-1
2457,2457,2458,2,4,2
2458,2458,2459,4,6,2
2459,2459,2460,6,9,3
2460,2460,2461,9,5,-4
2461,2461,2462,5,1,-4
2462,2462,2463,1,3,2
2463,2463,2464,3,2,-1
2464,2464,2465,2,9,7
2465,2465,2466,9,4,-5
2466,2466,2467,4,4,0
2467,2467,2468,4,3,-1
2468,2468,2469,3,3,0
2469,2469,2470,3,6,3
2470,2470,2471,6,9,3
2471,2471,2472,9,2,-7
2472,2472,2473,2,0,-2
2473,2473,2474,0,6,6
2474,2474,2475,6,8,2
2475,2475,2476,8,8,0
2476,2476,2477,8,7,-1
2477,2477,2478,7,5,-2
2478,2478,2479,5,6,1
2479,2479,2480,6,6,0
2480,2480,2481,6,3,-3
2481,2481,2482,3,8,5
2482,2482,2483,8,0,-8
2483,2483,2484,0,4,4
2484,2484,2485,4,4,0
2485,2485,2486,4,6,2
2486,2486,2487,6,6,0
2487,2487,2488,6,7,1
2488,2488,2489,7,3,-4
2489,2489,2490,3,4,1
2490,2490,2491,4,7,3
2491,2491,2492,7,7,0
2492,2492,2493,7,0,-7
2493,2493,2494,0,6,6
2494,2494,2495,6,1,-5
2495,2495,2496,1,6,5
2496,2496,2497,6,1,-5
2497,2497,2498,1,6,5
2498,2498,2499,6,2,-4
2499,2499,2500,2,0,-2
2500,2500,2501,0,9,9
2501,2501,2502,9,7,-2
2502,2502,2503,7,3,-4
2503,2503,2504,3,6,3
2504,2504,2505,6,1,-5
2505,2505,2506,1,3,2
2506,2506,2507,3,8,5
2507,2507,2508,8,2,-6
2508,2508,2509,2,9,7
2509,2509,2510,9,2,-7
2510,2510,2511,2,8,6
2511,2511,2512,8,7,-1
2512,2512,2513,7,2,-5
2513,2513,2514,2,9,7
2514,2514,2515,9,5,-4
2515,2515,2516,5,6,1
2516,2516,2517,6,2,-4
2517,2517,2518,2,2,0
2518,2518,2519,2,6,4
2519,2519,2520,6,4,-2
2520,2520,2521,4,9,5
2521,2521,2522,9,7,-2
2522,2522,2523,7,6,-1
2523,2523,2524,6,3,-3
2524,2524,2525,3,0,-3
2525,2525,2526,0,0,0
2526,2526,2527,0,5,5
2527,2527,2528,5,0,-5
2528,2528,2529,0,3,3
2529,2529,2530,3,1,-2
2530,2530,2531,1,3,2
2531,2531,2532,3,0,-3
2532,2532,2533,0,6,6
2533,2533,2534,6,2,-4
2534,2534,2535,2,3,1
2535,2535,2536,3,3,0
2536,2536,2537,3,5,2
2537,2537,2538,5,0,-5
2538,2538,2539,0,0,0
2539,2539,2540,0,7,7
2540,2540,2541,7,3,-4
2541,2541,2542,3,4,1
2542,2542,2543,4,7,3
2543,2543,2544,7,5,-2
2544,2544,2545,5,6,1
2545,2545,2546,6,4,-2
2546,2546,2547,4,1,-3
2547,2547,2548,1,4,3
2548,2548,2549,4,5,1
2549,2549,2550,5,2,-3
2550,2550,2551,2,5,3
2551,2551,2552,5,1,-4
2552,2552,2553,1,9,8
2553,2553,2554,9,5,-4
2554,2554,2555,5,8,3
2555,2555,2556,8,6,-2
2556,2556,2557,6,0,-6
2557,2557,2558,0,7,7
2558,2558,2559,7,9,2
2559,2559,2560,9,4,-5
2560,2560,2561,4,0,-4
2561,2561,2562,0,9,9
2562,2562,2563,9,1,-8
2563,2563,2564,1,3,2
2564,2564,2565,3,2,-1
2565,2565,2566,2,5,3
2566,2566,2567,5,3,-2
2567,2567,2568,3,3,0
2568,2568,2569,3,4,1
2569,2569,2570,4,6,2
2570,2570,2571,6,5,-1
2571,2571,2572,5,1,-4
2572,2572,2573,1,6,5
2573,2573,2574,6,7,1
2574,2574,2575,7,7,0
2575,2575,2576,7,7,0
2576,2576,2577,7,8,1
2577,2577,2578,8,4,-4
2578,2578,2579,4,9,5
2579,2579,2580,9,3,-6
2580,2580,2581,3,0,-3
2581,2581,2582,0,0,0
2582,2582,2583,0,1,1
2583,2583,2584,1,0,-1
2584,2584,2585,0,2,2
2585,2585,2586,2,0,-2
2586,2586,2587,0,3,3
2587,2587,2588,3,6,3
2588,2588,2589,6,4,-2
2589,2589,2590,4,6,2
2590,2590,2591,6,7,1
2591,2591,2592,7,5,-2
2592,2592,2593,5,8,3
2593,2593,2594,8,1,-7
2594,2594,2595,1,9,8
2595,2595,2596,9,4,-5
2596,2596,2597,4,0,-4
2597,2597,2598,0,8,8
2598,2598,2599,8,1,-7
2599,2599,2600,1,9,8
2600,2600,2601,9,2,-7
2601,2601,2602,2,6,4
2602,2602,2603,6,3,-3
2603,2603,2604,3,1,-2
2604,2604,2605,1,5,4
2605,2605,2606,5,0,-5
2606,2606,2607,0,6,6
2607,2607,2608,6,4,-2
2608,2608,2609,4,7,3
2609,2609,2610,7,8,1
2610,2610,2611,8,8,0
2611,2611,2612,8,7,-1
2612,2612,2613,7,9,2
2613,2613,2614,9,6,-3
2614,2614,2615,6,0,-6
2615,2615,2616,0,1,1
2616,2616,2617,1,0,-1
2617,2617,2618,0,7,7
2618,2618,2619,7,1,-6
2619,2619,2620,1,5,4
2620,2620,2621,5,0,-5
2621,2621,2622,0,5,5
2622,2622,2623,5,1,-4
2623,2623,2624,1,0,-1
2624,2624,2625,0,2,2
2625,2625,2626,2,2,0
2626,2626,2627,2,3,1
2627,2627,2628,3,8,5
2628,2628,2629,8,0,-8
2629,2629,2630,0,1,1
2630,2630,2631,1,6,5
2631,2631,2632,6,3,-3
2632,2632,2633,3,9,6
2633,2633,2634,9,7,-2
2634,2634,2635,7,6,-1
2635,2635,2636,6,8,2
2636,2636,2637,8,6,-2
2637,2637,2638,6,6,0
2638,2638,2639,6,5,-1
2639,2639,2640,5,9,4
2640,2640,2641,9,2,-7
2641,2641,2642,2,0,-2
2642,2642,2643,0,9,9
2643,2643,2644,9,6,-3
2644,2644,2645,6,1,-5
2645,2645,2646,1,5,4
2646,2646,2647,5,4,-1
2647,2647,2648,4,2,-2
2648,2648,2649,2,9,7
2649,2649,2650,9,7,-2
2650,2650,2651,7,5,-2
2651,2651,2652,5,3,-2
2652,2652,2653,3,7,4
2653,2653,2654,7,1,-6
2654,2654,2655,1,5,4
2655,2655,2656,5,6,1
2656,2656,2657,6,6,0
2657,2657,2658,6,7,1
2658,2658,2659,7,7,0
2659,2659,2660,7,3,-4
2660,2660,2661,3,3,0
2661,2661,2662,3,6,3
2662,2662,2663,6,1,-5
2663,2663,2664,1,2,1
2664,2664,2665,2,4,2
2665,2665,2666,4,7,3
2666,2666,2667,7,1,-6
2667,2667,2668,1,8,7
2668,2668,2669,8,3,-5
2669,2669,2670,3,2,-1
2670,2670,2671,2,3,1
2671,2671,2672,3,8,5
2672,2672,2673,8,7,-1
2673,2673,2674,7,5,-2
2674,2674,2675,5,3,-2
2675,2675,2676,3,7,4
2676,2676,2677,7,9,2
2677,2677,2678,9,8,-1
2678,2678,2679,8,8,0
2679,2679,2680,8,6,-2
2680,2680,2681,6,8,2
2681,2681,2682,8,8,0
2682,2682,2683,8,8,0
2683,2683,2684,8,2,-6
2684,2684,2685,2,8,6
2685,2685,2686,8,4,-4
2686,2686,2687,4,8,4
2687,2687,2688,8,1,-7
2688,2688,2689,1,4,3
2689,2689,2690,4,5,1
2690,2690,2691,5,7,2
2691,2691,2692,7,1,-6
2692,2692,2693,1,2,1
2693,2693,2694,2,2,0
2694,2694,2695,2,1,-1
2695,2695,2696,1,9,8
2696,2696,2697,9,9,0
2697,2697,2698,9,5,-4
2698,2698,2699,5,8,3
2699,2699,2700,8,2,-6
2700,2700,2701,2,7,5
2701,2701,2702,7,9,2
2702,2702,2703,9,9,0
2703,2703,2704,9,7,-2
2704,2704,2705,7,3,-4
2705,2705,2706,3,7,4
2706,2706,2707,7,3,-4
2707,2707,2708,3,1,-2
2708,2708,2709,1,0,-1
2709,2709,2710,0,6,6
2710,2710,2711,6,7,1
2711,2711,2712,7,9,2
2712,2712,2713,9,5,-4
2713,2713,2714,5,2,-3
2714,2714,2715,2,4,2
2715,2715,2716,4,1,-3
2716,2716,2717,1,1,0
2717,2717,2718,1,0,-1
2718,2718,2719,0,1,1
2719,2719,2720,1,3,2
2720,2720,2721,3,2,-1
2721,2721,2722,2,9,7
2722,2722,2723,9,6,-3
2723,2723,2724,6,4,-2
2724,2724,2725,4,1,-3
2725,2725,2726,1,3,2
2726,2726,2727,3,5,2
2727,2727,2728,5,9,4
2728,2728,2729,9,0,-9
2729,2729,2730,0,1,1
2730,2730,2731,1,1,0
2731,2731,2732,1,4,3
2732,2732,2733,4,2,-2
2733,2733,2734,2,3,1
2734,2734,2735,3,3,0
2735,2735,2736,3,0,-3
2736,2736,2737,0,4,4
2737,2737,2738,4,2,-2
2738,2738,2739,2,5,3
2739,2739,2740,5,3,-2
2740,2740,2741,3,6,3
2741,2741,2742,6,4,-2
2742,2742,2743,4,7,3
2743,2743,2744,7,5,-2
2744,2744,2745,5,0,-5
2745,2745,2746,0,0,0
2746,2746,2747,0,1,1
2747,2747,2748,1,2,1
2748,2748,2749,2,2,0
2749,2749,2750,2,7,5
2750,2750,2751,7,3,-4
2751,2751,2752,3,7,4
2752,2752,2753,7,4,-3
2753,2753,2754,4,7,3
2754,2754,2755,7,5,-2
2755,2755,2756,5,6,1
2756,2756,2757,6,6,0
2757,2757,2758,6,5,-1
2758,2758,2759,5,7,2
2759,2759,2760,7,3,-4
2760,2760,2761,3,8,5
2761,2761,2762,8,1,-7
2762,2762,2763,1,9,8
2763,2763,2764,9,9,0
2764,2764,2765,9,0,-9
2765,2765,2766,0,7,7
2766,2766,2767,7,1,-6
2767,2767,2768,1,8,7
2768,2768,2769,8,2,-6
2769,2769,2770,2,0,-2
2770,2770,2771,0,3,3
2771,2771,2772,3,4,1
2772,2772,2773,4,4,0
2773,2773,2774,4,3,-1
2774,2774,2775,3,5,2
2775,2775,2776,5,1,-4
2776,2776,2777,1,6,5
2777,2777,2778,6,7,1
2778,2778,2779,7,9,2
2779,2779,2780,9,5,-4
2780,2780,2781,5,8,3
2781,2781,2782,8,0,-8
2782,2782,2783,0,2,2
2783,2783,2784,2,1,-1
2784,2784,2785,1,6,5
2785,2785,2786,6,3,-3
2786,2786,2787,3,9,6
2787,2787,2788,9,3,-6
2788,2788,2789,3,6,3
2789,2789,2790,6,2,-4
2790,2790,2791,2,1,-1
2791,2791,2792,1,2,1
2792,2792,2793,2,9,7
2793,2793,2794,9,1,-8
2794,2794,2795,1,9,8
2795,2795,2796,9,3,-6
2796,2796,2797,3,9,6
2797,2797,2798,9,9,0
2798,2798,2799,9,4,-5
2799,2799,2800,4,4,0
2800,2800,2801,4,4,0
2801,2801,2802,4,2,-2
2802,2802,2803,2,3,1
2803,2803,2804,3,9,6
2804,2804,2805,9,8,-1
2805,2805,2806,8,0,-8
2806,2806,2807,0,1,1
2807,2807,2808,1,4,3
2808,2808,2809,4,4,0
2809,2809,2810,4,8,4
2810,2810,2811,8,1,-7
2811,2811,2812,1,2,1
2812,2812,2813,2,2,0
2813,2813,2814,2,7,5
2814,2814,2815,7,9,2
2815,2815,2816,9,3,-6
2816,2816,2817,3,0,-3
2817,2817,2818,0,3,3
2818,2818,2819,3,4,1
2819,2819,2820,4,3,-1
2820,2820,2821,3,9,6
2821,2821,2822,9,6,-3
2822,2822,2823,6,1,-5
2823,2823,2824,1,2,1
2824,2824,2825,2,7,5
2825,2825,2826,7,0,-7
2826,2826,2827,0,4,4
2827,2827,2828,4,6,2
2828,2828,2829,6,4,-2
2829,2829,2830,4,1,-3
2830,2830,2831,1,1,0
2831,2831,2832,1,4,3
2832,2832,2833,4,8,4
2833,2833,2834,8,3,-5
2834,2834,2835,3,7,4
2835,2835,2836,7,6,-1
2836,2836,2837,6,6,0
2837,2837,2838,6,2,-4
2838,2838,2839,2,0,-2
2839,2839,2840,0,2,2
2840,2840,2841,2,8,6
2841,2841,2842,8,8,0
2842,2842,2843,8,1,-7
2843,2843,2844,1,7,6
2844,2844,2845,7,8,1
2845,2845,2846,8,2,-6
2846,2846,2847,2,2,0
2847,2847,2848,2,7,5
2848,2848,2849,7,6,-1
2849,2849,2850,6,6,0
2850,2850,2851,6,2,-4
2851,2851,2852,2,7,5
2852,2852,2853,7,1,-6
2853,2853,2854,1,0,-1
2854,2854,2855,0,2,2
2855,2855,2856,2,4,2
2856,2856,2857,4,5,1
2857,2857,2858,5,1,-4
2858,2858,2859,1,4,3
2859,2859,2860,4,9,5
2860,2860,2861,9,5,-4
2861,2861,2862,5,6,1
2862,2862,2863,6,6,0
2863,2863,2864,6,0,-6
2864,2864,2865,0,7,7
2865,2865,2866,7,2,-5
2866,2866,2867,2,7,5
2867,2867,2868,7,5,-2
2868,2868,2869,5,5,0
2869,2869,2870,5,1,-4
2870,2870,2871,1,3,2
2871,2871,2872,3,1,-2
2872,2872,2873,1,0,-1
2873,2873,2874,0,4,4
2874,2874,2875,4,2,-2
2875,2875,2876,2,1,-1
2876,2876,2877,1,2,1
2877,2877,2878,2,1,-1
2878,2878,2879,1,2,1
2879,2879,2880,2,6,4
2880,2880,2881,6,7,1
2881,2881,2882,7,0,-7
2882,2882,2883,0,3,3
2883,2883,2884,3,6,3
2884,2884,2885,6,5,-1
2885,2885,2886,5,3,-2
2886,2886,2887,3,2,-1
2887,2887,2888,2,4,2
2888,2888,2889,4,1,-3
2889,2889,2890,1,0,-1
2890,2890,2891,0,4,4
2891,2891,2892,4,2,-2
2892,2892,2893,2,4,2
2893,2893,2894,4,1,-3
2894,2894,2895,1,3,2
2895,2895,2896,3,4,1
2896,2896,2897,4,0,-4
2897,2897,2898,0,6,6
2898,2898,2899,6,0,-6
2899,2899,2900,0,5,5
2900,2900,2901,5,8,3
2901,2901,2902,8,4,-4
2902,2902,2903,4,7,3
2903,2903,2904,7,0,-7
2904,2904,2905,0,3,3
2905,2905,2906,3,1,-2
2906,2906,2907,1,1,0
2907,2907,2908,1,2,1
2908,2908,2909,2,7,5
2909,2909,2910,7,6,-1
2910,2910,2911,6,9,3
2911,2911,2912,9,5,-4
2912,2912,2913,5,6,1
2913,2913,2914,6,0,-6
2914,2914,2915,0,3,3
2915,2915,2916,3,5,2
2916,2916,2917,5,3,-2
2917,2917,2918,3,1,-2
2918,2918,2919,1,0,-1
2919,2919,2920,0,1,1
2920,2920,2921,1,5,4
2921,2921,2922,5,4,-1
2922,2922,2923,4,6,2
2923,2923,2924,6,9,3
2924,2924,2925,9,6,-3
2925,2925,2926,6,3,-3
2926,2926,2927,3,8,5
2927,2927,2928,8,5,-3
2928,2928,2929,5,7,2
2929,2929,2930,7,6,-1
2930,2930,2931,6,3,-3
2931,2931,2932,3,1,-2
2932,2932,2933,1,5,4
2933,2933,2934,5,9,4
2934,2934,2935,9,0,-9
2935,2935,2936,0,2,2
2936,2936,2937,2,1,-1
2937,2937,2938,1,1,0
2938,2938,2939,1,2,1
2939,2939,2940,2,8,6
2940,2940,2941,8,3,-5
2941,2941,2942,3,8,5
2942,2942,2943,8,4,-4
2943,2943,2944,4,0,-4
2944,2944,2945,0,5,5
2945,2945,2946,5,5,0
2946,2946,2947,5,6,1
2947,2947,2948,6,5,-1
2948,2948,2949,5,7,2
2949,2949,2950,7,7,0
2950,2950,2951,7,8,1
2951,2951,2952,8,0,-8
2952,2952,2953,0,9,9
2953,2953,2954,9,6,-3
2954,2954,2955,6,0,-6
2955,2955,2956,0,9,9
2956,2956,2957,9,1,-8
2957,2957,2958,1,8,7
2958,2958,2959,8,2,-6
2959,2959,2960,2,3,1
2960,2960,2961,3,3,0
2961,2961,2962,3,4,1
2962,2962,2963,4,4,0
2963,2963,2964,4,3,-1
2964,2964,2965,3,5,2
2965,2965,2966,5,5,0
2966,2966,2967,5,6,1
2967,2967,2968,6,5,-1
2968,2968,2969,5,7,2
2969,2969,2970,7,1,-6
2970,2970,2971,1,8,7
2971,2971,2972,8,8,0
2972,2972,2973,8,9,1
2973,2973,2974,9,0,-9
2974,2974,2975,0,0,0
2975,2975,2976,0,2,2
2976,2976,2977,2,1,-1
2977,2977,2978,1,6,5
2978,2978,2979,6,2,-4
2979,2979,2980,2,7,5
2980,2980,2981,7,3,-4
2981,2981,2982,3,7,4
2982,2982,2983,7,4,-3
2983,2983,2984,4,7,3
2984,2984,2985,7,7,0
2985,2985,2986,7,7,0
2986,2986,2987,7,8,1
2987,2987,2988,8,1,-7
2988,2988,2989,1,9,8
2989,2989,2990,9,4,-5
2990,2990,2991,4,8,4
2991,2991,2992,8,6,-2
2992,2992,2993,6,5,-1
2993,2993,2994,5,1,-4
2994,2994,2995,1,7,6
2995,2995,2996,7,0,-7
2996,2996,2997,0,9,9
2997,2997,2998,9,1,-8
2998,2998,2999,1,5,4
2999,2999,3000,5,9,4
3000,3000,3001,9,0,-9
3001,3001,3002,0,8,8
3002,3002,3003,8,8,0
3003,3003,3004,8,1,-7
3004,3004,3005,1,3,2
3005,3005,3006,3,2,-1
3006,3006,3007,2,5,3
3007,3007,3008,5,7,2
3008,3008,3009,7,4,-3
3009,3009,3010,4,7,3
3010,3010,3011,7,8,1
3011,3011,3012,8,0,-8
3012,3012,3013,0,3,3
3013,3013,3014,3,8,5
3014,3014,3015,8,0,-8
3015,3015,3016,0,0,0
3016,3016,3017,0,2,2
3017,3017,3018,2,4,2
3018,3018,3019,4,1,-3
3019,3019,3020,1,9,8
3020,3020,3021,9,0,-9
3021,3021,3022,0,9,9
3022,3022,3023,9,2,-7
3023,3023,3024,2,0,-2
3024,3024,3025,0,5,5
3025,3025,3026,5,8,3
3026,3026,3027,8,8,0
3027,3027,3028,8,8,0
3028,3028,3029,8,8,0
3029,3029,3030,8,9,1
3030,3030,3031,9,5,-4
3031,3031,3032,5,8,3
3032,3032,3033,8,3,-5
3033,3033,3034,3,3,0
3034,3034,3035,3,0,-3
3035,3035,3036,0,6,6
3036,3036,3037,6,4,-2
3037,3037,3038,4,4,0
3038,3038,3039,4,4,0
3039,3039,3040,4,8,4
3040,3040,3041,8,1,-7
3041,3041,3042,1,2,1
3042,3042,3043,2,6,4
3043,3043,3044,6,9,3
3044,3044,3045,9,1,-8
3045,3045,3046,1,6,5
3046,3046,3047,6,3,-3
3047,3047,3048,3,3,0
3048,3048,3049,3,0,-3
3049,3049,3050,0,6,6
3050,3050,3051,6,3,-3
3051,3051,3052,3,4,1
3052,3052,3053,4,6,2
3053,3053,3054,6,2,-4
3054,3054,3055,2,9,7
3055,3055,3056,9,4,-5
3056,3056,3057,4,3,-1
3057,3057,3058,3,6,3
3058,3058,3059,6,7,1
3059,3059,3060,7,7,0
3060,3060,3061,7,4,-3
3061,3061,3062,4,5,1
3062,3062,3063,5,9,4
3063,3063,3064,9,2,-7
3064,3064,3065,2,7,5
3065,3065,3066,7,8,1
3066,3066,3067,8,0,-8
3067,3067,3068,0,1,1
3068,3068,3069,1,9,8
3069,3069,3070,9,1,-8
3070,3070,3071,1,4,3
3071,3071,3072,4,4,0
3072,3072,3073,4,8,4
3073,3073,3074,8,4,-4
3074,3074,3075,4,3,-1
3075,3075,3076,3,9,6
3076,3076,3077,9,2,-7
3077,3077,3078,2,2,0
3078,3078,3079,2,7,5
3079,3079,3080,7,1,-6
3080,3080,3081,1,7,6
3081,3081,3082,7,8,1
3082,3082,3083,8,9,1
3083,3083,3084,9,9,0
3084,3084,3085,9,5,-4
3085,3085,3086,5,8,3
3086,3086,3087,8,7,-1
3087,3087,3088,7,4,-3
3088,3088,3089,4,6,2
3089,3089,3090,6,9,3
3090,3090,3091,9,4,-5
3091,3091,3092,4,4,0
3092,3092,3093,4,8,4
3093,3093,3094,8,8,0
3094,3094,3095,8,9,1
3095,3095,3096,9,6,-3
3096,3096,3097,6,6,0
3097,3097,3098,6,6,0
3098,3098,3099,6,9,3
3099,3099,3100,9,4,-5
3100,3100,3101,4,4,0
3101,3101,3102,4,2,-2
3102,3102,3103,2,1,-1
3103,3103,3104,1,9,8
3104,3104,3105,9,2,-7
3105,3105,3106,2,0,-2
3106,3106,3107,0,0,0
3107,3107,3108,0,3,3
3108,3108,3109,3,6,3
3109,3109,3110,6,4,-2
3110,3110,3111,4,1,-3
3111,3111,3112,1,2,1
3112,3112,3113,2,1,-1
3113,3113,3114,1,8,7
3114,3114,3115,8,6,-2
3115,3115,3116,6,7,1
3116,3116,3117,7,4,-3
3117,3117,3118,4,5,1
3118,3118,3119,5,8,3
3119,3119,3120,8,1,-7
3120,3120,3121,1,9,8
3121,3121,3122,9,1,-8
3122,3122,3123,1,6,5
3123,3123,3124,6,3,-3
3124,3124,3125,3,4,1
3125,3125,3126,4,5,1
3126,3126,3127,5,6,1
3127,3127,3128,6,0,-6
3128,3128,3129,0,5,5
3129,3129,3130,5,1,-4
3130,3130,3131,1,0,-1
3131,3131,3132,0,1,1
3132,3132,3133,1,2,1
3133,3133,3134,2,2,0
3134,3134,3135,2,0,-2
3135,3135,3136,0,6,6
3136,3136,3137,6,5,-1
3137,3137,3138,5,4,-1
3138,3138,3139,4,6,2
3139,3139,3140,6,7,1
3140,3140,3141,7,5,-2
3141,3141,3142,5,2,-3
3142,3142,3143,2,0,-2
3143,3143,3144,0,8,8
3144,3144,3145,8,1,-7
3145,3145,3146,1,9,8
3146,3146,3147,9,2,-7
3147,3147,3148,2,8,6
3148,3148,3149,8,1,-7
3149,3149,3150,1,3,2
3150,3150,3151,3,7,4
3151,3151,3152,7,8,1
3152,3152,3153,8,8,0
3153,3153,3154,8,8,0
3154,3154,3155,8,1,-7
3155,3155,3156,1,2,1
3156,3156,3157,2,4,2
3157,3157,3158,4,8,4
3158,3158,3159,8,3,-5
3159,3159,3160,3,0,-3
3160,3160,3161,0,2,2
3161,3161,3162,2,7,5
3162,3162,3163,7,8,1
3163,3163,3164,8,9,1
3164,3164,3165,9,2,-7
3165,3165,3166,2,2,0
3166,3166,3167,2,7,5
3167,3167,3168,7,8,1
3168,3168,3169,8,9,1
3169,3169,3170,9,5,-4
3170,3170,3171,5,3,-2
3171,3171,3172,3,6,3
3172,3172,3173,6,9,3
3173,3173,3174,9,3,-6
3174,3174,3175,3,0,-3
3175,3175,3176,0,2,2
3176,3176,3177,2,1,-1
3177,3177,3178,1,3,2
3178,3178,3179,3,2,-1
3179,3179,3180,2,5,3
3180,3180,3181,5,3,-2
3181,3181,3182,3,4,1
3182,3182,3183,4,4,0
3183,3183,3184,4,4,0
3184,3184,3185,4,5,1
3185,3185,3186,5,9,4
3186,3186,3187,9,6,-3
3187,3187,3188,6,5,-1
3188,3188,3189,5,7,2
3189,3189,3190,7,9,2
3190,3190,3191,9,8,-1
3191,3191,3192,8,3,-5
3192,3192,3193,3,9,6
3193,3193,3194,9,4,-5
3194,3194,3195,4,0,-4
3195,3195,3196,0,8,8
3196,3196,3197,8,1,-7
3197,3197,3198,1,0,-1
3198,3198,3199,0,2,2
3199,3199,3200,2,2,0
3200,3200,3201,2,3,1
3201,3201,3202,3,9,6
3202,3202,3203,9,4,-5
3203,3203,3204,4,5,1
3204,3204,3205,5,5,0
3205,3205,3206,5,7,2
3206,3206,3207,7,6,-1
3207,3207,3208,6,2,-4
3208,3208,3209,2,7,5
3209,3209,3210,7,7,0
3210,3210,3211,7,8,1
3211,3211,3212,8,1,-7
3212,3212,3213,1,0,-1
3213,3213,3214,0,7,7
3214,3214,3215,7,3,-4
3215,3215,3216,3,5,2
3216,3216,3217,5,4,-1
3217,3217,3218,4,4,0
3218,3218,3219,4,5,1
3219,3219,3220,5,3,-2
3220,3220,3221,3,6,3
3221,3221,3222,6,4,-2
3222,3222,3223,4,7,3
3223,3223,3224,7,2,-5
3224,3224,3225,2,8,6
3225,3225,3226,8,1,-7
3226,3226,3227,1,9,8
3227,3227,3228,9,7,-2
3228,3228,3229,7,6,-1
3229,3229,3230,6,1,-5
3230,3230,3231,1,0,-1
3231,3231,3232,0,9,9
3232,3232,3233,9,3,-6
3233,3233,3234,3,1,-2
3234,3234,3235,1,4,3
3235,3235,3236,4,7,3
3236,3236,3237,7,1,-6
3237,3237,3238,1,9,8
3238,3238,3239,9,4,-5
3239,3239,3240,4,4,0
3240,3240,3241,4,0,-4
3241,3241,3242,0,2,2
3242,3242,3243,2,8,6
3243,3243,3244,8,2,-6
3244,3244,3245,2,6,4
3245,3245,3246,6,7,1
3246,3246,3247,7,0,-7
3247,3247,3248,0,0,0
3248,3248,3249,0,7,7
3249,3249,3250,7,7,0
3250,3250,3251,7,8,1
3251,3251,3252,8,7,-1
3252,3252,3253,7,7,0
3253,3253,3254,7,8,1
3254,3254,3255,8,7,-1
3255,3255,3256,7,9,2
3256,3256,3257,9,9,0
3257,3257,3258,9,3,-6
3258,3258,3259,3,0,-3
3259,3259,3260,0,4,4
3260,3260,3261,4,4,0
3261,3261,3262,4,0,-4
3262,3262,3263,0,9,9
3263,3263,3264,9,3,-6
3264,3264,3265,3,9,6
3265,3265,3266,9,5,-4
3266,3266,3267,5,7,2
3267,3267,3268,7,6,-1
3268,3268,3269,6,0,-6
3269,3269,3270,0,7,7
3270,3270,3271,7,5,-2
3271,3271,3272,5,1,-4
3272,3272,3273,1,8,7
3273,3273,3274,8,2,-6
3274,3274,3275,2,5,3
3275,3275,3276,5,7,2
3276,3276,3277,7,9,2
3277,3277,3278,9,4,-5
3278,3278,3279,4,8,4
3279,3279,3280,8,4,-4
3280,3280,3281,4,8,4
3281,3281,3282,8,7,-1
3282,3282,3283,7,7,0
3283,3283,3284,7,9,2
3284,3284,3285,9,5,-4
3285,3285,3286,5,0,-5
3286,3286,3287,0,6,6
3287,3287,3288,6,6,0
3288,3288,3289,6,5,-1
3289,3289,3290,5,4,-1
3290,3290,3291,4,3,-1
3291,3291,3292,3,9,6
3292,3292,3293,9,8,-1
3293,3293,3294,8,6,-2
3294,3294,3295,6,1,-5
3295,3295,3296,1,9,8
3296,3296,3297,9,6,-3
3297,3297,3298,6,7,1
3298,3298,3299,7,8,1
3299,3299,3300,8,2,-6
3300,3300,3301,2,5,3
3301,3301,3302,5,9,4
3302,3302,3303,9,9,0
3303,3303,3304,9,2,-7
3304,3304,3305,2,2,0
3305,3305,3306,2,1,-1
3306,3306,3307,1,2,1
3307,3307,3308,2,2,0
3308,3308,3309,2,0,-2
3309,3309,3310,0,9,9
3310,3310,3311,9,9,0
3311,3311,3312,9,4,-5
3312,3312,3313,4,2,-2
3313,3313,3314,2,3,1
3314,3314,3315,3,4,1
3315,3315,3316,4,9,5
3316,3316,3317,9,7,-2
3317,3317,3318,7,3,-4
3318,3318,3319,3,3,0
3319,3319,3320,3,3,0
3320,3320,3321,3,1,-2
3321,3321,3322,1,9,8
3322,3322,3323,9,3,-6
3323,3323,3324,3,7,4
3324,3324,3325,7,6,-1
3325,3325,3326,6,5,-1
3326,3326,3327,5,6,1
3327,3327,3328,6,0,-6
3328,3328,3329,0,2,2
3329,3329,3330,2,6,4
3330,3330,3331,6,1,-5
3331,3331,3332,1,3,2
3332,3332,3333,3,2,-1
3333,3333,3334,2,4,2
3334,3334,3335,4,6,2
3335,3335,3336,6,3,-3
3336,3336,3337,3,0,-3
3337,3337,3338,0,8,8
3338,3338,3339,8,2,-6
3339,3339,3340,2,4,2
3340,3340,3341,4,2,-2
3341,3341,3342,2,2,0
3342,3342,3343,2,7,5
3343,3343,3344,7,1,-6
3344,3344,3345,1,1,0
3345,3345,3346,1,9,8
3346,3346,3347,9,3,-6
3347,3347,3348,3,9,6
3348,3348,3349,9,7,-2
3349,3349,3350,7,4,-3
3350,3350,3351,4,4,0
3351,3351,3352,4,4,0
3352,3352,3353,4,8,4
3353,3353,3354,8,8,0
3354,3354,3355,8,9,1
3355,3355,3356,9,5,-4
3356,3356,3357,5,2,-3
3357,3357,3358,2,3,1
3358,3358,3359,3,9,6
3359,3359,3360,9,4,-5
3360,3360,3361,4,5,1
3361,3361,3362,5,2,-3
3362,3362,3363,2,6,4
3363,3363,3364,6,6,0
3364,3364,3365,6,8,2
3365,3365,3366,8,6,-2
3366,3366,3367,6,0,-6
3367,3367,3368,0,7,7
3368,3368,3369,7,0,-7
3369,3369,3370,0,4,4
3370,3370,3371,4,9,5
3371,3371,3372,9,7,-2
3372,3372,3373,7,1,-6
3373,3373,3374,1,9,8
3374,3374,3375,9,1,-8
3375,3375,3376,1,0,-1
3376,3376,3377,0,0,0
3377,3377,3378,0,5,5
3378,3378,3379,5,1,-4
3379,3379,3380,1,1,0
3380,3380,3381,1,2,1
3381,3381,3382,2,9,7
3382,3382,3383,9,3,-6
3383,3383,3384,3,5,2
3384,3384,3385,5,5,0
3385,3385,3386,5,3,-2
3386,3386,3387,3,6,3
3387,3387,3388,6,4,-2
3388,3388,3389,4,9,5
3389,3389,3390,9,2,-7
3390,3390,3391,2,0,-2
3391,3391,3392,0,6,6
3392,3392,3393,6,1,-5
3393,3393,3394,1,1,0
3394,3394,3395,1,2,1
3395,3395,3396,2,0,-2
3396,3396,3397,0,3,3
3397,3397,3398,3,9,6
3398,3398,3399,9,4,-5
3399,3399,3400,4,3,-1
3400,3400,3401,3,5,2
3401,3401,3402,5,3,-2
3402,3402,3403,3,6,3
3403,3403,3404,6,3,-3
3404,3404,3405,3,7,4
3405,3405,3406,7,1,-6
3406,3406,3407,1,8,7
3407,3407,3408,8,7,-1
3408,3408,3409,7,0,-7
3409,3409,3410,0,0,0
3410,3410,3411,0,1,1
3411,3411,3412,1,1,0
3412,3412,3413,1,2,1
3413,3413,3414,2,9,7
3414,3414,3415,9,3,-6
3415,3415,3416,3,5,2
3416,3416,3417,5,4,-1
3417,3417,3418,4,1,-3
3418,3418,3419,1,5,4
3419,3419,3420,5,8,3
3420,3420,3421,8,6,-2
3421,3421,3422,6,3,-3
3422,3422,3423,3,7,4
3423,3423,3424,7,3,-4
3424,3424,3425,3,8,5
3425,3425,3426,8,7,-1
3426,3426,3427,7,1,-6
3427,3427,3428,1,7,6
3428,3428,3429,7,0,-7
3429,3429,3430,0,1,1
3430,3430,3431,1,1,0
3431,3431,3432,1,8,7
3432,3432,3433,8,5,-3
3433,3433,3434,5,0,-5
3434,3434,3435,0,3,3
3435,3435,3436,3,4,1
3436,3436,3437,4,4,0
3437,3437,3438,4,8,4
3438,3438,3439,8,4,-4
3439,3439,3440,4,1,-3
3440,3440,3441,1,0,-1
3441,3441,3442,0,7,7
3442,3442,3443,7,0,-7
3443,3443,3444,0,2,2
3444,3444,3445,2,6,4
3445,3445,3446,6,8,2
3446,3446,3447,8,9,1
3447,3447,3448,9,7,-2
3448,3448,3449,7,6,-1
3449,3449,3450,6,4,-2
3450,3450,3451,4,6,2
3451,3451,3452,6,3,-3
3452,3452,3453,3,5,2
3453,3453,3454,5,6,1
3454,3454,3455,6,4,-2
3455,3455,3456,4,1,-3
3456,3456,3457,1,4,3
3457,3457,3458,4,4,0
3458,3458,3459,4,4,0
3459,3459,3460,4,3,-1
3460,3460,3461,3,0,-3
3461,3461,3462,0,3,3
3462,3462,3463,3,7,4
3463,3463,3464,7,1,-6
3464,3464,3465,1,9,8
3465,3465,3466,9,3,-6
3466,3466,3467,3,5,2
3467,3467,3468,5,1,-4
3468,3468,3469,1,7,6
3469,3469,3470,7,2,-5
3470,3470,3471,2,3,1
3471,3471,3472,3,3,0
3472,3472,3473,3,1,-2
3473,3473,3474,1,6,5
3474,3474,3475,6,4,-2
3475,3475,3476,4,8,4
3476,3476,3477,8,4,-4
3477,3477,3478,4,1,-3
3478,3478,3479,1,0,-1
3479,3479,3480,0,8,8
3480,3480,3481,8,9,1
3481,3481,3482,9,8,-1
3482,3482,3483,8,9,1
3483,3483,3484,9,4,-5
3484,3484,3485,4,6,2
3485,3485,3486,6,2,-4
3486,3486,3487,2,1,-1
3487,3487,3488,1,1,0
3488,3488,3489,1,8,7
3489,3489,3490,8,0,-8
3490,3490,3491,0,3,3
3491,3491,3492,3,0,-3
3492,3492,3493,0,8,8
3493,3493,3494,8,7,-1
3494,3494,3495,7,8,1
3495,3495,3496,8,4,-4
3496,3496,3497,4,8,4
3497,3497,3498,8,7,-1
3498,3498,3499,7,8,1
3499,3499,3500,8,5,-3
3500,3500,3501,5,8,3
3501,3501,3502,8,8,0
3502,3502,3503,8,4,-4
3503,3503,3504,4,4,0
3504,3504,3505,4,7,3
3505,3505,3506,7,9,2
3506,3506,3507,9,7,-2
3507,3507,3508,7,9,2
3508,3508,3509,9,1,-8
3509,3509,3510,1,9,8
3510,3510,3511,9,9,0
3511,3511,3512,9,8,-1
3512,3512,3513,8,8,0
3513,3513,3514,8,0,-8
3514,3514,3515,0,7,7
3515,3515,3516,7,0,-7
3516,3516,3517,0,8,8
3517,3517,3518,8,7,-1
3518,3518,3519,7,9,2
3519,3519,3520,9,6,-3
3520,3520,3521,6,3,-3
3521,3521,3522,3,7,4
3522,3522,3523,7,3,-4
3523,3523,3524,3,6,3
3524,3524,3525,6,5,-1
3525,3525,3526,5,8,3
3526,3526,3527,8,5,-3
3527,3527,3528,5,9,4
3528,3528,3529,9,0,-9
3529,3529,3530,0,6,6
3530,3530,3531,6,7,1
3531,3531,3532,7,1,-6
3532,3532,3533,1,9,8
3533,3533,3534,9,0,-9
3534,3534,3535,0,5,5
3535,3535,3536,5,2,-3
3536,3536,3537,2,6,4
3537,3537,3538,6,7,1
3538,3538,3539,7,5,-2
3539,3539,3540,5,1,-4
3540,3540,3541,1,0,-1
3541,3541,3542,0,3,3
3542,3542,3543,3,6,3
3543,3543,3544,6,9,3
3544,3544,3545,9,1,-8
3545,3545,3546,1,1,0
3546,3546,3547,1,4,3
3547,3547,3548,4,4,0
3548,3548,3549,4,1,-3
3549,3549,3550,1,3,2
3550,3550,3551,3,1,-2
3551,3551,3552,1,3,2
3552,3552,3553,3,2,-1
3553,3553,3554,2,8,6
3554,3554,3555,8,8,0
3555,3555,3556,8,7,-1
3556,3556,3557,7,2,-5
3557,3557,3558,2,5,3
3558,3558,3559,5,6,1
3559,3559,3560,6,1,-5
3560,3560,3561,1,1,0
3561,3561,3562,1,0,-1
3562,3562,3563,0,5,5
3563,3563,3564,5,2,-3
3564,3564,3565,2,0,-2
3565,3565,3566,0,9,9
3566,3566,3567,9,1,-8
3567,3567,3568,1,0,-1
3568,3568,3569,0,2,2
3569,3569,3570,2,8,6
3570,3570,3571,8,3,-5
3571,3571,3572,3,6,3
3572,3572,3573,6,4,-2
3573,3573,3574,4,2,-2
3574,3574,3575,2,5,3
3575,3575,3576,5,3,-2
3576,3576,3577,3,6,3
3577,3577,3578,6,2,-4
3578,3578,3579,2,7,5
3579,3579,3580,7,5,-2
3580,3580,3581,5,8,3
3581,3581,3582,8,2,-6
3582,3582,3583,2,9,7
3583,3583,3584,9,8,-1
3584,3584,3585,8,0,-8
3585,3585,3586,0,6,6
3586,3586,3587,6,1,-5
3587,3587,3588,1,9,8
3588,3588,3589,9,2,-7
3589,3589,3590,2,0,-2
3590,3590,3591,0,3,3
3591,3591,3592,3,1,-2
3592,3592,3593,1,1,0
3593,3593,3594,1,9,8
3594,3594,3595,9,5,-4
3595,3595,3596,5,3,-2
3596,3596,3597,3,6,3
3597,3597,3598,6,9,3
3598,3598,3599,9,7,-2
3599,3599,3600,7,8,1
3600,3600,3601,8,8,0
3601,3601,3602,8,1,-7
3602,3602,3603,1,0,-1
3603,3603,3604,0,1,1
3604,3604,3605,1,1,0
3605,3605,3606,1,3,2
3606,3606,3607,3,2,-1
3607,3607,3608,2,4,2
3608,3608,3609,4,3,-1
3609,3609,3610,3,0,-3
3610,3610,3611,0,4,4
3611,3611,3612,4,0,-4
3612,3612,3613,0,5,5
3613,3613,3614,5,3,-2
3614,3614,3615,3,6,3
3615,3615,3616,6,8,2
3616,3616,3617,8,7,-1
3617,3617,3618,7,7,0
3618,3618,3619,7,8,1
3619,3619,3620,8,7,-1
3620,3620,3621,7,9,2
3621,3621,3622,9,0,-9
3622,3622,3623,0,6,6
3623,3623,3624,6,4,-2
3624,3624,3625,4,4,0
3625,3625,3626,4,3,-1
3626,3626,3627,3,2,-1
3627,3627,3628,2,1,-1
3628,3628,3629,1,6,5
3629,3629,3630,6,8,2
3630,3630,3631,8,4,-4
3631,3631,3632,4,0,-4
3632,3632,3633,0,7,7
3633,3633,3634,7,5,-2
3634,3634,3635,5,5,0
3635,3635,3636,5,9,4
3636,3636,3637,9,5,-4
3637,3637,3638,5,5,0
3638,3638,3639,5,4,-1
3639,3639,3640,4,7,3
3640,3640,3641,7,7,0
3641,3641,3642,7,2,-5
3642,3642,3643,2,8,6
3643,3643,3644,8,1,-7
3644,3644,3645,1,9,8
3645,3645,3646,9,6,-3
3646,3646,3647,6,2,-4
3647,3647,3648,2,5,3
3648,3648,3649,5,9,4
3649,3649,3650,9,6,-3
3650,3650,3651,6,3,-3
3651,3651,3652,3,4,1
3652,3652,3653,4,9,5
3653,3653,3654,9,6,-3
3654,3654,3655,6,3,-3
3655,3655,3656,3,3,0
3656,3656,3657,3,8,5
3657,3657,3658,8,8,0
3658,3658,3659,8,2,-6
3659,3659,3660,2,2,0
3660,3660,3661,2,0,-2
3661,3661,3662,0,9,9
3662,3662,3663,9,9,0
3663,3663,3664,9,8,-1
3664,3664,3665,8,8,0
3665,3665,3666,8,4,-4
3666,3666,3667,4,0,-4
3667,3667,3668,0,4,4
3668,3668,3669,4,5,1
3669,3669,3670,5,3,-2
3670,3670,3671,3,6,3
3671,3671,3672,6,2,-4
3672,3672,3673,2,0,-2
3673,3673,3674,0,3,3
3674,3674,3675,3,1,-2
3675,3675,3676,1,2,1
3676,3676,3677,2,0,-2
3677,3677,3678,0,9,9
3678,3678,3679,9,2,-7
3679,3679,3680,2,2,0
3680,3680,3681,2,5,3
3681,3681,3682,5,5,0
3682,3682,3683,5,3,-2
3683,3683,3684,3,3,0
3684,3684,3685,3,5,2
3685,3685,3686,5,4,-1
3686,3686,3687,4,3,-1
3687,3687,3688,3,8,5
3688,3688,3689,8,8,0
3689,3689,3690,8,8,0
3690,3690,3691,8,0,-8
3691,3691,3692,0,7,7
3692,3692,3693,7,0,-7
3693,3693,3694,0,4,4
3694,3694,3695,4,5,1
3695,3695,3696,5,9,4
3696,3696,3697,9,4,-5
3697,3697,3698,4,0,-4
3698,3698,3699,0,3,3
3699,3699,3700,3,6,3
3700,3700,3701,6,4,-2
3701,3701,3702,4,0,-4
3702,3702,3703,0,1,1
3703,3703,3704,1,9,8
3704,3704,3705,9,5,-4
3705,3705,3706,5,6,1
3706,3706,3707,6,3,-3
3707,3707,3708,3,4,1
3708,3708,3709,4,0,-4
3709,3709,3710,0,2,2
3710,3710,3711,2,8,6
3711,3711,3712,8,2,-6
3712,3712,3713,2,3,1
3713,3713,3714,3,1,-2
3714,3714,3715,1,0,-1
3715,3715,3716,0,4,4
3716,3716,3717,4,6,2
3717,3717,3718,6,7,1
3718,3718,3719,7,2,-5
3719,3719,3720,2,0,-2
3720,3720,3721,0,7,7
3721,3721,3722,7,2,-5
3722,3722,3723,2,1,-1
3723,3723,3724,1,4,3
3724,3724,3725,4,1,-3
3725,3725,3726,1,6,5
3726,3726,3727,6,8,2
3727,3727,3728,8,7,-1
3728,3728,3729,7,1,-6
3729,3729,3730,1,8,7
3730,3730,3731,8,7,-1
3731,3731,3732,7,4,-3
3732,3732,3733,4,1,-3
3733,3733,3734,1,0,-1
3734,3734,3735,0,3,3
3735,3735,3736,3,6,3
3736,3736,3737,6,8,2
3737,3737,3738,8,4,-4
3738,3738,3739,4,4,0
3739,3739,3740,4,3,-1
3740,3740,3741,3,2,-1
3741,3741,3742,2,9,7
3742,3742,3743,9,0,-9
3743,3743,3744,0,8,8
3744,3744,3745,8,9,1
3745,3745,3746,9,9,0
3746,3746,3747,9,7,-2
3747,3747,3748,7,2,-5
3748,3748,3749,2,6,4
3749,3749,3750,6,7,1
3750,3750,3751,7,7,0
3751,3751,3752,7,5,-2
3752,3752,3753,5,4,-1
3753,3753,3754,4,3,-1
3754,3754,3755,3,1,-2
3755,3755,3756,1,3,2
3756,3756,3757,3,6,3
3757,3757,3758,6,1,-5
3758,3758,3759,1,8,7
3759,3759,3760,8,9,1
3760,3760,3761,9,4,-5
3761,3761,3762,4,8,4
3762,3762,3763,8,1,-7
3763,3763,3764,1,6,5
3764,3764,3765,6,2,-4
3765,3765,3766,2,8,6
3766,3766,3767,8,6,-2
3767,3767,3768,6,5,-1
3768,3768,3769,5,7,2
3769,3769,3770,7,9,2
3770,3770,3771,9,1,-8
3771,3771,3772,1,6,5
3772,3772,3773,6,9,3
3773,3773,3774,9,6,-3
3774,3774,3775,6,8,2
3775,3775,3776,8,0,-8
3776,3776,3777,0,0,0
3777,3777,3778,0,0,0
3778,3778,3779,0,6,6
3779,3779,3780,6,7,1
3780,3780,3781,7,9,2
3781,3781,3782,9,7,-2
3782,3782,3783,7,4,-3
3783,3783,3784,4,9,5
3784,3784,3785,9,9,0
3785,3785,3786,9,9,0
3786,3786,3787,9,9,0
3787,3787,3788,9,7,-2
3788,3788,3789,7,6,-1
3789,3789,3790,6,7,1
3790,3790,3791,7,2,-5
3791,3791,3792,2,8,6
3792,3792,3793,8,3,-5
3793,3793,3794,3,6,3
3794,3794,3795,6,7,1
3795,3795,3796,7,9,2
3796,3796,3797,9,1,-8
3797,3797,3798,1,7,6
3798,3798,3799,7,2,-5
3799,3799,3800,2,1,-1
3800,3800,3801,1,5,4
3801,3801,3802,5,1,-4
3802,3802,3803,1,3,2
3803,3803,3804,3,7,4
3804,3804,3805,7,7,0
3805,3805,3806,7,0,-7
3806,3806,3807,0,8,8
3807,3807,3808,8,6,-2
3808,3808,3809,6,0,-6
3809,3809,3810,0,3,3
3810,3810,3811,3,1,-2
3811,3811,3812,1,3,2
3812,3812,3813,3,2,-1
3813,3813,3814,2,6,4
3814,3814,3815,6,3,-3
3815,3815,3816,3,8,5
3816,3816,3817,8,4,-4
3817,3817,3818,4,9,5
3818,3818,3819,9,5,-4
3819,3819,3820,5,6,1
3820,3820,3821,6,6,0
3821,3821,3822,6,1,-5
3822,3822,3823,1,7,6
3823,3823,3824,7,3,-4
3824,3824,3825,3,8,5
3825,3825,3826,8,2,-6
3826,3826,3827,2,9,7
3827,3827,3828,9,4,-5
3828,3828,3829,4,0,-4
3829,3829,3830,0,2,2
3830,3830,3831,2,1,-1
3831,3831,3832,1,5,4
3832,3832,3833,5,2,-3
3833,3833,3834,2,9,7
3834,3834,3835,9,3,-6
3835,3835,3836,3,2,-1
3836,3836,3837,2,4,2
3837,3837,3838,4,4,0
3838,3838,3839,4,5,1
3839,3839,3840,5,7,2
3840,3840,3841,7,6,-1
3841,3841,3842,6,8,2
3842,3842,3843,8,7,-1
3843,3843,3844,7,3,-4
3844,3844,3845,3,8,5
3845,3845,3846,8,7,-1
3846,3846,3847,7,9,2
3847,3847,3848,9,2,-7
3848,3848,3849,2,0,-2
3849,3849,3850,0,1,1
3850,3850,3851,1,1,0
3851,3851,3852,1,9,8
3852,3852,3853,9,2,-7
3853,3853,3854,2,7,5
3854,3854,3855,7,3,-4
3855,3855,3856,3,6,3
3856,3856,3857,6,4,-2
3857,3857,3858,4,6,2
3858,3858,3859,6,5,-1
3859,3859,3860,5,5,0
3860,3860,3861,5,6,1
3861,3861,3862,6,4,-2
3862,3862,3863,4,7,3
3863,3863,3864,7,5,-2
3864,3864,3865,5,8,3
3865,3865,3866,8,8,0
3866,3866,3867,8,9,1
3867,3867,3868,9,7,-2
3868,3868,3869,7,6,-1
3869,3869,3870,6,5,-1
3870,3870,3871,5,2,-3
3871,3871,3872,2,8,6
3872,3872,3873,8,6,-2
3873,3873,3874,6,9,3
3874,3874,3875,9,5,-4
3875,3875,3876,5,0,-5
3876,3876,3877,0,4,4
3877,3877,3878,4,1,-3
3878,3878,3879,1,2,1
3879,3879,3880,2,2,0
3880,3880,3881,2,0,-2
3881,3881,3882,0,0,0
3882,3882,3883,0,8,8
3883,3883,3884,8,0,-8
3884,3884,3885,0,1,1
3885,3885,3886,1,2,1
3886,3886,3887,2,7,5
3887,3887,3888,7,0,-7
3888,3888,3889,0,1,1
3889,3889,3890,1,2,1
3890,3890,3891,2,8,6
3891,3891,3892,8,8,0
3892,3892,3893,8,3,-5
3893,3893,3894,3,7,4
3894,3894,3895,7,7,0
3895,3895,3896,7,0,-7
3896,3896,3897,0,1,1
3897,3897,3898,1,1,0
3898,3898,3899,1,7,6
3899,3899,3900,7,1,-6
3900,3900,3901,1,1,0
3901,3901,3902,1,2,1
3902,3902,3903,2,4,2
3903,3903,3904,4,9,5
3904,3904,3905,9,4,-5
3905,3905,3906,4,0,-4
3906,3906,3907,0,5,5
3907,3907,3908,5,6,1
3908,3908,3909,6,7,1
3909,3909,3910,7,6,-1
3910,3910,3911,6,4,-2
3911,3911,3912,4,9,5
3912,3912,3913,9,9,0
3913,3913,3914,9,7,-2
3914,3914,3915,7,7,0
3915,3915,3916,7,7,0
3916,3916,3917,7,2,-5
3917,3917,3918,2,8,6
3918,3918,3919,8,6,-2
3919,3919,3920,6,3,-3
3920,3920,3921,3,5,2
3921,3921,3922,5,5,0
3922,3922,3923,5,3,-2
3923,3923,3924,3,2,-1
3924,3924,3925,2,9,7
3925,3925,3926,9,1,-8
3926,3926,3927,1,9,8
3927,3927,3928,9,8,-1
3928,3928,3929,8,0,-8
3929,3929,3930,0,2,2
3930,3930,3931,2,8,6
3931,3931,3932,8,6,-2
3932,3932,3933,6,7,1
3933,3933,3934,7,2,-5
3934,3934,3935,2,9,7
3935,3935,3936,9,6,-3
3936,3936,3937,6,0,-6
3937,3937,3938,0,3,3
3938,3938,3939,3,6,3
3939,3939,3940,6,7,1
3940,3940,3941,7,3,-4
3941,3941,3942,3,7,4
3942,3942,3943,7,0,-7
3943,3943,3944,0,5,5
3944,3944,3945,5,4,-1
3945,3945,3946,4,4,0
3946,3946,3947,4,6,2
3947,3947,3948,6,7,1
3948,3948,3949,7,3,-4
3949,3949,3950,3,6,3
3950,3950,3951,6,7,1
3951,3951,3952,7,6,-1
3952,3952,3953,6,0,-6
3953,3953,3954,0,1,1
3954,3954,3955,1,1,0
3955,3955,3956,1,1,0
3956,3956,3957,1,4,3
3957,3957,3958,4,8,4
3958,3958,3959,8,8,0
3959,3959,3960,8,6,-2
3960,3960,3961,6,8,2
3961,3961,3962,8,1,-7
3962,3962,3963,1,1,0
3963,3963,3964,1,0,-1
3964,3964,3965,0,2,2
3965,3965,3966,2,1,-1
3966,3966,3967,1,9,8
3967,3967,3968,9,8,-1
3968,3968,3969,8,3,-5
3969,3969,3970,3,9,6
3970,3970,3971,9,1,-8
3971,3971,3972,1,5,4
3972,3972,3973,5,4,-1
3973,3973,3974,4,5,1
3974,3974,3975,5,2,-3
3975,3975,3976,2,8,6
3976,3976,3977,8,9,1
3977,3977,3978,9,4,-5
3978,3978,3979,4,8,4
3979,3979,3980,8,2,-6
3980,3980,3981,2,2,0
3981,3981,3982,2,9,7
3982,3982,3983,9,8,-1
3983,3983,3984,8,4,-4
3984,3984,3985,4,6,2
3985,3985,3986,6,8,2
3986,3986,3987,8,9,1
3987,3987,3988,9,5,-4
3988,3988,3989,5,2,-3
3989,3989,3990,2,4,2
3990,3990,3991,4,9,5
3991,3991,3992,9,7,-2
3992,3992,3993,7,6,-1
3993,3993,3994,6,6,0
3994,3994,3995,6,3,-3
3995,3995,3996,3,1,-2
3996,3996,3997,1,3,2
3997,3997,3998,3,9,6
3998,3998,3999,9,6,-3
3999,3999,4000,6,7,1
4000,4000,4001,7,3,-4
4001,4001,4002,3,0,-3
4002,4002,4003,0,1,1
4003,4003,4004,1,5,4
4004,4004,4005,5,2,-3
4005,4005,4006,2,8,6
4006,4006,4007,8,5,-3
4007,4007,4008,5,0,-5
4008,4008,4009,0,0,0
4009,4009,4010,0,1,1
4010,4010,4011,1,3,2
4011,4011,4012,3,1,-2
4012,4012,4013,1,1,0
4013,4013,4014,1,1,0
4014,4014,4015,1,5,4
4015,4015,4016,5,2,-3
4016,4016,4017,2,5,3
4017,4017,4018,5,6,1
4018,4018,4019,6,9,3
4019,4019,4020,9,7,-2
4020,4020,4021,7,8,1
4021,4021,4022,8,3,-5
4022,4022,4023,3,0,-3
4023,4023,4024,0,7,7
4024,4024,4025,7,9,2
4025,4025,4026,9,9,0
4026,4026,4027,9,0,-9
4027,4027,4028,0,2,2
4028,4028,4029,2,1,-1
4029,4029,4030,1,6,5
4030,4030,4031,6,2,-4
4031,4031,4032,2,9,7
4032,4032,4033,9,3,-6
4033,4033,4034,3,7,4
4034,4034,4035,7,4,-3
4035,4035,4036,4,8,4
4036,4036,4037,8,5,-3
4037,4037,4038,5,4,-1
4038,4038,4039,4,6,2
4039,4039,4040,6,8,2
4040,4040,4041,8,7,-1
4041,4041,4042,7,7,0
4042,4042,4043,7,8,1
4043,4043,4044,8,0,-8
4044,4044,4045,0,9,9
4045,4045,4046,9,7,-2
4046,4046,4047,7,0,-7
4047,4047,4048,0,5,5
4048,4048,4049,5,1,-4
4049,4049,4050,1,9,8
4050,4050,4051,9,2,-7
4051,4051,4052,2,8,6
4052,4052,4053,8,3,-5
4053,4053,4054,3,6,3
4054,4054,4055,6,4,-2
4055,4055,4056,4,9,5
4056,4056,4057,9,5,-4
4057,4057,4058,5,8,3
4058,4058,4059,8,6,-2
4059,4059,4060,6,9,3
4060,4060,4061,9,7,-2
4061,4061,4062,7,5,-2
4062,4062,4063,5,8,3
4063,4063,4064,8,1,-7
4064,4064,4065,1,9,8
4065,4065,4066,9,1,-8
4066,4066,4067,1,0,-1
4067,4067,4068,0,3,3
4068,4068,4069,3,1,-2
4069,4069,4070,1,1,0
4070,4070,4071,1,2,1
4071,4071,4072,2,6,4
4072,4072,4073,6,3,-3
4073,4073,4074,3,7,4
4074,4074,4075,7,4,-3
4075,4075,4076,4,5,1
4076,4076,4077,5,5,0
4077,4077,4078,5,6,1
4078,4078,4079,6,6,0
4079,4079,4080,6,2,-4
4080,4080,4081,2,7,5
4081,4081,4082,7,0,-7
4082,4082,4083,0,8,8
4083,4083,4084,8,8,0
4084,4084,4085,8,9,1
4085,4085,4086,9,2,-7
4086,4086,4087,2,6,4
4087,4087,4088,6,4,-2
4088,4088,4089,4,1,-3
4089,4089,4090,1,6,5
4090,4090,4091,6,9,3
4091,4091,4092,9,9,0
4092,4092,4093,9,9,0
4093,4093,4094,9,3,-6
4094,4094,4095,3,9,6
4095,4095,4096,9,2,-7
4096,4096,4097,2,4,2
4097,4097,4098,4,9,5
4098,4098,4099,9,4,-5
4099,4099,4100,4,8,4
4100,4100,4101,8,3,-5
4101,4101,4102,3,4,1
4102,4102,4103,4,8,4
4103,4103,4104,8,5,-3
4104,4104,4105,5,1,-4
4105,4105,4106,1,0,-1
4106,4106,4107,0,4,4
4107,4107,4108,4,0,-4
4108,4108,4109,0,1,1
4109,4109,4110,1,6,5
4110,4110,4111,6,2,-4
4111,4111,4112,2,6,4
4112,4112,4113,6,5,-1
4113,4113,4114,5,4,-1
4114,4114,4115,4,0,-4
4115,4115,4116,0,7,7
4116,4116,4117,7,9,2
4117,4117,4118,9,9,0
4118,4118,4119,9,5,-4
4119,4119,4120,5,1,-4
4120,4120,4121,1,3,2
4121,4121,4122,3,9,6
4122,4122,4123,9,0,-9
4123,4123,4124,0,9,9
4124,4124,4125,9,4,-5
4125,4125,4126,4,5,1
4126,4126,4127,5,9,4
4127,4127,4128,9,1,-8
4128,4128,4129,1,1,0
4129,4129,4130,1,7,6
4130,4130,4131,7,7,0
4131,4131,4132,7,4,-3
4132,4132,4133,4,4,0
4133,4133,4134,4,5,1
4134,4134,4135,5,4,-1
4135,4135,4136,4,3,-1
4136,4136,4137,3,1,-2
4137,4137,4138,1,3,2
4138,4138,4139,3,8,5
4139,4139,4140,8,1,-7
4140,4140,4141,1,7,6
4141,4141,4142,7,0,-7
4142,4142,4143,0,6,6
4143,4143,4144,6,2,-4
4144,4144,4145,2,0,-2
4145,4145,4146,0,4,4
4146,4146,4147,4,8,4
4147,4147,4148,8,8,0
4148,4148,4149,8,1,-7
4149,4149,4150,1,6,5
4150,4150,4151,6,8,2
4151,4151,4152,8,1,-7
4152,4152,4153,1,2,1
4153,4153,4154,2,3,1
4154,4154,4155,3,6,3
4155,4155,4156,6,3,-3
4156,4156,4157,3,2,-1
4157,4157,4158,2,9,7
4158,4158,4159,9,0,-9
4159,4159,4160,0,1,1
4160,4160,4161,1,9,8
4161,4161,4162,9,1,-8
4162,4162,4163,1,1,0
4163,4163,4164,1,7,6
4164,4164,4165,7,2,-5
4165,4165,4166,2,1,-1
4166,4166,4167,1,5,4
4167,4167,4168,5,5,0
4168,4168,4169,5,4,-1
4169,4169,4170,4,6,2
4170,4170,4171,6,5,-1
4171,4171,4172,5,4,-1
4172,4172,4173,4,7,3
4173,4173,4174,7,4,-3
4174,4174,4175,4,7,3
4175,4175,4176,7,8,1
4176,4176,4177,8,5,-3
4177,4177,4178,5,4,-1
4178,4178,4179,4,3,-1
4179,4179,4180,3,4,1
4180,4180,4181,4,0,-4
4181,4181,4182,0,2,2
4182,4182,4183,2,2,0
4183,4183,4184,2,5,3
4184,4184,4185,5,2,-3
4185,4185,4186,2,1,-1
4186,4186,4187,1,2,1
4187,4187,4188,2,6,4
4188,4188,4189,6,7,1
4189,4189,4190,7,1,-6
4190,4190,4191,1,3,2
4191,4191,4192,3,5,2
4192,4192,4193,5,1,-4
4193,4193,4194,1,5,4
4194,4194,4195,5,4,-1
4195,4195,4196,4,3,-1
4196,4196,4197,3,4,1
4197,4197,4198,4,6,2
4198,4198,4199,6,3,-3
4199,4199,4200,3,7,4
4200,4200,4201,7,0,-7
4201,4201,4202,0,1,1
4202,4202,4203,1,0,-1
4203,4203,4204,0,2,2
4204,4204,4205,2,4,2
4205,4205,4206,4,9,5
4206,4206,4207,9,7,-2
4207,4207,4208,7,2,-5
4208,4208,4209,2,9,7
4209,4209,4210,9,6,-3
4210,4210,4211,6,7,1
4211,4211,4212,7,2,-5
4212,4212,4213,2,8,6
4213,4213,4214,8,6,-2
4214,4214,4215,6,8,2
4215,4215,4216,8,0,-8
4216,4216,4217,0,7,7
4217,4217,4218,7,0,-7
4218,4218,4219,0,9,9
4219,4219,4220,9,0,-9
4220,4220,4221,0,6,6
4221,4221,4222,6,9,3
4222,4222,4223,9,3,-6
4223,4223,4224,3,4,1
4224,4224,4225,4,1,-3
4225,4225,4226,1,7,6
4226,4226,4227,7,7,0
4227,4227,4228,7,4,-3
4228,4228,4229,4,9,5
4229,4229,4230,9,2,-7
4230,4230,4231,2,6,4
4231,4231,4232,6,6,0
4232,4232,4233,6,3,-3
4233,4233,4234,3,3,0
4234,4234,4235,3,3,0
4235,4235,4236,3,3,0
4236,4236,4237,3,1,-2
4237,4237,4238,1,3,2
4238,4238,4239,3,0,-3
4239,4239,4240,0,4,4
4240,4240,4241,4,2,-2
4241,4241,4242,2,7,5
4242,4242,4243,7,6,-1
4243,4243,4244,6,9,3
4244,4244,4245,9,0,-9
4245,4245,4246,0,3,3
4246,4246,4247,3,5,2
4247,4247,4248,5,1,-4
4248,4248,4249,1,6,5
4249,4249,4250,6,3,-3
4250,4250,4251,3,6,3
4251,4251,4252,6,4,-2
4252,4252,4253,4,8,4
4253,4253,4254,8,7,-1
4254,4254,4255,7,7,0
4255,4255,4256,7,3,-4
4256,4256,4257,3,3,0
4257,4257,4258,3,8,5
4258,4258,4259,8,5,-3
4259,4259,4260,5,9,4
4260,4260,4261,9,8,-1
4261,4261,4262,8,3,-5
4262,4262,4263,3,3,0
4263,4263,4264,3,4,1
4264,4264,4265,4,0,-4
4265,4265,4266,0,7,7
4266,4266,4267,7,1,-6
4267,4267,4268,1,6,5
4268,4268,4269,6,2,-4
4269,4269,4270,2,0,-2
4270,4270,4271,0,3,3
4271,4271,4272,3,8,5
4272,4272,4273,8,7,-1
4273,4273,4274,7,4,-3
4274,4274,4275,4,8,4
4275,4275,4276,8,3,-5
4276,4276,4277,3,9,6
4277,4277,4278,9,2,-7
4278,4278,4279,2,0,-2
4279,4279,4280,0,7,7
4280,4280,4281,7,3,-4
4281,4281,4282,3,8,5
4282,4282,4283,8,4,-4
4283,4283,4284,4,0,-4
4284,4284,4285,0,7,7
4285,4285,4286,7,1,-6
4286,4286,4287,1,8,7
4287,4287,4288,8,0,-8
4288,4288,4289,0,0,0
4289,4289,4290,0,5,5
4290,4290,4291,5,1,-4
4291,4291,4292,1,4,3
4292,4292,4293,4,2,-2
4293,4293,4294,2,1,-1
4294,4294,4295,1,3,2
4295,4295,4296,3,7,4
4296,4296,4297,7,4,-3
4297,4297,4298,4,7,3
4298,4298,4299,7,5,-2
4299,4299,4300,5,1,-4
4300,4300,4301,1,6,5
4301,4301,4302,6,5,-1
4302,4302,4303,5,7,2
4303,4303,4304,7,5,-2
4304,4304,4305,5,8,3
4305,4305,4306,8,9,1
4306,4306,4307,9,9,0
4307,4307,4308,9,8,-1
4308,4308,4309,8,5,-3
4309,4309,4310,5,0,-5
4310,4310,4311,0,1,1
4311,4311,4312,1,5,4
4312,4312,4313,5,9,4
4313,4313,4314,9,6,-3
4314,4314,4315,6,9,3
4315,4315,4316,9,0,-9
4316,4316,4317,0,7,7
4317,4317,4318,7,4,-3
4318,4318,4319,4,1,-3
4319,4319,4320,1,9,8
4320,4320,4321,9,0,-9
4321,4321,4322,0,2,2
4322,4322,4323,2,9,7
4323,4323,4324,9,8,-1
4324,4324,4325,8,0,-8
4325,4325,4326,0,7,7
4326,4326,4327,7,5,-2
4327,4327,4328,5,3,-2
4328,4328,4329,3,9,6
4329,4329,4330,9,7,-2
4330,4330,4331,7,7,0
4331,4331,4332,7,7,0
4332,4332,4333,7,1,-6
4333,4333,4334,1,7,6
4334,4334,4335,7,3,-4
4335,4335,4336,3,4,1
4336,4336,4337,4,6,2
4337,4337,4338,6,7,1
4338,4338,4339,7,3,-4
4339,4339,4340,3,0,-3
4340,4340,4341,0,2,2
4341,4341,4342,2,3,1
4342,4342,4343,3,0,-3
4343,4343,4344,0,0,0
4344,4344,4345,0,9,9
4345,4345,4346,9,4,-5
4346,4346,4347,4,0,-4
4347,4347,4348,0,8,8
4348,4348,4349,8,6,-2
4349,4349,4350,6,9,3
4350,4350,4351,9,1,-8
4351,4351,4352,1,3,2
4352,4352,4353,3,7,4
4353,4353,4354,7,7,0
4354,4354,4355,7,2,-5
4355,4355,4356,2,0,-2
4356,4356,4357,0,8,8
4357,4357,4358,8,7,-1
4358,4358,4359,7,3,-4
4359,4359,4360,3,6,3
4360,4360,4361,6,4,-2
4361,4361,4362,4,9,5
4362,4362,4363,9,7,-2
4363,4363,4364,7,6,-1
4364,4364,4365,6,6,0
4365,4365,4366,6,7,1
4366,4366,4367,7,6,-1
4367,4367,4368,6,9,3
4368,4368,4369,9,3,-6
4369,4369,4370,3,8,5
4370,4370,4371,8,2,-6
4371,4371,4372,2,7,5
4372,4372,4373,7,3,-4
4373,4373,4374,3,0,-3
4374,4374,4375,0,8,8
4375,4375,4376,8,5,-3
4376,4376,4377,5,9,4
4377,4377,4378,9,9,0
4378,4378,4379,9,4,-5
4379,4379,4380,4,2,-2
4380,4380,4381,2,8,6
4381,4381,4382,8,4,-4
4382,4382,4383,4,8,4
4383,4383,4384,8,8,0
4384,4384,4385,8,7,-1
4385,4385,4386,7,4,-3
4386,4386,4387,4,1,-3
4387,4387,4388,1,8,7
4388,4388,4389,8,0,-8
4389,4389,4390,0,1,1
4390,4390,4391,1,8,7
4391,4391,4392,8,6,-2
4392,4392,4393,6,7,1
4393,4393,4394,7,7,0
4394,4394,4395,7,7,0
4395,4395,4396,7,7,0
4396,4396,4397,7,5,-2
4397,4397,4398,5,2,-3
4398,4398,4399,2,9,7
4399,4399,4400,9,3,-6
4400,4400,4401,3,2,-1
4401,4401,4402,2,6,4
4402,4402,4403,6,3,-3
4403,4403,4404,3,6,3
4404,4404,4405,6,1,-5
4405,4405,4406,1,4,3
4406,4406,4407,4,1,-3
4407,4407,4408,1,6,5
4408,4408,4409,6,4,-2
4409,4409,4410,4,4,0
4410,4410,4411,4,5,1
4411,4411,4412,5,1,-4
4412,4412,4413,1,5,4
4413,4413,4414,5,2,-3
4414,4414,4415,2,0,-2
4415,4415,4416,0,5,5
4416,4416,4417,5,4,-1
4417,4417,4418,4,3,-1
4418,4418,4419,3,8,5
4419,4419,4420,8,1,-7
4420,4420,4421,1,7,6
4421,4421,4422,7,7,0
4422,4422,4423,7,4,-3
4423,4423,4424,4,5,1
4424,4424,4425,5,9,4
4425,4425,4426,9,6,-3
4426,4426,4427,6,2,-4
4427,4427,4428,2,2,0
4428,4428,4429,2,3,1
4429,4429,4430,3,6,3
4430,4430,4431,6,6,0
4431,4431,4432,6,7,1
4432,4432,4433,7,4,-3
4433,4433,4434,4,8,4
4434,4434,4435,8,1,-7
4435,4435,4436,1,4,3
4436,4436,4437,4,2,-2
4437,4437,4438,2,4,2
4438,4438,4439,4,4,0
4439,4439,4440,4,8,4
4440,4440,4441,8,1,-7
4441,4441,4442,1,2,1
4442,4442,4443,2,5,3
4443,4443,4444,5,0,-5
4444,4444,4445,0,1,1
4445,4445,4446,1,2,1
4446,4446,4447,2,9,7
4447,4447,4448,9,8,-1
4448,4448,4449,8,3,-5
4449,4449,4450,3,5,2
4450,4450,4451,5,2,-3
4451,4451,4452,2,7,5
4452,4452,4453,7,0,-7
4453,4453,4454,0,4,4
4454,4454,4455,4,0,-4
4455,4455,4456,0,9,9
4456,4456,4457,9,2,-7
4457,4457,4458,2,7,5
4458,4458,4459,7,9,2
4459,4459,4460,9,4,-5
4460,4460,4461,4,3,-1
4461,4461,4462,3,5,2
4462,4462,4463,5,6,1
4463,4463,4464,6,4,-2
4464,4464,4465,4,0,-4
4465,4465,4466,0,9,9
4466,4466,4467,9,1,-8
4467,4467,4468,1,8,7
4468,4468,4469,8,2,-6
4469,4469,4470,2,1,-1
4470,4470,4471,1,3,2
4471,4471,4472,3,7,4
4472,4472,4473,7,4,-3
4473,4473,4474,4,2,-2
4474,4474,4475,2,5,3
4475,4475,4476,5,2,-3
4476,4476,4477,2,6,4
4477,4477,4478,6,7,1
4478,4478,4479,7,7,0
4479,4479,4480,7,5,-2
4480,4480,4481,5,8,3
4481,4481,4482,8,8,0
4482,4482,4483,8,9,1
4483,4483,4484,9,1,-8
4484,4484,4485,1,0,-1
4485,4485,4486,0,1,1
4486,4486,4487,1,1,0
4487,4487,4488,1,0,-1
4488,4488,4489,0,2,2
4489,4489,4490,2,3,1
4490,4490,4491,3,3,0
4491,4491,4492,3,1,-2
4492,4492,4493,1,4,3
4493,4493,4494,4,4,0
4494,4494,4495,4,5,1
4495,4495,4496,5,0,-5
4496,4496,4497,0,6,6
4497,4497,4498,6,4,-2
4498,4498,4499,4,7,3
4499,4499,4500,7,0,-7
4500,4500,4501,0,8,8
4501,4501,4502,8,1,-7
4502,4502,4503,1,9,8
4503,4503,4504,9,1,-8
4504,4504,4505,1,0,-1
4505,4505,4506,0,3,3
4506,4506,4507,3,1,-2
4507,4507,4508,1,3,2
4508,4508,4509,3,2,-1
4509,4509,4510,2,3,1
4510,4510,4511,3,3,0
4511,4511,4512,3,3,0
4512,4512,4513,3,4,1
4513,4513,4514,4,2,-2
4514,4514,4515,2,5,3
4515,4515,4516,5,7,2
4516,4516,4517,7,6,-1
4517,4517,4518,6,2,-4
4518,4518,4519,2,7,5
4519,4519,4520,7,6,-1
4520,4520,4521,6,8,2
4521,4521,4522,8,4,-4
4522,4522,4523,4,9,5
4523,4523,4524,9,1,-8
4524,4524,4525,1,8,7
4525,4525,4526,8,6,-2
4526,4526,4527,6,0,-6
4527,4527,4528,0,7,7
4528,4528,4529,7,5,-2
4529,4529,4530,5,7,2
4530,4530,4531,7,6,-1
4531,4531,4532,6,0,-6
4532,4532,4533,0,6,6
4533,4533,4534,6,1,-5
4534,4534,4535,1,0,-1
4535,4535,4536,0,6,6
4536,4536,4537,6,8,2
4537,4537,4538,8,4,-4
4538,4538,4539,4,0,-4
4539,4539,4540,0,4,4
4540,4540,4541,4,2,-2
4541,4541,4542,2,2,0
4542,4542,4543,2,3,1
4543,4543,4544,3,9,6
4544,4544,4545,9,7,-2
4545,4545,4546,7,6,-1
4546,4546,4547,6,9,3
4547,4547,4548,9,7,-2
4548,4548,4549,7,4,-3
4549,4549,4550,4,2,-2
4550,4550,4551,2,7,5
4551,4551,4552,7,3,-4
4552,4552,4553,3,1,-2
4553,4553,4554,1,1,0
4554,4554,4555,1,9,8
4555,4555,4556,9,0,-9
4556,4556,4557,0,1,1
4557,4557,4558,1,5,4
4558,4558,4559,5,7,2
4559,4559,4560,7,6,-1
4560,4560,4561,6,1,-5
4561,4561,4562,1,5,4
4562,4562,4563,5,0,-5
4563,4563,4564,0,4,4
4564,4564,4565,4,0,-4
4565,4565,4566,0,1,1
4566,4566,4567,1,4,3
4567,4567,4568,4,9,5
4568,4568,4569,9,1,-8
4569,4569,4570,1,3,2
4570,4570,4571,3,7,4
4571,4571,4572,7,6,-1
4572,4572,4573,6,5,-1
4573,4573,4574,5,2,-3
4574,4574,4575,2,7,5
4575,4575,4576,7,2,-5
4576,4576,4577,2,1,-1
4577,4577,4578,1,8,7
4578,4578,4579,8,3,-5
4579,4579,4580,3,8,5
4580,4580,4581,8,3,-5
4581,4581,4582,3,8,5
4582,4582,4583,8,3,-5
4583,4583,4584,3,3,0
4584,4584,4585,3,1,-2
4585,4585,4586,1,6,5
4586,4586,4587,6,6,0
4587,4587,4588,6,0,-6
4588,4588,4589,0,9,9
4589,4589,4590,9,5,-4
4590,4590,4591,5,7,2
4591,4591,4592,7,7,0
4592,4592,4593,7,4,-3
4593,4593,4594,4,9,5
4594,4594,4595,9,3,-6
4595,4595,4596,3,5,2
4596,4596,4597,5,0,-5
4597,4597,4598,0,8,8
4598,4598,4599,8,2,-6
4599,4599,4600,2,5,3
4600,4600,4601,5,5,0
4601,4601,4602,5,1,-4
4602,4602,4603,1,2,1
4603,4603,4604,2,7,5
4604,4604,4605,7,6,-1
4605,4605,4606,6,9,3
4606,4606,4607,9,0,-9
4607,4607,4608,0,0,0
4608,4608,4609,0,8,8
4609,4609,4610,8,2,-6
4610,4610,4611,2,9,7
4611,4611,4612,9,6,-3
4612,4612,4613,6,4,-2
4613,4613,4614,4,5,1
4614,4614,4615,5,3,-2
4615,4615,4616,3,4,1
4616,4616,4617,4,5,1
4617,4617,4618,5,7,2
4618,4618,4619,7,4,-3
4619,4619,4620,4,6,2
4620,4620,4621,6,8,2
4621,4621,4622,8,5,-3
4622,4622,4623,5,1,-4
4623,4623,4624,1,0,-1
4624,4624,4625,0,5,5
4625,4625,4626,5,4,-1
4626,4626,4627,4,9,5
4627,4627,4628,9,3,-6
4628,4628,4629,3,0,-3
4629,4629,4630,0,9,9
4630,4630,4631,9,6,-3
4631,4631,4632,6,3,-3
4632,4632,4633,3,4,1
4633,4633,4634,4,8,4
4634,4634,4635,8,6,-2
4635,4635,4636,6,4,-2
4636,4636,4637,4,8,4
4637,4637,4638,8,3,-5
4638,4638,4639,3,1,-2
4639,4639,4640,1,6,5
4640,4640,4641,6,4,-2
4641,4641,4642,4,0,-4
4642,4642,4643,0,7,7
4643,4643,4644,7,1,-6
4644,4644,4645,1,5,4
4645,4645,4646,5,2,-3
4646,4646,4647,2,7,5
4647,4647,4648,7,2,-5
4648,4648,4649,2,2,0
4649,4649,4650,2,2,0
4650,4650,4651,2,2,0
4651,4651,4652,2,8,6
4652,4652,4653,8,0,-8
4653,4653,4654,0,1,1
4654,4654,4655,1,0,-1
4655,4655,4656,0,0,0
4656,4656,4657,0,1,1
4657,4657,4658,1,3,2
4658,4658,4659,3,7,4
4659,4659,4660,7,6,-1
4660,4660,4661,6,7,1
4661,4661,4662,7,2,-5
4662,4662,4663,2,9,7
4663,4663,4664,9,2,-7
4664,4664,4665,2,5,3
4665,4665,4666,5,5,0
4666,4666,4667,5,9,4
4667,4667,4668,9,9,0
4668,4668,4669,9,8,-1
4669,4669,4670,8,5,-3
4670,4670,4671,5,9,4
4671,4671,4672,9,7,-2
4672,4672,4673,7,6,-1
4673,4673,4674,6,3,-3
4674,4674,4675,3,8,5
4675,4675,4676,8,1,-7
4676,4676,4677,1,8,7
4677,4677,4678,8,9,1
4678,4678,4679,9,2,-7
4679,4679,4680,2,7,5
4680,4680,4681,7,3,-4
4681,4681,4682,3,0,-3
4682,4682,4683,0,6,6
4683,4683,4684,6,8,2
4684,4684,4685,8,1,-7
4685,4685,4686,1,0,-1
4686,4686,4687,0,2,2
4687,4687,4688,2,0,-2
4688,4688,4689,0,9,9
4689,4689,4690,9,9,0
4690,4690,4691,9,8,-1
4691,4691,4692,8,8,0
4692,4692,4693,8,9,1
4693,4693,4694,9,3,-6
4694,4694,4695,3,5,2
4695,4695,4696,5,1,-4
4696,4696,4697,1,2,1
4697,4697,4698,2,8,6
4698,4698,4699,8,6,-2
4699,4699,4700,6,8,2
4700,4700,4701,8,2,-6
4701,4701,4702,2,6,4
4702,4702,4703,6,4,-2
4703,4703,4704,4,5,1
4704,4704,4705,5,8,3
4705,4705,4706,8,2,-6
4706,4706,4707,2,4,2
4707,4707,4708,4,1,-3
4708,4708,4709,1,6,5
4709,4709,4710,6,1,-5
4710,4710,4711,1,5,4
4711,4711,4712,5,6,1
4712,4712,4713,6,0,-6
4713,4713,4714,0,2,2
4714,4714,4715,2,1,-1
4715,4715,4716,1,2,1
4716,4716,4717,2,2,0
4717,4717,4718,2,0,-2
4718,4718,4719,0,3,3
4719,4719,4720,3,9,6
4720,4720,4721,9,4,-5
4721,4721,4722,4,2,-2
4722,4722,4723,2,5,3
4723,4723,4724,5,6,1
4724,4724,4725,6,7,1
4725,4725,4726,7,7,0
4726,4726,4727,7,8,1
4727,4727,4728,8,5,-3
4728,4728,4729,5,0,-5
4729,4729,4730,0,4,4
4730,4730,4731,4,1,-3
4731,4731,4732,1,6,5
4732,4732,4733,6,2,-4
4733,4733,4734,2,7,5
4734,4734,4735,7,3,-4
4735,4735,4736,3,3,0
4736,4736,4737,3,4,1
4737,4737,4738,4,0,-4
4738,4738,4739,0,5,5
4739,4739,4740,5,3,-2
4740,4740,4741,3,6,3
4741,4741,4742,6,3,-3
4742,4742,4743,3,7,4
4743,4743,4744,7,0,-7
4744,4744,4745,0,8,8
4745,4745,4746,8,4,-4
4746,4746,4747,4,9,5
4747,4747,4748,9,0,-9
4748,4748,4749,0,0,0
4749,4749,4750,0,1,1
4750,4750,4751,1,1,0
4751,4751,4752,1,5,4
4752,4752,4753,5,2,-3
4753,4753,4754,2,9,7
4754,4754,4755,9,3,-6
4755,4755,4756,3,0,-3
4756,4756,4757,0,4,4
4757,4757,4758,4,4,0
4758,4758,4759,4,7,3
4759,4759,4760,7,5,-2
4760,4760,4761,5,8,3
4761,4761,4762,8,3,-5
4762,4762,4763,3,1,-2
4763,4763,4764,1,1,0
4764,4764,4765,1,6,5
4765,4765,4766,6,1,-5
4766,4766,4767,1,8,7
4767,4767,4768,8,4,-4
4768,4768,4769,4,9,5
4769,4769,4770,9,6,-3
4770,4770,4771,6,9,3
4771,4771,4772,9,1,-8
4772,4772,4773,1,0,-1
4773,4773,4774,0,7,7
4774,4774,4775,7,1,-6
4775,4775,4776,1,0,-1
4776,4776,4777,0,2,2
4777,4777,4778,2,6,4
4778,4778,4779,6,4,-2
4779,4779,4780,4,4,0
4780,4780,4781,4,4,0
4781,4781,4782,4,4,0
4782,4782,4783,4,3,-1
4783,4783,4784,3,7,4
4784,4784,4785,7,7,0
4785,4785,4786,7,5,-2
4786,4786,4787,5,4,-1
4787,4787,4788,4,9,5
4788,4788,4789,9,4,-5
4789,4789,4790,4,1,-3
4790,4790,4791,1,4,3
4791,4791,4792,4,3,-1
4792,4792,4793,3,0,-3
4793,4793,4794,0,7,7
4794,4794,4795,7,3,-4
4795,4795,4796,3,4,1
4796,4796,4797,4,8,4
4797,4797,4798,8,4,-4
4798,4798,4799,4,7,3
4799,4799,4800,7,6,-1
4800,4800,4801,6,5,-1
4801,4801,4802,5,4,-1
4802,4802,4803,4,8,4
4803,4803,4804,8,0,-8
4804,4804,4805,0,2,2
4805,4805,4806,2,7,5
4806,4806,4807,7,1,-6
4807,4807,4808,1,3,2
4808,4808,4809,3,7,4
4809,4809,4810,7,1,-6
4810,4810,4811,1,9,8
4811,4811,4812,9,4,-5
4812,4812,4813,4,1,-3
4813,4813,4814,1,8,7
4814,4814,4815,8,1,-7
4815,4815,4816,1,9,8
4816,4816,4817,9,6,-3
4817,4817,4818,6,6,0
4818,4818,4819,6,2,-4
4819,4819,4820,2,5,3
4820,4820,4821,5,1,-4
4821,4821,4822,1,4,3
4822,4822,4823,4,3,-1
4823,4823,4824,3,9,6
4824,4824,4825,9,8,-1
4825,4825,4826,8,9,1
4826,4826,4827,9,6,-3
4827,4827,4828,6,6,0
4828,4828,4829,6,4,-2
4829,4829,4830,4,9,5
4830,4830,4831,9,9,0
4831,4831,4832,9,7,-2
4832,4832,4833,7,4,-3
4833,4833,4834,4,8,4
4834,4834,4835,8,2,-6
4835,4835,4836,2,3,1
4836,4836,4837,3,4,1
4837,4837,4838,4,4,0
4838,4838,4839,4,4,0
4839,4839,4840,4,7,3
4840,4840,4841,7,6,-1
4841,4841,4842,6,7,1
4842,4842,4843,7,2,-5
4843,4843,4844,2,5,3
4844,4844,4845,5,5,0
4845,4845,4846,5,2,-3
4846,4846,4847,2,5,3
4847,4847,4848,5,8,3
4848,4848,4849,8,0,-8
4849,4849,4850,0,3,3
4850,4850,4851,3,2,-1
4851,4851,4852,2,0,-2
4852,4852,4853,0,8,8
4853,4853,4854,8,0,-8
4854,4854,4855,0,0,0
4855,4855,4856,0,2,2
4856,4856,4857,2,6,4
4857,4857,4858,6,7,1
4858,4858,4859,7,8,1
4859,4859,4860,8,8,0
4860,4860,4861,8,1,-7
4861,4861,4862,1,8,7
4862,4862,4863,8,7,-1
4863,4863,4864,7,3,-4
4864,4864,4865,3,1,-2
4865,4865,4866,1,3,2
4866,4866,4867,3,6,3
4867,4867,4868,6,3,-3
4868,4868,4869,3,7,4
4869,4869,4870,7,0,-7
4870,4870,4871,0,6,6
4871,4871,4872,6,1,-5
4872,4872,4873,1,8,7
4873,4873,4874,8,4,-4
4874,4874,4875,4,7,3
4875,4875,4876,7,7,0
4876,4876,4877,7,4,-3
4877,4877,4878,4,3,-1
4878,4878,4879,3,9,6
4879,4879,4880,9,2,-7
4880,4880,4881,2,3,1
4881,4881,4882,3,6,3
4882,4882,4883,6,3,-3
4883,4883,4884,3,1,-2
4884,4884,4885,1,5,4
4885,4885,4886,5,6,1
4886,4886,4887,6,8,2
4887,4887,4888,8,7,-1
4888,4888,4889,7,0,-7
4889,4889,4890,0,4,4
4890,4890,4891,4,3,-1
4891,4891,4892,3,0,-3
4892,4892,4893,0,7,7
4893,4893,4894,7,9,2
4894,4894,4895,9,9,0
4895,4895,4896,9,4,-5
4896,4896,4897,4,7,3
4897,4897,4898,7,3,-4
4898,4898,4899,3,7,4
4899,4899,4900,7,1,-6
4900,4900,4901,1,9,8
4901,4901,4902,9,9,0
4902,4902,4903,9,1,-8
4903,4903,4904,1,7,6
4904,4904,4905,7,6,-1
4905,4905,4906,6,0,-6
4906,4906,4907,0,7,7
4907,4907,4908,7,5,-2
4908,4908,4909,5,8,3
4909,4909,4910,8,6,-2
4910,4910,4911,6,0,-6
4911,4911,4912,0,9,9
4912,4912,4913,9,1,-8
4913,4913,4914,1,2,1
4914,4914,4915,2,2,0
4915,4915,4916,2,9,7
4916,4916,4917,9,3,-6
4917,4917,4918,3,0,-3
4918,4918,4919,0,4,4
4919,4919,4920,4,1,-3
4920,4920,4921,1,5,4
4921,4921,4922,5,6,1
4922,4922,4923,6,6,0
4923,4923,4924,6,1,-5
4924,4924,4925,1,7,6
4925,4925,4926,7,0,-7
4926,4926,4927,0,8,8
4927,4927,4928,8,7,-1
4928,4928,4929,7,9,2
4929,4929,4930,9,6,-3
4930,4930,4931,6,0,-6
4931,4931,4932,0,9,9
4932,4932,4933,9,1,-8
4933,4933,4934,1,6,5
4934,4934,4935,6,2,-4
4935,4935,4936,2,9,7
4936,4936,4937,9,3,-6
4937,4937,4938,3,2,-1
4938,4938,4939,2,4,2
4939,4939,4940,4,5,1
4940,4940,4941,5,5,0
4941,4941,4942,5,1,-4
4942,4942,4943,1,6,5
4943,4943,4944,6,1,-5
4944,4944,4945,1,7,6
4945,4945,4946,7,7,0
4946,4946,4947,7,8,1
4947,4947,4948,8,5,-3
4948,4948,4949,5,9,4
4949,4949,4950,9,1,-8
4950,4950,4951,1,0,-1
4951,4951,4952,0,4,4
4952,4952,4953,4,1,-3
4953,4953,4954,1,4,3
4954,4954,4955,4,2,-2
4955,4955,4956,2,3,1
4956,4956,4957,3,3,0
4957,4957,4958,3,1,-2
4958,4958,4959,1,4,3
4959,4959,4960,4,1,-3
4960,4960,4961,1,5,4
4961,4961,4962,5,0,-5
4962,4962,4963,0,6,6
4963,4963,4964,6,7,1
4964,4964,4965,7,7,0
4965,4965,4966,7,3,-4
4966,4966,4967,3,8,5
4967,4967,4968,8,9,1
4968,4968,4969,9,5,-4
4969,4969,4970,5,1,-4
4970,4970,4971,1,1,0
4971,4971,4972,1,1,0
4972,4972,4973,1,9,8
4973,4973,4974,9,5,-4
4974,4974,4975,5,9,4
4975,4975,4976,9,1,-8
4976,4976,4977,1,7,6
4977,4977,4978,7,1,-6
4978,4978,4979,1,1,0
4979,4979,4980,1,6,5
4980,4980,4981,6,0,-6
4981,4981,4982,0,8,8
4982,4982,4983,8,9,1
4983,4983,4984,9,7,-2
4984,4984,4985,7,0,-7
4985,4985,4986,0,2,2
4986,4986,4987,2,5,3
4987,4987,4988,5,3,-2
4988,4988,4989,3,9,6
4989,4989,4990,9,6,-3
4990,4990,4991,6,7,1
4991,4991,4992,7,8,1
4992,4992,4993,8,1,-7
4993,4993,4994,1,0,-1
4994,4994,4995,0,7,7
4995,4995,4996,7,3,-4
4996,4996,4997,3,2,-1
4997,4997,4998,2,1,-1
4998,4998,4999,1,2,1
4999,4999,5000,2,7,5
5000,5000,5001,7,3,-4
5001,5001,5002,3,4,1
5002,5002,5003,4,6,2
5003,5003,5004,6,1,-5
5004,5004,5005,1,8,7
5005,5005,5006,8,1,-7
5006,5006,5007,1,0,-1
5007,5007,5008,0,9,9
5008,5008,5009,9,8,-1
5009,5009,5010,8,0,-8
5010,5010,5011,0,3,3
5011,5011,5012,3,1,-2
5012,5012,5013,1,2,1
5013,5013,5014,2,7,5
5014,5014,5015,7,0,-7
5015,5015,5016,0,2,2
5016,5016,5017,2,9,7
5017,5017,5018,9,6,-3
5018,5018,5019,6,0,-6
5019,5019,5020,0,1,1
5020,5020,5021,1,6,5
5021,5021,5022,6,7,1
5022,5022,5023,7,1,-6
5023,5023,5024,1,9,8
5024,5024,5025,9,7,-2
5025,5025,5026,7,6,-1
5026,5026,5027,6,5,-1
5027,5027,5028,5,5,0
5028,5028,5029,5,8,3
5029,5029,5030,8,8,0
5030,5030,5031,8,3,-5
5031,5031,5032,3,4,1
5032,5032,5033,4,4,0
5033,5033,5034,4,8,4
5034,5034,5035,8,7,-1
5035,5035,5036,7,3,-4
5036,5036,5037,3,6,3
5037,5037,5038,6,4,-2
5038,5038,5039,4,6,2
5039,5039,5040,6,6,0
5040,5040,5041,6,3,-3
5041,5041,5042,3,8,5
5042,5042,5043,8,8,0
5043,5043,5044,8,9,1
5044,5044,5045,9,9,0
5045,5045,5046,9,4,-5
5046,5046,5047,4,4,0
5047,5047,5048,4,0,-4
5048,5048,5049,0,7,7
5049,5049,5050,7,8,1
5050,5050,5051,8,1,-7
5051,5051,5052,1,0,-1
5052,5052,5053,0,0,0
5053,5053,5054,0,1,1
5054,5054,5055,1,8,7
5055,5055,5056,8,5,-3
5056,5056,5057,5,7,2
5057,5057,5058,7,1,-6
5058,5058,5059,1,7,6
5059,5059,5060,7,5,-2
5060,5060,5061,5,5,0
5061,5061,5062,5,9,4
5062,5062,5063,9,9,0
5063,5063,5064,9,4,-5
5064,5064,5065,4,2,-2
5065,5065,5066,2,5,3
5066,5066,5067,5,3,-2
5067,5067,5068,3,7,4
5068,5068,5069,7,4,-3
5069,5069,5070,4,6,2
5070,5070,5071,6,6,0
5071,5071,5072,6,0,-6
5072,5072,5073,0,1,1
5073,5073,5074,1,0,-1
5074,5074,5075,0,1,1
5075,5075,5076,1,2,1
5076,5076,5077,2,4,2
5077,5077,5078,4,8,4
5078,5078,5079,8,5,-3
5079,5079,5080,5,3,-2
5080,5080,5081,3,5,2
5081,5081,5082,5,0,-5
5082,5082,5083,0,0,0
5083,5083,5084,0,6,6
5084,5084,5085,6,4,-2
5085,5085,5086,4,3,-1
5086,5086,5087,3,8,5
5087,5087,5088,8,3,-5
5088,5088,5089,3,7,4
5089,5089,5090,7,1,-6
5090,5090,5091,1,4,3
5091,5091,5092,4,3,-1
5092,5092,5093,3,9,6
5093,5093,5094,9,2,-7
5094,5094,5095,2,2,0
5095,5095,5096,2,0,-2
5096,5096,5097,0,3,3
5097,5097,5098,3,6,3
5098,5098,5099,6,6,0
5099,5099,5100,6,7,1
5100,5100,5101,7,4,-3
5101,5101,5102,4,3,-1
5102,5102,5103,3,2,-1
5103,5103,5104,2,2,0
5104,5104,5105,2,4,2
5105,5105,5106,4,9,5
5106,5106,5107,9,1,-8
5107,5107,5108,1,0,-1
5108,5108,5109,0,5,5
5109,5109,5110,5,2,-3
5110,5110,5111,2,4,2
5111,5111,5112,4,8,4
5112,5112,5113,8,2,-6
5113,5113,5114,2,1,-1
5114,5114,5115,1,0,-1
5115,5115,5116,0,8,8
5116,5116,5117,8,4,-4
5117,5117,5118,4,4,0
5118,5118,5119,4,8,4
5119,5119,5120,8,0,-8
5120,5120,5121,0,6,6
5121,5121,5122,6,4,-2
5122,5122,5123,4,1,-3
5123,5123,5124,1,4,3
5124,5124,5125,4,9,5
5125,5125,5126,9,6,-3
5126,5126,5127,6,3,-3
5127,5127,5128,3,1,-2
5128,5128,5129,1,2,1
5129,5129,5130,2,9,7
5130,5130,5131,9,0,-9
5131,5131,5132,0,1,1
5132,5132,5133,1,0,-1
5133,5133,5134,0,4,4
5134,5134,5135,4,2,-2
5135,5135,5136,2,9,7
5136,5136,5137,9,9,0
5137,5137,5138,9,4,-5
5138,5138,5139,4,3,-1
5139,5139,5140,3,8,5
5140,5140,5141,8,6,-2
5141,5141,5142,6,9,3
5142,5142,5143,9,3,-6
5143,5143,5144,3,0,-3
5144,5144,5145,0,6,6
5145,5145,5146,6,7,1
5146,5146,5147,7,0,-7
5147,5147,5148,0,3,3
5148,5148,5149,3,1,-2
5149,5149,5150,1,4,3
5150,5150,5151,4,2,-2
5151,5151,5152,2,3,1
5152,5152,5153,3,3,0
5153,5153,5154,3,0,-3
5154,5154,5155,0,4,4
5155,5155,5156,4,2,-2
5156,5156,5157,2,5,3
5157,5157,5158,5,5,0
5158,5158,5159,5,6,1
5159,5159,5160,6,3,-3
5160,5160,5161,3,7,4
5161,5161,5162,7,2,-5
5162,5162,5163,2,8,6
5163,5163,5164,8,5,-3
5164,5164,5165,5,9,4
5165,5165,5166,9,2,-7
5166,5166,5167,2,0,-2
5167,5167,5168,0,1,1
5168,5168,5169,1,1,0
5169,5169,5170,1,8,7
5170,5170,5171,8,2,-6
5171,5171,5172,2,9,7
5172,5172,5173,9,3,-6
5173,5173,5174,3,1,-2
5174,5174,5175,1,4,3
5175,5175,5176,4,1,-3
5176,5176,5177,1,5,4
5177,5177,5178,5,7,2
5178,5178,5179,7,6,-1
5179,5179,5180,6,4,-2
5180,5180,5181,4,7,3
5181,5181,5182,7,7,0
5182,5182,5183,7,8,1
5183,5183,5184,8,3,-5
5184,5184,5185,3,9,6
5185,5185,5186,9,3,-6
5186,5186,5187,3,0,-3
5187,5187,5188,0,5,5
5188,5188,5189,5,1,-4
5189,5189,5190,1,3,2
5190,5190,5191,3,2,-1
5191,5191,5192,2,0,-2
5192,5192,5193,0,3,3
5193,5193,5194,3,0,-3
5194,5194,5195,0,4,4
5195,5195,5196,4,0,-4
5196,5196,5197,0,7,7
5197,5197,5198,7,4,-3
5198,5198,5199,4,8,4
5199,5199,5200,8,8,0
5200,5200,5201,8,9,1
5201,5201,5202,9,0,-9
5202,5202,5203,0,0,0
5203,5203,5204,0,1,1
5204,5204,5205,1,8,7
5205,5205,5206,8,7,-1
5206,5206,5207,7,3,-4
5207,5207,5208,3,9,6
5208,5208,5209,9,9,0
5209,5209,5210,9,5,-4
5210,5210,5211,5,5,0
5211,5211,5212,5,9,4
5212,5212,5213,9,6,-3
5213,5213,5214,6,7,1
5214,5214,5215,7,8,1
5215,5215,5216,8,2,-6
5216,5216,5217,2,4,2
5217,5217,5218,4,6,2
5218,5218,5219,6,9,3
5219,5219,5220,9,8,-1
5220,5220,5221,8,1,-7
5221,5221,5222,1,6,5
5222,5222,5223,6,7,1
5223,5223,5224,7,9,2
5224,5224,5225,9,1,-8
5225,5225,5226,1,6,5
5226,5226,5227,6,2,-4
5227,5227,5228,2,0,-2
5228,5228,5229,0,9,9
5229,5229,5230,9,6,-3
5230,5230,5231,6,6,0
5231,5231,5232,6,2,-4
5232,5232,5233,2,9,7
5233,5233,5234,9,1,-8
5234,5234,5235,1,1,0
5235,5235,5236,1,2,1
5236,5236,5237,2,1,-1
5237,5237,5238,1,3,2
5238,5238,5239,3,1,-2
5239,5239,5240,1,5,4
5240,5240,5241,5,2,-3
5241,5241,5242,2,7,5
5242,5242,5243,7,8,1
5243,5243,5244,8,0,-8
5244,5244,5245,0,1,1
5245,5245,5246,1,0,-1
5246,5246,5247,0,2,2
5247,5247,5248,2,8,6
5248,5248,5249,8,0,-8
5249,5249,5250,0,2,2
5250,5250,5251,2,7,5
5251,5251,5252,7,3,-4
5252,5252,5253,3,7,4
5253,5253,5254,7,5,-2
5254,5254,5255,5,5,0
5255,5255,5256,5,1,-4
5256,5256,5257,1,8,7
5257,5257,5258,8,2,-6
5258,5258,5259,2,2,0
5259,5259,5260,2,6,4
5260,5260,5261,6,9,3
5261,5261,5262,9,1,-8
5262,5262,5263,1,8,7
5263,5263,5264,8,7,-1
5264,5264,5265,7,4,-3
5265,5265,5266,4,0,-4
5266,5266,5267,0,6,6
5267,5267,5268,6,0,-6
5268,5268,5269,0,7,7
5269,5269,5270,7,3,-4
5270,5270,5271,3,1,-2
5271,5271,5272,1,0,-1
5272,5272,5273,0,6,6
5273,5273,5274,6,6,0
5274,5274,5275,6,0,-6
5275,5275,5276,0,9,9
5276,5276,5277,9,3,-6
5277,5277,5278,3,4,1
5278,5278,5279,4,6,2
5279,5279,5280,6,7,1
5280,5280,5281,7,8,1
5281,5281,5282,8,9,1
5282,5282,5283,9,7,-2
5283,5283,5284,7,3,-4
5284,5284,5285,3,0,-3
5285,5285,5286,0,0,0
5286,5286,5287,0,4,4
5287,5287,5288,4,0,-4
5288,5288,5289,0,2,2
5289,5289,5290,2,6,4
5290,5290,5291,6,7,1
5291,5291,5292,7,5,-2
5292,5292,5293,5,4,-1
5293,5293,5294,4,6,2
5294,5294,5295,6,4,-2
5295,5295,5296,4,8,4
5296,5296,5297,8,2,-6
5297,5297,5298,2,0,-2
5298,5298,5299,0,8,8
5299,5299,5300,8,7,-1
5300,5300,5301,7,1,-6
5301,5301,5302,1,7,6
5302,5302,5303,7,5,-2
5303,5303,5304,5,1,-4
5304,5304,5305,1,1,0
5305,5305,5306,1,2,1
5306,5306,5307,2,2,0
5307,5307,5308,2,7,5
5308,5308,5309,7,5,-2
5309,5309,5310,5,6,1
5310,5310,5311,6,6,0
5311,5311,5312,6,7,1
5312,5312,5313,7,4,-3
5313,5313,5314,4,2,-2
5314,5314,5315,2,3,1
5315,5315,5316,3,9,6
5316,5316,5317,9,0,-9
5317,5317,5318,0,2,2
5318,5318,5319,2,0,-2
5319,5319,5320,0,9,9
5320,5320,5321,9,0,-9
5321,5321,5322,0,4,4
5322,5322,5323,4,3,-1
5323,5323,5324,3,4,1
5324,5324,5325,4,7,3
5325,5325,5326,7,7,0
5326,5326,5327,7,0,-7
5327,5327,5328,0,3,3
5328,5328,5329,3,6,3
5329,5329,5330,6,0,-6
5330,5330,5331,0,4,4
5331,5331,5332,4,3,-1
5332,5332,5333,3,8,5
5333,5333,5334,8,6,-2
5334,5334,5335,6,8,2
5335,5335,5336,8,1,-7
5336,5336,5337,1,3,2
5337,5337,5338,3,8,5
5338,5338,5339,8,9,1
5339,5339,5340,9,0,-9
5340,5340,5341,0,9,9
5341,5341,5342,9,0,-9
5342,5342,5343,0,8,8
5343,5343,5344,8,0,-8
5344,5344,5345,0,2,2
5345,5345,5346,2,8,6
5346,5346,5347,8,7,-1
5347,5347,5348,7,8,1
5348,5348,5349,8,7,-1
5349,5349,5350,7,9,2
5350,5350,5351,9,1,-8
5351,5351,5352,1,7,6
5352,5352,5353,7,0,-7
5353,5353,5354,0,3,3
5354,5354,5355,3,1,-2
5355,5355,5356,1,4,3
5356,5356,5357,4,2,-2
5357,5357,5358,2,3,1
5358,5358,5359,3,3,0
5359,5359,5360,3,8,5
5360,5360,5361,8,4,-4
5361,5361,5362,4,9,5
5362,5362,5363,9,5,-4
5363,5363,5364,5,6,1
5364,5364,5365,6,6,0
5365,5365,5366,6,4,-2
5366,5366,5367,4,7,3
5367,5367,5368,7,0,-7
5368,5368,5369,0,8,8
5369,5369,5370,8,3,-5
5370,5370,5371,3,9,6
5371,5371,5372,9,8,-1
5372,5372,5373,8,0,-8
5373,5373,5374,0,6,6
5374,5374,5375,6,1,-5
5375,5375,5376,1,8,7
5376,5376,5377,8,2,-6
5377,5377,5378,2,5,3
5378,5378,5379,5,3,-2
5379,5379,5380,3,2,-1
5380,5380,5381,2,4,2
5381,5381,5382,4,5,1
5382,5382,5383,5,5,0
5383,5383,5384,5,6,1
5384,5384,5385,6,6,0
5385,5385,5386,6,9,3
5386,5386,5387,9,7,-2
5387,5387,5388,7,3,-4
5388,5388,5389,3,8,5
5389,5389,5390,8,9,1
5390,5390,5391,9,9,0
5391,5391,5392,9,3,-6
5392,5392,5393,3,0,-3
5393,5393,5394,0,8,8
5394,5394,5395,8,1,-7
5395,5395,5396,1,3,2
5396,5396,5397,3,2,-1
5397,5397,5398,2,0,-2
5398,5398,5399,0,3,3
5399,5399,5400,3,2,-1
5400,5400,5401,2,4,2
5401,5401,5402,4,9,5
5402,5402,5403,9,5,-4
5403,5403,5404,5,9,4
5404,5404,5405,9,6,-3
5405,5405,5406,6,4,-2
5406,5406,5407,4,7,3
5407,5407,5408,7,3,-4
5408,5408,5409,3,8,5
5409,5409,5410,8,4,-4
5410,5410,5411,4,9,5
5411,5411,5412,9,3,-6
5412,5412,5413,3,6,3
5413,5413,5414,6,5,-1
5414,5414,5415,5,2,-3
5415,5415,5416,2,7,5
5416,5416,5417,7,5,-2
5417,5417,5418,5,8,3
5418,5418,5419,8,6,-2
5419,5419,5420,6,2,-4
5420,5420,5421,2,2,0
5421,5421,5422,2,7,5
5422,5422,5423,7,5,-2
5423,5423,5424,5,5,0
5424,5424,5425,5,1,-4
5425,5425,5426,1,9,8
5426,5426,5427,9,7,-2
5427,5427,5428,7,1,-6
5428,5428,5429,1,1,0
5429,5429,5430,1,8,7
5430,5430,5431,8,8,0
5431,5431,5432,8,3,-5
5432,5432,5433,3,3,0
5433,5433,5434,3,3,0
5434,5434,5435,3,8,5
5435,5435,5436,8,2,-6
5436,5436,5437,2,7,5
5437,5437,5438,7,2,-5
5438,5438,5439,2,1,-1
5439,5439,5440,1,5,4
5440,5440,5441,5,7,2
5441,5441,5442,7,3,-4
5442,5442,5443,3,1,-2
5443,5443,5444,1,4,3
5444,5444,5445,4,4,0
5445,5445,5446,4,7,3
5446,5446,5447,7,7,0
5447,5447,5448,7,7,0
5448,5448,5449,7,2,-5
5449,5449,5450,2,4,2
5450,5450,5451,4,6,2
5451,5451,5452,6,5,-1
5452,5452,5453,5,5,0
5453,5453,5454,5,9,4
5454,5454,5455,9,3,-6
5455,5455,5456,3,5,2
5456,5456,5457,5,9,4
5457,5457,5458,9,3,-6
5458,5458,5459,3,9,6
5459,5459,5460,9,8,-1
5460,5460,5461,8,0,-8
5461,5461,5462,0,0,0
5462,5462,5463,0,8,8
5463,5463,5464,8,0,-8
5464,5464,5465,0,7,7
5465,5465,5466,7,6,-1
5466,5466,5467,6,3,-3
5467,5467,5468,3,0,-3
5468,5468,5469,0,0,0
5469,5469,5470,0,0,0
5470,5470,5471,0,3,3
5471,5471,5472,3,7,4
5472,5472,5473,7,7,0
5473,5473,5474,7,8,1
5474,5474,5475,8,0,-8
5475,5475,5476,0,8,8
5476,5476,5477,8,1,-7
5477,5477,5478,1,9,8
5478,5478,5479,9,1,-8
5479,5479,5480,1,2,1
5480,5480,5481,2,2,0
5481,5481,5482,2,4,2
5482,5482,5483,4,1,-3
5483,5483,5484,1,1,0
5484,5484,5485,1,6,5
5485,5485,5486,6,6,0
5486,5486,5487,6,0,-6
5487,5487,5488,0,0,0
5488,5488,5489,0,5,5
5489,5489,5490,5,4,-1
5490,5490,5491,4,3,-1
5491,5491,5492,3,9,6
5492,5492,5493,9,3,-6
5493,5493,5494,3,1,-2
5494,5494,5495,1,6,5
5495,5495,5496,6,7,1
5496,5496,5497,7,3,-4
5497,5497,5498,3,0,-3
5498,5498,5499,0,5,5
5499,5499,5500,5,1,-4
5500,5500,5501,1,9,8
5501,5501,5502,9,0,-9
5502,5502,5503,0,9,9
5503,5503,5504,9,7,-2
5504,5504,5505,7,0,-7
5505,5505,5506,0,5,5
5506,5506,5507,5,1,-4
5507,5507,5508,1,2,1
5508,5508,5509,2,2,0
5509,5509,5510,2,3,1
5510,5510,5511,3,3,0
5511,5511,5512,3,0,-3
5512,5512,5513,0,4,4
5513,5513,5514,4,0,-4
5514,5514,5515,0,5,5
5515,5515,5516,5,1,-4
5516,5516,5517,1,6,5
5517,5517,5518,6,9,3
5518,5518,5519,9,7,-2
5519,5519,5520,7,1,-6
5520,5520,5521,1,8,7
5521,5521,5522,8,9,1
5522,5522,5523,9,9,0
5523,5523,5524,9,6,-3
5524,5524,5525,6,0,-6
5525,5525,5526,0,5,5
5526,5526,5527,5,1,-4
5527,5527,5528,1,2,1
5528,5528,5529,2,2,0
5529,5529,5530,2,1,-1
5530,5530,5531,1,3,2
5531,5531,5532,3,9,6
5532,5532,5533,9,4,-5
5533,5533,5534,4,8,4
5534,5534,5535,8,7,-1
5535,5535,5536,7,8,1
5536,5536,5537,8,8,0
5537,5537,5538,8,9,1
5538,5538,5539,9,9,0
5539,5539,5540,9,7,-2
5540,5540,5541,7,0,-7
5541,5541,5542,0,3,3
5542,5542,5543,3,1,-2
5543,5543,5544,1,9,8
5544,5544,5545,9,2,-7
5545,5545,5546,2,7,5
5546,5546,5547,7,3,-4
5547,5547,5548,3,8,5
5548,5548,5549,8,4,-4
5549,5549,5550,4,5,1
5550,5550,5551,5,5,0
5551,5551,5552,5,1,-4
5552,5552,5553,1,6,5
5553,5553,5554,6,6,0
5554,5554,5555,6,7,1
5555,5555,5556,7,6,-1
5556,5556,5557,6,8,2
5557,5557,5558,8,9,1
5558,5558,5559,9,9,0
5559,5559,5560,9,0,-9
5560,5560,5561,0,6,6
5561,5561,5562,6,3,-3
5562,5562,5563,3,0,-3
5563,5563,5564,0,7,7
5564,5564,5565,7,7,0
5565,5565,5566,7,6,-1
5566,5566,5567,6,3,-3
5567,5567,5568,3,7,4
5568,5568,5569,7,7,0
5569,5569,5570,7,1,-6
5570,5570,5571,1,1,0
5571,5571,5572,1,9,8
5572,5572,5573,9,3,-6
5573,5573,5574,3,8,5
5574,5574,5575,8,7,-1
5575,5575,5576,7,6,-1
5576,5576,5577,6,9,3
5577,5577,5578,9,3,-6
5578,5578,5579,3,7,4
5579,5579,5580,7,4,-3
5580,5580,5581,4,4,0
5581,5581,5582,4,1,-3
5582,5582,5583,1,0,-1
5583,5583,5584,0,7,7
5584,5584,5585,7,0,-7
5585,5585,5586,0,6,6
5586,5586,5587,6,6,0
5587,5587,5588,6,3,-3
5588,5588,5589,3,9,6
5589,5589,5590,9,4,-5
5590,5590,5591,4,5,1
5591,5591,5592,5,9,4
5592,5592,5593,9,6,-3
5593,5593,5594,6,8,2
5594,5594,5595,8,9,1
5595,5595,5596,9,7,-2
5596,5596,5597,7,8,1
5597,5597,5598,8,5,-3
5598,5598,5599,5,5,0
5599,5599,5600,5,6,1
5600,5600,5601,6,1,-5
5601,5601,5602,1,2,1
5602,5602,5603,2,5,3
5603,5603,5604,5,0,-5
5604,5604,5605,0,3,3
5605,5605,5606,3,5,2
5606,5606,5607,5,9,4
5607,5607,5608,9,0,-9
5608,5608,5609,0,8,8
5609,5609,5610,8,1,-7
5610,5610,5611,1,3,2
5611,5611,5612,3,0,-3
5612,5612,5613,0,4,4
5613,5613,5614,4,9,5
5614,5614,5615,9,0,-9
5615,5615,5616,0,3,3
5616,5616,5617,3,5,2
5617,5617,5618,5,2,-3
5618,5618,5619,2,6,4
5619,5619,5620,6,5,-1
5620,5620,5621,5,3,-2
5621,5621,5622,3,0,-3
5622,5622,5623,0,4,4
5623,5623,5624,4,2,-2
5624,5624,5625,2,8,6
5625,5625,5626,8,7,-1
5626,5626,5627,7,0,-7
5627,5627,5628,0,8,8
5628,5628,5629,8,6,-2
5629,5629,5630,6,1,-5
5630,5630,5631,1,4,3
5631,5631,5632,4,6,2
5632,5632,5633,6,8,2
5633,5633,5634,8,6,-2
5634,5634,5635,6,1,-5
5635,5635,5636,1,4,3
5636,5636,5637,4,3,-1
5637,5637,5638,3,2,-1
5638,5638,5639,2,4,2
5639,5639,5640,4,3,-1
5640,5640,5641,3,0,-3
5641,5641,5642,0,3,3
5642,5642,5643,3,1,-2
5643,5643,5644,1,1,0
5644,5644,5645,1,9,8
5645,5645,5646,9,0,-9
5646,5646,5647,0,2,2
5647,5647,5648,2,1,-1
5648,5648,5649,1,3,2
5649,5649,5650,3,7,4
5650,5650,5651,7,7,0
5651,5651,5652,7,7,0
5652,5652,5653,7,5,-2
5653,5653,5654,5,6,1
5654,5654,5655,6,1,-5
5655,5655,5656,1,2,1
5656,5656,5657,2,7,5
5657,5657,5658,7,9,2
5658,5658,5659,9,2,-7
5659,5659,5660,2,3,1
5660,5660,5661,3,8,5
5661,5661,5662,8,0,-8
5662,5662,5663,0,7,7
5663,5663,5664,7,9,2
5664,5664,5665,9,0,-9
5665,5665,5666,0,5,5
5666,5666,5667,5,1,-4
5667,5667,5668,1,5,4
5668,5668,5669,5,9,4
5669,5669,5670,9,8,-1
5670,5670,5671,8,6,-2
5671,5671,5672,6,9,3
5672,5672,5673,9,4,-5
5673,5673,5674,4,0,-4
5674,5674,5675,0,1,1
5675,5675,5676,1,7,6
5676,5676,5677,7,2,-5
5677,5677,5678,2,5,3
5678,5678,5679,5,3,-2
5679,5679,5680,3,8,5
5680,5680,5681,8,1,-7
5681,5681,5682,1,6,5
5682,5682,5683,6,3,-3
5683,5683,5684,3,6,3
5684,5684,5685,6,5,-1
5685,5685,5686,5,6,1
5686,5686,5687,6,3,-3
5687,5687,5688,3,5,2
5688,5688,5689,5,4,-1
5689,5689,5690,4,0,-4
5690,5690,5691,0,1,1
5691,5691,5692,1,0,-1
5692,5692,5693,0,6,6
5693,5693,5694,6,0,-6
5694,5694,5695,0,8,8
5695,5695,5696,8,8,0
5696,5696,5697,8,0,-8
5697,5697,5698,0,0,0
5698,5698,5699,0,8,8
5699,5699,5700,8,2,-6
5700,5700,5701,2,9,7
5701,5701,5702,9,3,-6
5702,5702,5703,3,4,1
5703,5703,5704,4,9,5
5704,5704,5705,9,9,0
5705,5705,5706,9,2,-7
5706,5706,5707,2,2,0
5707,5707,5708,2,1,-1
5708,5708,5709,1,6,5
5709,5709,5710,6,3,-3
5710,5710,5711,3,0,-3
5711,5711,5712,0,5,5
5712,5712,5713,5,1,-4
5713,5713,5714,1,1,0
5714,5714,5715,1,2,1
5715,5715,5716,2,7,5
5716,5716,5717,7,3,-4
5717,5717,5718,3,9,6
5718,5718,5719,9,5,-4
5719,5719,5720,5,4,-1
5720,5720,5721,4,6,2
5721,5721,5722,6,2,-4
5722,5722,5723,2,7,5
5723,5723,5724,7,2,-5
5724,5724,5725,2,8,6
5725,5725,5726,8,9,1
5726,5726,5727,9,9,0
5727,5727,5728,9,3,-6
5728,5728,5729,3,0,-3
5729,5729,5730,0,0,0
5730,5730,5731,0,1,1
5731,5731,5732,1,1,0
5732,5732,5733,1,2,1
5733,5733,5734,2,4,2
5734,5734,5735,4,4,0
5735,5735,5736,4,3,-1
5736,5736,5737,3,5,2
5737,5737,5738,5,3,-2
5738,5738,5739,3,6,3
5739,5739,5740,6,9,3
5740,5740,5741,9,7,-2
5741,5741,5742,7,5,-2
5742,5742,5743,5,8,3
5743,5743,5744,8,2,-6
5744,5744,5745,2,9,7
5745,5745,5746,9,9,0
5746,5746,5747,9,0,-9
5747,5747,5748,0,3,3
5748,5748,5749,3,1,-2
5749,5749,5750,1,6,5
5750,5750,5751,6,2,-4
5751,5751,5752,2,5,3
5752,5752,5753,5,3,-2
5753,5753,5754,3,7,4
5754,5754,5755,7,4,-3
5755,5755,5756,4,1,-3
5756,5756,5757,1,5,4
5757,5757,5758,5,2,-3
5758,5758,5759,2,6,4
5759,5759,5760,6,1,-5
5760,5760,5761,1,7,6
5761,5761,5762,7,2,-5
5762,5762,5763,2,8,6
5763,5763,5764,8,4,-4
5764,5764,5765,4,9,5
5765,5765,5766,9,6,-3
5766,5766,5767,6,0,-6
5767,5767,5768,0,7,7
5768,5768,5769,7,7,0
5769,5769,5770,7,3,-4
5770,5770,5771,3,5,2
5771,5771,5772,5,6,1
5772,5772,5773,6,0,-6
5773,5773,5774,0,6,6
5774,5774,5775,6,8,2
5775,5775,5776,8,5,-3
5776,5776,5777,5,4,-1
5777,5777,5778,4,7,3
5778,5778,5779,7,1,-6
5779,5779,5780,1,6,5
5780,5780,5781,6,8,2
5781,5781,5782,8,6,-2
5782,5782,5783,6,8,2
5783,5783,5784,8,7,-1
5784,5784,5785,7,1,-6
5785,5785,5786,1,7,6
5786,5786,5787,7,3,-4
5787,5787,5788,3,3,0
5788,5788,5789,3,1,-2
5789,5789,5790,1,2,1
5790,5790,5791,2,8,6
5791,5791,5792,8,4,-4
5792,5792,5793,4,3,-1
5793,5793,5794,3,9,6
5794,5794,5795,9,7,-2
5795,5795,5796,7,4,-3
5796,5796,5797,4,9,5
5797,5797,5798,9,3,-6
5798,5798,5799,3,3,0
5799,5799,5800,3,8,5
5800,5800,5801,8,0,-8
5801,5801,5802,0,6,6
5802,5802,5803,6,9,3
5803,5803,5804,9,6,-3
5804,5804,5805,6,4,-2
5805,5805,5806,4,9,5
5806,5806,5807,9,4,-5
5807,5807,5808,4,0,-4
5808,5808,5809,0,0,0
5809,5809,5810,0,6,6
5810,5810,5811,6,7,1
5811,5811,5812,7,3,-4
5812,5812,5813,3,4,1
5813,5813,5814,4,1,-3
5814,5814,5815,1,2,1
5815,5815,5816,2,2,0
5816,5816,5817,2,9,7
5817,5817,5818,9,7,-2
5818,5818,5819,7,8,1
5819,5819,5820,8,3,-5
5820,5820,5821,3,7,4
5821,5821,5822,7,4,-3
5822,5822,5823,4,2,-2
5823,5823,5824,2,1,-1
5824,5824,5825,1,7,6
5825,5825,5826,7,6,-1
5826,5826,5827,6,8,2
5827,5827,5828,8,5,-3
5828,5828,5829,5,9,4
5829,5829,5830,9,0,-9
5830,5830,5831,0,3,3
5831,5831,5832,3,6,3
5832,5832,5833,6,1,-5
5833,5833,5834,1,1,0
5834,5834,5835,1,4,3
5835,5835,5836,4,9,5
5836,5836,5837,9,6,-3
5837,5837,5838,6,3,-3
5838,5838,5839,3,5,2
5839,5839,5840,5,1,-4
5840,5840,5841,1,2,1
5841,5841,5842,2,1,-1
5842,5842,5843,1,2,1
5843,5843,5844,2,0,-2
5844,5844,5845,0,2,2
5845,5845,5846,2,6,4
5846,5846,5847,6,5,-1
5847,5847,5848,5,6,1
5848,5848,5849,6,6,0
5849,5849,5850,6,1,-5
5850,5850,5851,1,7,6
5851,5851,5852,7,3,-4
5852,5852,5853,3,8,5
5853,5853,5854,8,4,-4
5854,5854,5855,4,7,3
5855,5855,5856,7,5,-2
5856,5856,5857,5,5,0
5857,5857,5858,5,3,-2
5858,5858,5859,3,1,-2
5859,5859,5860,1,9,8
5860,5860,5861,9,6,-3
5861,5861,5862,6,1,-5
5862,5862,5863,1,4,3
5863,5863,5864,4,1,-3
5864,5864,5865,1,9,8
5865,5865,5866,9,5,-4
5866,5866,5867,5,2,-3
5867,5867,5868,2,9,7
5868,5868,5869,9,9,0
5869,5869,5870,9,3,-6
5870,5870,5871,3,3,0
5871,5871,5872,3,5,2
5872,5872,5873,5,5,0
5873,5873,5874,5,9,4
5874,5874,5875,9,3,-6
5875,5875,5876,3,1,-2
5876,5876,5877,1,6,5
5877,5877,5878,6,9,3
5878,5878,5879,9,6,-3
5879,5879,5880,6,4,-2
5880,5880,5881,4,0,-4
5881,5881,5882,0,1,1
5882,5882,5883,1,0,-1
5883,5883,5884,0,0,0
5884,5884,5885,0,2,2
5885,5885,5886,2,0,-2
5886,5886,5887,0,5,5
5887,5887,5888,5,0,-5
5888,5888,5889,0,6,6
5889,5889,5890,6,2,-4
5890,5890,5891,2,4,2
5891,5891,5892,4,9,5
5892,5892,5893,9,9,0
5893,5893,5894,9,8,-1
5894,5894,5895,8,2,-6
5895,5895,5896,2,8,6
5896,5896,5897,8,7,-1
5897,5897,5898,7,9,2
5898,5898,5899,9,4,-5
5899,5899,5900,4,2,-2
5900,5900,5901,2,9,7
5901,5901,5902,9,2,-7
5902,5902,5903,2,1,-1
5903,5903,5904,1,5,4
5904,5904,5905,5,0,-5
5905,5905,5906,0,7,7
5906,5906,5907,7,2,-5
5907,5907,5908,2,2,0
5908,5908,5909,2,2,0
5909,5909,5910,2,6,4
5910,5910,5911,6,3,-3
5911,5911,5912,3,7,4
5912,5912,5913,7,6,-1
5913,5913,5914,6,2,-4
5914,5914,5915,2,1,-1
5915,5915,5916,1,8,7
5916,5916,5917,8,8,0
5917,5917,5918,8,9,1
5918,5918,5919,9,3,-6
5919,5919,5920,3,6,3
5920,5920,5921,6,0,-6
5921,5921,5922,0,3,3
5922,5922,5923,3,3,0
5923,5923,5924,3,9,6
5924,5924,5925,9,5,-4
5925,5925,5926,5,3,-2
5926,5926,5927,3,0,-3
5927,5927,5928,0,2,2
5928,5928,5929,2,0,-2
5929,5929,5930,0,1,1
5930,5930,5931,1,6,5
5931,5931,5932,6,0,-6
5932,5932,5933,0,1,1
5933,5933,5934,1,5,4
5934,5934,5935,5,6,1
5935,5935,5936,6,4,-2
5936,5936,5937,4,9,5
5937,5937,5938,9,0,-9
5938,5938,5939,0,5,5
5939,5939,5940,5,9,4
5940,5940,5941,9,3,-6
5941,5941,5942,3,3,0
5942,5942,5943,3,9,6
5943,5943,5944,9,4,-5
5944,5944,5945,4,4,0
5945,5945,5946,4,7,3
5946,5946,5947,7,5,-2
5947,5947,5948,5,6,1
5948,5948,5949,6,8,2
5949,5949,5950,8,1,-7
5950,5950,5951,1,6,5
5951,5951,5952,6,2,-4
5952,5952,5953,2,7,5
5953,5953,5954,7,4,-3
5954,5954,5955,4,1,-3
5955,5955,5956,1,6,5
5956,5956,5957,6,1,-5
5957,5957,5958,1,3,2
5958,5958,5959,3,7,4
5959,5959,5960,7,4,-3
5960,5960,5961,4,0,-4
5961,5961,5962,0,6,6
5962,5962,5963,6,1,-5
5963,5963,5964,1,9,8
5964,5964,5965,9,2,-7
5965,5965,5966,2,1,-1
5966,5966,5967,1,3,2
5967,5967,5968,3,7,4
5968,5968,5969,7,4,-3
5969,5969,5970,4,3,-1
5970,5970,5971,3,5,2
5971,5971,5972,5,8,3
5972,5972,5973,8,6,-2
5973,5973,5974,6,3,-3
5974,5974,5975,3,7,4
5975,5975,5976,7,7,0
5976,5976,5977,7,8,1
5977,5977,5978,8,0,-8
5978,5978,5979,0,9,9
5979,5979,5980,9,3,-6
5980,5980,5981,3,0,-3
5981,5981,5982,0,4,4
5982,5982,5983,4,1,-3
5983,5983,5984,1,5,4
5984,5984,5985,5,2,-3
5985,5985,5986,2,7,5
5986,5986,5987,7,3,-4
5987,5987,5988,3,2,-1
5988,5988,5989,2,4,2
5989,5989,5990,4,6,2
5990,5990,5991,6,5,-1
5991,5991,5992,5,9,4
5992,5992,5993,9,6,-3
5993,5993,5994,6,1,-5
5994,5994,5995,1,7,6
5995,5995,5996,7,6,-1
5996,5996,5997,6,8,2
5997,5997,5998,8,6,-2
5998,5998,5999,6,9,3
5999,5999,6000,9,6,-3
6000,6000,6001,6,0,-6
6001,6001,6002,0,1,1
6002,6002,6003,1,1,0
6003,6003,6004,1,5,4
6004,6004,6005,5,2,-3
6005,6005,6006,2,8,6
6006,6006,6007,8,3,-5
6007,6007,6008,3,0,-3
6008,6008,6009,0,4,4
6009,6009,6010,4,9,5
6010,6010,6011,9,5,-4
6011,6011,6012,5,2,-3
6012,6012,6013,2,6,4
6013,6013,6014,6,7,1
6014,6014,6015,7,7,0
6015,6015,6016,7,3,-4
6016,6016,6017,3,8,5
6017,6017,6018,8,5,-3
6018,6018,6019,5,9,4
6019,6019,6020,9,1,-8
6020,6020,6021,1,1,0
6021,6021,6022,1,8,7
6022,6022,6023,8,0,-8
6023,6023,6024,0,6,6
6024,6024,6025,6,4,-2
6025,6025,6026,4,5,1
6026,6026,6027,5,5,0
6027,6027,6028,5,4,-1
6028,6028,6029,4,6,2
6029,6029,6030,6,8,2
6030,6030,6031,8,6,-2
6031,6031,6032,6,3,-3
6032,6032,6033,3,3,0
6033,6033,6034,3,0,-3
6034,6034,6035,0,4,4
6035,6035,6036,4,9,5
6036,6036,6037,9,4,-5
6037,6037,6038,4,2,-2
6038,6038,6039,2,2,0
6039,6039,6040,2,3,1
6040,6040,6041,3,8,5
6041,6041,6042,8,9,1
6042,6042,6043,9,1,-8
6043,6043,6044,1,2,1
6044,6044,6045,2,0,-2
6045,6045,6046,0,7,7
6046,6046,6047,7,6,-1
6047,6047,6048,6,3,-3
6048,6048,6049,3,4,1
6049,6049,6050,4,7,3
6050,6050,6051,7,9,2
6051,6051,6052,9,1,-8
6052,6052,6053,1,7,6
6053,6053,6054,7,7,0
6054,6054,6055,7,2,-5
6055,6055,6056,2,2,0
6056,6056,6057,2,3,1
6057,6057,6058,3,4,1
6058,6058,6059,4,3,-1
6059,6059,6060,3,2,-1
6060,6060,6061,2,9,7
6061,6061,6062,9,1,-8
6062,6062,6063,1,2,1
6063,6063,6064,2,7,5
6064,6064,6065,7,0,-7
6065,6065,6066,0,8,8
6066,6066,6067,8,9,1
6067,6067,6068,9,5,-4
6068,6068,6069,5,3,-2
6069,6069,6070,3,1,-2
6070,6070,6071,1,3,2
6071,6071,6072,3,8,5
6072,6072,6073,8,9,1
6073,6073,6074,9,9,0
6074,6074,6075,9,1,-8
6075,6075,6076,1,0,-1
6076,6076,6077,0,5,5
6077,6077,6078,5,9,4
6078,6078,6079,9,2,-7
6079,6079,6080,2,2,0
6080,6080,6081,2,3,1
6081,6081,6082,3,1,-2
6082,6082,6083,1,1,0
6083,6083,6084,1,9,8
6084,6084,6085,9,6,-3
6085,6085,6086,6,5,-1
6086,6086,6087,5,7,2
6087,6087,6088,7,7,0
6088,6088,6089,7,3,-4
6089,6089,6090,3,6,3
6090,6090,6091,6,7,1
6091,6091,6092,7,9,2
6092,6092,6093,9,8,-1
6093,6093,6094,8,0,-8
6094,6094,6095,0,4,4
6095,6095,6096,4,5,1
6096,6096,6097,5,0,-5
6097,6097,6098,0,3,3
6098,6098,6099,3,2,-1
6099,6099,6100,2,9,7
6100,6100,6101,9,4,-5
6101,6101,6102,4,6,2
6102,6102,6103,6,0,-6
6103,6103,6104,0,1,1
6104,6104,6105,1,2,1
6105,6105,6106,2,3,1
6106,6106,6107,3,4,1
6107,6107,6108,4,1,-3
6108,6108,6109,1,7,6
6109,6109,6110,7,1,-6
6110,6110,6111,1,8,7
6111,6111,6112,8,5,-3
6112,6112,6113,5,0,-5
6113,6113,6114,0,2,2
6114,6114,6115,2,7,5
6115,6115,6116,7,1,-6
6116,6116,6117,1,0,-1
6117,6117,6118,0,3,3
6118,6118,6119,3,6,3
6119,6119,6120,6,4,-2
6120,6120,6121,4,9,5
6121,6121,6122,9,1,-8
6122,6122,6123,1,3,2
6123,6123,6124,3,2,-1
6124,6124,6125,2,2,0
6125,6125,6126,2,2,0
6126,6126,6127,2,4,2
6127,6127,6128,4,4,0
6128,6128,6129,4,8,4
6129,6129,6130,8,7,-1
6130,6130,6131,7,6,-1
6131,6131,6132,6,7,1
6132,6132,6133,7,0,-7
6133,6133,6134,0,7,7
6134,6134,6135,7,1,-6
6135,6135,6136,1,8,7
6136,6136,6137,8,0,-8
6137,6137,6138,0,2,2
6138,6138,6139,2,6,4
6139,6139,6140,6,7,1
6140,6140,6141,7,7,0
6141,6141,6142,7,1,-6
6142,6142,6143,1,2,1
6143,6143,6144,2,2,0
6144,6144,6145,2,9,7
6145,6145,6146,9,0,-9
6146,6146,6147,0,7,7
6147,6147,6148,7,3,-4
6148,6148,6149,3,9,6
6149,6149,6150,9,6,-3
6150,6150,6151,6,5,-1
6151,6151,6152,5,8,3
6152,6152,6153,8,8,0
6153,6153,6154,8,4,-4
6154,6154,6155,4,9,5
6155,6155,6156,9,9,0
6156,6156,6157,9,6,-3
6157,6157,6158,6,8,2
6158,6158,6159,8,6,-2
6159,6159,6160,6,4,-2
6160,6160,6161,4,2,-2
6161,6161,6162,2,9,7
6162,6162,6163,9,8,-1
6163,6163,6164,8,9,1
6164,6164,6165,9,1,-8
6165,6165,6166,1,9,8
6166,6166,6167,9,7,-2
6167,6167,6168,7,2,-5
6168,6168,6169,2,5,3
6169,6169,6170,5,3,-2
6170,6170,6171,3,5,2
6171,6171,6172,5,2,-3
6172,6172,6173,2,7,5
6173,6173,6174,7,9,2
6174,6174,6175,9,3,-6
6175,6175,6176,3,7,4
6176,6176,6177,7,5,-2
6177,6177,6178,5,6,1
6178,6178,6179,6,0,-6
6179,6179,6180,0,5,5
6180,6180,6181,5,1,-4
6181,6181,6182,1,3,2
6182,6182,6183,3,1,-2
6183,6183,6184,1,4,3
6184,6184,6185,4,3,-1
6185,6185,6186,3,1,-2
6186,6186,6187,1,8,7
6187,6187,6188,8,5,-3
6188,6188,6189,5,4,-1
6189,6189,6190,4,2,-2
6190,6190,6191,2,9,7
6191,6191,6192,9,1,-8
6192,6192,6193,1,4,3
6193,6193,6194,4,6,2
6194,6194,6195,6,5,-1
6195,6195,6196,5,8,3
6196,6196,6197,8,1,-7
6197,6197,6198,1,5,4
6198,6198,6199,5,8,3
6199,6199,6200,8,5,-3
6200,6200,6201,5,6,1
6201,6201,6202,6,7,1
6202,6202,6203,7,8,1
6203,6203,6204,8,2,-6
6204,6204,6205,2,9,7
6205,6205,6206,9,1,-8
6206,6206,6207,1,0,-1
6207,6207,6208,0,1,1
6208,6208,6209,1,1,0
6209,6209,6210,1,4,3
6210,6210,6211,4,2,-2
6211,6211,6212,2,2,0
6212,6212,6213,2,3,1
6213,6213,6214,3,8,5
6214,6214,6215,8,4,-4
6215,6215,6216,4,3,-1
6216,6216,6217,3,5,2
6217,6217,6218,5,4,-1
6218,6218,6219,4,6,2
6219,6219,6220,6,4,-2
6220,6220,6221,4,7,3
6221,6221,6222,7,2,-5
6222,6222,6223,2,8,6
6223,6223,6224,8,7,-1
6224,6224,6225,7,9,2
6225,6225,6226,9,1,-8
6226,6226,6227,1,0,-1
6227,6227,6228,0,0,0
6228,6228,6229,0,1,1
6229,6229,6230,1,3,2
6230,6230,6231,3,2,-1
6231,6231,6232,2,1,-1
6232,6232,6233,1,3,2
6233,6233,6234,3,9,6
6234,6234,6235,9,4,-5
6235,6235,6236,4,6,2
6236,6236,6237,6,5,-1
6237,6237,6238,5,9,4
6238,6238,6239,9,6,-3
6239,6239,6240,6,8,2
6240,6240,6241,8,7,-1
6241,6241,6242,7,8,1
6242,6242,6243,8,8,0
6243,6243,6244,8,1,-7
6244,6244,6245,1,0,-1
6245,6245,6246,0,6,6
6246,6246,6247,6,1,-5
6247,6247,6248,1,7,6
6248,6248,6249,7,2,-5
6249,6249,6250,2,7,5
6250,6250,6251,7,3,-4
6251,6251,6252,3,2,-1
6252,6252,6253,2,4,2
6253,6253,6254,4,1,-3
6254,6254,6255,1,5,4
6255,6255,6256,5,4,-1
6256,6256,6257,4,6,2
6257,6257,6258,6,4,-2
6258,6258,6259,4,7,3
6259,6259,6260,7,4,-3
6260,6260,6261,4,8,4
6261,6261,6262,8,1,-7
6262,6262,6263,1,9,8
6263,6263,6264,9,5,-4
6264,6264,6265,5,6,1
6265,6265,6266,6,6,0
6266,6266,6267,6,6,0
6267,6267,6268,6,4,-2
6268,6268,6269,4,3,-1
6269,6269,6270,3,2,-1
6270,6270,6271,2,4,2
6271,6271,6272,4,9,5
6272,6272,6273,9,2,-7
6273,6273,6274,2,5,3
6274,6274,6275,5,8,3
6275,6275,6276,8,5,-3
6276,6276,6277,5,1,-4
6277,6277,6278,1,7,6
6278,6278,6279,7,0,-7
6279,6279,6280,0,7,7
6280,6280,6281,7,6,-1
6281,6281,6282,6,3,-3
6282,6282,6283,3,4,1
6283,6283,6284,4,8,4
6284,6284,6285,8,9,1
6285,6285,6286,9,3,-6
6286,6286,6287,3,7,4
6287,6287,6288,7,8,1
6288,6288,6289,8,2,-6
6289,6289,6290,2,5,3
6290,6290,6291,5,3,-2
6291,6291,6292,3,0,-3
6292,6292,6293,0,3,3
6293,6293,6294,3,9,6
6294,6294,6295,9,9,0
6295,6295,6296,9,0,-9
6296,6296,6297,0,3,3
6297,6297,6298,3,3,0
6298,6298,6299,3,3,0
6299,6299,6300,3,5,2
6300,6300,6301,5,9,4
6301,6301,6302,9,0,-9
6302,6302,6303,0,1,1
6303,6303,6304,1,7,6
6304,6304,6305,7,5,-2
6305,6305,6306,5,9,4
6306,6306,6307,9,2,-7
6307,6307,6308,2,4,2
6308,6308,6309,4,3,-1
6309,6309,6310,3,9,6
6310,6310,6311,9,1,-8
6311,6311,6312,1,4,3
6312,6312,6313,4,6,2
6313,6313,6314,6,4,-2
6314,6314,6315,4,7,3
6315,6315,6316,7,0,-7
6316,6316,6317,0,3,3
6317,6317,6318,3,1,-2
6318,6318,6319,1,7,6
6319,6319,6320,7,0,-7
6320,6320,6321,0,8,8
6321,6321,6322,8,8,0
6322,6322,6323,8,4,-4
6323,6323,6324,4,5,1
6324,6324,6325,5,0,-5
6325,6325,6326,0,0,0
6326,6326,6327,0,2,2
6327,6327,6328,2,1,-1
6328,6328,6329,1,4,3
6329,6329,6330,4,0,-4
6330,6330,6331,0,0,0
6331,6331,6332,0,0,0
6332,6332,6333,0,7,7
6333,6333,6334,7,9,2
6334,6334,6335,9,8,-1
6335,6335,6336,8,4,-4
6336,6336,6337,4,0,-4
6337,6337,6338,0,6,6
6338,6338,6339,6,7,1
6339,6339,6340,7,3,-4
6340,6340,6341,3,0,-3
6341,6341,6342,0,3,3
6342,6342,6343,3,6,3
6343,6343,6344,6,2,-4
6344,6344,6345,2,9,7
6345,6345,6346,9,5,-4
6346,6346,6347,5,3,-2
6347,6347,6348,3,2,-1
6348,6348,6349,2,2,0
6349,6349,6350,2,3,1
6350,6350,6351,3,4,1
6351,6351,6352,4,5,1
6352,6352,6353,5,8,3
6353,6353,6354,8,8,0
6354,6354,6355,8,6,-2
6355,6355,6356,6,1,-5
6356,6356,6357,1,0,-1
6357,6357,6358,0,7,7
6358,6358,6359,7,5,-2
6359,6359,6360,5,2,-3
6360,6360,6361,2,7,5
6361,6361,6362,7,3,-4
6362,6362,6363,3,5,2
6363,6363,6364,5,8,3
6364,6364,6365,8,1,-7
6365,6365,6366,1,1,0
6366,6366,6367,1,0,-1
6367,6367,6368,0,9,9
6368,6368,6369,9,8,-1
6369,6369,6370,8,5,-3
6370,6370,6371,5,1,-4
6371,6371,6372,1,1,0
6372,6372,6373,1,6,5
6373,6373,6374,6,5,-1
6374,6374,6375,5,7,2
6375,6375,6376,7,9,2
6376,6376,6377,9,2,-7
6377,6377,6378,2,7,5
6378,6378,6379,7,9,2
6379,6379,6380,9,1,-8
6380,6380,6381,1,7,6
6381,6381,6382,7,9,2
6382,6382,6383,9,9,0
6383,6383,6384,9,1,-8
6384,6384,6385,1,5,4
6385,6385,6386,5,2,-3
6386,6386,6387,2,6,4
6387,6387,6388,6,6,0
6388,6388,6389,6,5,-1
6389,6389,6390,5,8,3
6390,6390,6391,8,2,-6
6391,6391,6392,2,6,4
6392,6392,6393,6,6,0
6393,6393,6394,6,0,-6
6394,6394,6395,0,1,1
6395,6395,6396,1,6,5
6396,6396,6397,6,7,1
6397,6397,6398,7,3,-4
6398,6398,6399,3,5,2
6399,6399,6400,5,0,-5
6400,6400,6401,0,5,5
6401,6401,6402,5,6,1
6402,6402,6403,6,7,1
6403,6403,6404,7,8,1
6404,6404,6405,8,3,-5
6405,6405,6406,3,0,-3
6406,6406,6407,0,5,5
6407,6407,6408,5,1,-4
6408,6408,6409,1,0,-1
6409,6409,6410,0,3,3
6410,6410,6411,3,1,-2
6411,6411,6412,1,5,4
6412,6412,6413,5,1,-4
6413,6413,6414,1,2,1
6414,6414,6415,2,3,1
6415,6415,6416,3,3,0
6416,6416,6417,3,8,5
6417,6417,6418,8,5,-3
6418,6418,6419,5,1,-4
6419,6419,6420,1,3,2
6420,6420,6421,3,0,-3
6421,6421,6422,0,0,0
6422,6422,6423,0,1,1
6423,6423,6424,1,4,3
6424,6424,6425,4,2,-2
6425,6425,6426,2,5,3
6426,6426,6427,5,3,-2
6427,6427,6428,3,3,0
6428,6428,6429,3,4,1
6429,6429,6430,4,3,-1
6430,6430,6431,3,5,2
6431,6431,6432,5,7,2
6432,6432,6433,7,6,-1
6433,6433,6434,6,5,-1
6434,6434,6435,5,7,2
6435,6435,6436,7,1,-6
6436,6436,6437,1,8,7
6437,6437,6438,8,9,1
6438,6438,6439,9,9,0
6439,6439,6440,9,3,-6
6440,6440,6441,3,0,-3
6441,6441,6442,0,2,2
6442,6442,6443,2,1,-1
6443,6443,6444,1,0,-1
6444,6444,6445,0,2,2
6445,6445,6446,2,0,-2
6446,6446,6447,0,3,3
6447,6447,6448,3,4,1
6448,6448,6449,4,4,0
6449,6449,6450,4,3,-1
6450,6450,6451,3,5,2
6451,6451,6452,5,6,1
6452,6452,6453,6,6,0
6453,6453,6454,6,4,-2
6454,6454,6455,4,7,3
6455,6455,6456,7,6,-1
6456,6456,6457,6,8,2
6457,6457,6458,8,1,-7
6458,6458,6459,1,9,8
6459,6459,6460,9,9,0
6460,6460,6461,9,0,-9
6461,6461,6462,0,4,4
6462,6462,6463,4,1,-3
6463,6463,6464,1,6,5
6464,6464,6465,6,2,-4
6465,6465,6466,2,2,0
6466,6466,6467,2,3,1
6467,6467,6468,3,0,-3
6468,6468,6469,0,4,4
6469,6469,6470,4,8,4
6470,6470,6471,8,5,-3
6471,6471,6472,5,5,0
6472,6472,6473,5,6,1
6473,6473,6474,6,6,0
6474,6474,6475,6,7,1
6475,6475,6476,7,7,0
6476,6476,6477,7,8,1
6477,6477,6478,8,2,-6
6478,6478,6479,2,9,7
6479,6479,6480,9,2,-7
6480,6480,6481,2,7,5
6481,6481,6482,7,6,-1
6482,6482,6483,6,4,-2
6483,6483,6484,4,4,0
6484,6484,6485,4,7,3
6485,6485,6486,7,6,-1
6486,6486,6487,6,7,1
6487,6487,6488,7,1,-6
6488,6488,6489,1,3,2
6489,6489,6490,3,4,1
6490,6490,6491,4,9,5
6491,6491,6492,9,2,-7
6492,6492,6493,2,8,6
6493,6493,6494,8,2,-6
6494,6494,6495,2,8,6
6495,6495,6496,8,0,-8
6496,6496,6497,0,3,3
6497,6497,6498,3,8,5
6498,6498,6499,8,1,-7
6499,6499,6500,1,3,2
6500,6500,6501,3,5,2
6501,6501,6502,5,0,-5
6502,6502,6503,0,8,8
6503,6503,6504,8,5,-3
6504,6504,6505,5,2,-3
6505,6505,6506,2,8,6
6506,6506,6507,8,7,-1
6507,6507,6508,7,8,1
6508,6508,6509,8,6,-2
6509,6509,6510,6,7,1
6510,6510,6511,7,1,-6
6511,6511,6512,1,8,7
6512,6512,6513,8,5,-3
6513,6513,6514,5,9,4
6514,6514,6515,9,2,-7
6515,6515,6516,2,3,1
6516,6516,6517,3,6,3
6517,6517,6518,6,9,3
6518,6518,6519,9,4,-5
6519,6519,6520,4,9,5
6520,6520,6521,9,1,-8
6521,6521,6522,1,3,2
6522,6522,6523,3,8,5
6523,6523,6524,8,5,-3
6524,6524,6525,5,7,2
6525,6525,6526,7,6,-1
6526,6526,6527,6,5,-1
6527,6527,6528,5,7,2
6528,6528,6529,7,5,-2
6529,6529,6530,5,1,-4
6530,6530,6531,1,1,0
6531,6531,6532,1,4,3
6532,6532,6533,4,8,4
6533,6533,6534,8,8,0
6534,6534,6535,8,9,1
6535,6535,6536,9,4,-5
6536,6536,6537,4,1,-3
6537,6537,6538,1,0,-1
6538,6538,6539,0,3,3
6539,6539,6540,3,2,-1
6540,6540,6541,2,6,4
6541,6541,6542,6,9,3
6542,6542,6543,9,3,-6
6543,6543,6544,3,8,5
6544,6544,6545,8,3,-5
6545,6545,6546,3,4,1
6546,6546,6547,4,2,-2
6547,6547,6548,2,6,4
6548,6548,6549,6,2,-4
6549,6549,6550,2,7,5
6550,6550,6551,7,6,-1
6551,6551,6552,6,4,-2
6552,6552,6553,4,6,2
6553,6553,6554,6,1,-5
6554,6554,6555,1,5,4
6555,6555,6556,5,4,-1
6556,6556,6557,4,5,1
6557,6557,6558,5,1,-4
6558,6558,6559,1,3,2
6559,6559,6560,3,4,1
6560,6560,6561,4,3,-1
6561,6561,6562,3,6,3
6562,6562,6563,6,8,2
6563,6563,6564,8,9,1
6564,6564,6565,9,1,-8
6565,6565,6566,1,7,6
6566,6566,6567,7,6,-1
6567,6567,6568,6,1,-5
6568,6568,6569,1,5,4
6569,6569,6570,5,1,-4
6570,6570,6571,1,6,5
6571,6571,6572,6,6,0
6572,6572,6573,6,8,2
6573,6573,6574,8,6,-2
6574,6574,6575,6,1,-5
6575,6575,6576,1,3,2
6576,6576,6577,3,9,6
6577,6577,6578,9,6,-3
6578,6578,6579,6,7,1
6579,6579,6580,7,8,1
6580,6580,6581,8,6,-2
6581,6581,6582,6,8,2
6582,6582,6583,8,8,0
6583,6583,6584,8,3,-5
6584,6584,6585,3,3,0
6585,6585,6586,3,1,-2
6586,6586,6587,1,7,6
6587,6587,6588,7,9,2
6588,6588,6589,9,9,0
6589,6589,6590,9,7,-2
6590,6590,6591,7,0,-7
6591,6591,6592,0,3,3
6592,6592,6593,3,0,-3
6593,6593,6594,0,3,3
6594,6594,6595,3,3,0
6595,6595,6596,3,4,1
6596,6596,6597,4,7,3
6597,6597,6598,7,4,-3
6598,6598,6599,4,9,5
6599,6599,6600,9,7,-2
6600,6600,6601,7,3,-4
6601,6601,6602,3,6,3
6602,6602,6603,6,0,-6
6603,6603,6604,0,8,8
6604,6604,6605,8,2,-6
6605,6605,6606,2,8,6
6606,6606,6607,8,0,-8
6607,6607,6608,0,4,4
6608,6608,6609,4,1,-3
6609,6609,6610,1,5,4
6610,6610,6611,5,0,-5
6611,6611,6612,0,3,3
6612,6612,6613,3,1,-2
6613,6613,6614,1,0,-1
6614,6614,6615,0,0,0
6615,6615,6616,0,7,7
6616,6616,6617,7,1,-6
6617,6617,6618,1,8,7
6618,6618,6619,8,0,-8
6619,6619,6620,0,8,8
6620,6620,6621,8,4,-4
6621,6621,6622,4,8,4
6622,6622,6623,8,7,-1
6623,6623,6624,7,2,-5
6624,6624,6625,2,9,7
6625,6625,6626,9,2,-7
6626,6626,6627,2,2,0
6627,6627,6628,2,2,0
6628,6628,6629,2,0,-2
6629,6629,6630,0,0,0
6630,6630,6631,0,6,6
6631,6631,6632,6,3,-3
6632,6632,6633,3,2,-1
6633,6633,6634,2,9,7
6634,6634,6635,9,6,-3
6635,6635,6636,6,5,-1
6636,6636,6637,5,2,-3
6637,6637,6638,2,6,4
6638,6638,6639,6,2,-4
6639,6639,6640,2,1,-1
6640,6640,6641,1,9,8
6641,6641,6642,9,2,-7
6642,6642,6643,2,9,7
6643,6643,6644,9,5,-4
6644,6644,6645,5,0,-5
6645,6645,6646,0,5,5
6646,6646,6647,5,1,-4
6647,6647,6648,1,0,-1
6648,6648,6649,0,2,2
6649,6649,6650,2,7,5
6650,6650,6651,7,3,-4
6651,6651,6652,3,4,1
6652,6652,6653,4,4,0
6653,6653,6654,4,1,-3
6654,6654,6655,1,5,4
6655,6655,6656,5,4,-1
6656,6656,6657,4,6,2
6657,6657,6658,6,3,-3
6658,6658,6659,3,8,5
6659,6659,6660,8,5,-3
6660,6660,6661,5,9,4
6661,6661,6662,9,3,-6
6662,6662,6663,3,0,-3
6663,6663,6664,0,5,5
6664,6664,6665,5,1,-4
6665,6665,6666,1,7,6
6666,6666,6667,7,3,-4
6667,6667,6668,3,9,6
6668,6668,6669,9,4,-5
6669,6669,6670,4,6,2
6670,6670,6671,6,5,-1
6671,6671,6672,5,4,-1
6672,6672,6673,4,6,2
6673,6673,6674,6,4,-2
6674,6674,6675,4,7,3
6675,6675,6676,7,0,-7
6676,6676,6677,0,8,8
6677,6677,6678,8,1,-7
6678,6678,6679,1,9,8
6679,6679,6680,9,5,-4
6680,6680,6681,5,0,-5
6681,6681,6682,0,1,1
6682,6682,6683,1,1,0
6683,6683,6684,1,0,-1
6684,6684,6685,0,2,2
6685,6685,6686,2,7,5
6686,6686,6687,7,3,-4
6687,6687,6688,3,7,4
6688,6688,6689,7,4,-3
6689,6689,6690,4,6,2
6690,6690,6691,6,5,-1
6691,6691,6692,5,6,1
6692,6692,6693,6,6,0
6693,6693,6694,6,9,3
6694,6694,6695,9,7,-2
6695,6695,6696,7,7,0
6696,6696,6697,7,8,1
6697,6697,6698,8,1,-7
6698,6698,6699,1,9,8
6699,6699,6700,9,0,-9
6700,6700,6701,0,1,1
6701,6701,6702,1,1,0
6702,6702,6703,1,8,7
6703,6703,6704,8,0,-8
6704,6704,6705,0,6,6
6705,6705,6706,6,3,-3
6706,6706,6707,3,7,4
6707,6707,6708,7,0,-7
6708,6708,6709,0,1,1
6709,6709,6710,1,3,2
6710,6710,6711,3,3,0
6711,6711,6712,3,5,2
6712,6712,6713,5,7,2
6713,6713,6714,7,4,-3
6714,6714,6715,4,7,3
6715,6715,6716,7,4,-3
6716,6716,6717,4,9,5
6717,6717,6718,9,1,-8
6718,6718,6719,1,3,2
6719,6719,6720,3,6,3
6720,6720,6721,6,6,0
6721,6721,6722,6,7,1
6722,6722,6723,7,0,-7
6723,6723,6724,0,4,4
6724,6724,6725,4,2,-2
6725,6725,6726,2,6,4
6726,6726,6727,6,6,0
6727,6727,6728,6,8,2
6728,6728,6729,8,4,-4
6729,6729,6730,4,0,-4
6730,6730,6731,0,8,8
6731,6731,6732,8,6,-2
6732,6732,6733,6,4,-2
6733,6733,6734,4,9,5
6734,6734,6735,9,5,-4
6735,6735,6736,5,1,-4
6736,6736,6737,1,0,-1
6737,6737,6738,0,0,0
6738,6738,6739,0,3,3
6739,6739,6740,3,7,4
6740,6740,6741,7,9,2
6741,6741,6742,9,6,-3
6742,6742,6743,6,2,-4
6743,6743,6744,2,8,6
6744,6744,6745,8,1,-7
6745,6745,6746,1,8,7
6746,6746,6747,8,1,-7
6747,6747,6748,1,1,0
6748,6748,6749,1,5,4
6749,6749,6750,5,3,-2
6750,6750,6751,3,9,6
6751,6751,6752,9,7,-2
6752,6752,6753,7,4,-3
6753,6753,6754,4,3,-1
6754,6754,6755,3,2,-1
6755,6755,6756,2,7,5
6756,6756,6757,7,0,-7
6757,6757,6758,0,0,0
6758,6758,6759,0,4,4
6759,6759,6760,4,8,4
6760,6760,6761,8,4,-4
6761,6761,6762,4,3,-1
6762,6762,6763,3,0,-3
6763,6763,6764,0,2,2
6764,6764,6765,2,9,7
6765,6765,6766,9,3,-6
6766,6766,6767,3,6,3
6767,6767,6768,6,0,-6
6768,6768,6769,0,9,9
6769,6769,6770,9,7,-2
6770,6770,6771,7,2,-5
6771,6771,6772,2,5,3
6772,6772,6773,5,2,-3
6773,6773,6774,2,8,6
6774,6774,6775,8,1,-7
6775,6775,6776,1,5,4
6776,6776,6777,5,7,2
6777,6777,6778,7,4,-3
6778,6778,6779,4,9,5
6779,6779,6780,9,2,-7
6780,6780,6781,2,5,3
6781,6781,6782,5,5,0
6782,6782,6783,5,1,-4
6783,6783,6784,1,3,2
6784,6784,6785,3,1,-2
6785,6785,6786,1,5,4
6786,6786,6787,5,9,4
6787,6787,6788,9,8,-1
6788,6788,6789,8,6,-2
6789,6789,6790,6,9,3
6790,6790,6791,9,0,-9
6791,6791,6792,0,8,8
6792,6792,6793,8,1,-7
6793,6793,6794,1,4,3
6794,6794,6795,4,8,4
6795,6795,6796,8,6,-2
6796,6796,6797,6,4,-2
6797,6797,6798,4,4,0
6798,6798,6799,4,6,2
6799,6799,6800,6,6,0
6800,6800,6801,6,8,2
6801,6801,6802,8,0,-8
6802,6802,6803,0,8,8
6803,6803,6804,8,4,-4
6804,6804,6805,4,2,-2
6805,6805,6806,2,8,6
6806,6806,6807,8,6,-2
6807,6807,6808,6,8,2
6808,6808,6809,8,3,-5
6809,6809,6810,3,4,1
6810,6810,6811,4,2,-2
6811,6811,6812,2,4,2
6812,6812,6813,4,9,5
6813,6813,6814,9,8,-1
6814,6814,6815,8,2,-6
6815,6815,6816,2,8,6
6816,6816,6817,8,4,-4
6817,6817,6818,4,7,3
6818,6818,6819,7,0,-7
6819,6819,6820,0,9,9
6820,6820,6821,9,9,0
6821,6821,6822,9,1,-8
6822,6822,6823,1,0,-1
6823,6823,6824,0,7,7
6824,6824,6825,7,3,-4
6825,6825,6826,3,3,0
6826,6826,6827,3,3,0
6827,6827,6828,3,6,3
6828,6828,6829,6,5,-1
6829,6829,6830,5,5,0
6830,6830,6831,5,8,3
6831,6831,6832,8,0,-8
6832,6832,6833,0,4,4
6833,6833,6834,4,1,-3
6834,6834,6835,1,7,6
6835,6835,6836,7,5,-2
6836,6836,6837,5,6,1
6837,6837,6838,6,9,3
6838,6838,6839,9,2,-7
6839,6839,6840,2,5,3
6840,6840,6841,5,2,-3
6841,6841,6842,2,9,7
6842,6842,6843,9,7,-2
6843,6843,6844,7,3,-4
6844,6844,6845,3,7,4
6845,6845,6846,7,2,-5
6846,6846,6847,2,0,-2
6847,6847,6848,0,5,5
6848,6848,6849,5,5,0
6849,6849,6850,5,9,4
6850,6850,6851,9,1,-8
6851,6851,6852,1,5,4
6852,6852,6853,5,5,0
6853,6853,6854,5,6,1
6854,6854,6855,6,3,-3
6855,6855,6856,3,3,0
6856,6856,6857,3,0,-3
6857,6857,6858,0,3,3
6858,6858,6859,3,1,-2
6859,6859,6860,1,2,1
6860,6860,6861,2,2,0
6861,6861,6862,2,7,5
6862,6862,6863,7,3,-4
6863,6863,6864,3,1,-2
6864,6864,6865,1,4,3
6865,6865,6866,4,7,3
6866,6866,6867,7,5,-2
6867,6867,6868,5,5,0
6868,6868,6869,5,6,1
6869,6869,6870,6,1,-5
6870,6870,6871,1,7,6
6871,6871,6872,7,9,2
6872,6872,6873,9,8,-1
6873,6873,6874,8,6,-2
6874,6874,6875,6,0,-6
6875,6875,6876,0,6,6
6876,6876,6877,6,1,-5
6877,6877,6878,1,7,6
6878,6878,6879,7,4,-3
6879,6879,6880,4,1,-3
6880,6880,6881,1,7,6
6881,6881,6882,7,7,0
6882,6882,6883,7,0,-7
6883,6883,6884,0,5,5
6884,6884,6885,5,1,-4
6885,6885,6886,1,9,8
6886,6886,6887,9,4,-5
6887,6887,6888,4,5,1
6888,6888,6889,5,7,2
6889,6889,6890,7,4,-3
6890,6890,6891,4,8,4
6891,6891,6892,8,3,-5
6892,6892,6893,3,9,6
6893,6893,6894,9,3,-6
6894,6894,6895,3,6,3
6895,6895,6896,6,8,2
6896,6896,6897,8,8,0
6897,6897,6898,8,3,-5
6898,6898,6899,3,2,-1
6899,6899,6900,2,1,-1
6900,6900,6901,1,4,3
6901,6901,6902,4,7,3
6902,6902,6903,7,6,-1
6903,6903,6904,6,3,-3
6904,6904,6905,3,8,5
6905,6905,6906,8,3,-5
6906,6906,6907,3,6,3
6907,6907,6908,6,7,1
6908,6908,6909,7,6,-1
6909,6909,6910,6,2,-4
6910,6910,6911,2,7,5
6911,6911,6912,7,3,-4
6912,6912,6913,3,1,-2
6913,6913,6914,1,7,6
6914,6914,6915,7,7,0
6915,6915,6916,7,8,1
6916,6916,6917,8,0,-8
6917,6917,6918,0,9,9
6918,6918,6919,9,2,-7
6919,6919,6920,2,3,1
6920,6920,6921,3,2,-1
6921,6921,6922,2,9,7
6922,6922,6923,9,0,-9
6923,6923,6924,0,8,8
6924,6924,6925,8,1,-7
6925,6925,6926,1,1,0
6926,6926,6927,1,6,5
6927,6927,6928,6,0,-6
6928,6928,6929,0,5,5
6929,6929,6930,5,6,1
6930,6930,6931,6,1,-5
6931,6931,6932,1,7,6
6932,6932,6933,7,2,-5
6933,6933,6934,2,9,7
6934,6934,6935,9,0,-9
6935,6935,6936,0,5,5
6936,6936,6937,5,2,-3
6937,6937,6938,2,8,6
6938,6938,6939,8,3,-5
6939,6939,6940,3,8,5
6940,6940,6941,8,4,-4
6941,6941,6942,4,8,4
6942,6942,6943,8,8,0
6943,6943,6944,8,2,-6
6944,6944,6945,2,3,1
6945,6945,6946,3,1,-2
6946,6946,6947,1,7,6
6947,6947,6948,7,2,-5
6948,6948,6949,2,4,2
6949,6949,6950,4,9,5
6950,6950,6951,9,1,-8
6951,6951,6952,1,8,7
6952,6952,6953,8,7,-1
6953,6953,6954,7,6,-1
6954,6954,6955,6,4,-2
6955,6955,6956,4,7,3
6956,6956,6957,7,8,1
6957,6957,6958,8,0,-8
6958,6958,6959,0,3,3
6959,6959,6960,3,0,-3
6960,6960,6961,0,9,9
6961,6961,6962,9,8,-1
6962,6962,6963,8,6,-2
6963,6963,6964,6,9,3
6964,6964,6965,9,7,-2
6965,6965,6966,7,3,-4
6966,6966,6967,3,0,-3
6967,6967,6968,0,0,0
6968,6968,6969,0,9,9
6969,6969,6970,9,0,-9
6970,6970,6971,0,6,6
6971,6971,6972,6,0,-6
6972,6972,6973,0,0,0
6973,6973,6974,0,2,2
6974,6974,6975,2,6,4
6975,6975,6976,6,8,2
6976,6976,6977,8,1,-7
6977,6977,6978,1,5,4
6978,6978,6979,5,0,-5
6979,6979,6980,0,5,5
6980,6980,6981,5,5,0
6981,6981,6982,5,6,1
6982,6982,6983,6,5,-1
6983,6983,6984,5,5,0
6984,6984,6985,5,1,-4
6985,6985,6986,1,7,6
6986,6986,6987,7,0,-7
6987,6987,6988,0,5,5
6988,6988,6989,5,1,-4
6989,6989,6990,1,4,3
6990,6990,6991,4,0,-4
6991,6991,6992,0,2,2
6992,6992,6993,2,9,7
6993,6993,6994,9,8,-1
6994,6994,6995,8,4,-4
6995,6995,6996,4,4,0
6996,6996,6997,4,5,1
6997,6997,6998,5,1,-4
6998,6998,6999,1,9,8
6999,6999,7000,9,8,-1
7000,7000,7001,8,7,-1
7001,7001,7002,7,4,-3
7002,7002,7003,4,0,-4
7003,7003,7004,0,0,0
7004,7004,7005,0,2,2
7005,7005,7006,2,9,7
7006,7006,7007,9,1,-8
7007,7007,7008,1,6,5
7008,7008,7009,6,4,-2
7009,7009,7010,4,7,3
7010,7010,7011,7,4,-3
7011,7011,7012,4,0,-4
7012,7012,7013,0,9,9
7013,7013,7014,9,2,-7
7014,7014,7015,2,6,4
7015,7015,7016,6,9,3
7016,7016,7017,9,7,-2
7017,7017,7018,7,0,-7
7018,7018,7019,0,4,4
7019,7019,7020,4,1,-3
7020,7020,7021,1,8,7
7021,7021,7022,8,1,-7
7022,7022,7023,1,9,8
7023,7023,7024,9,5,-4
7024,7024,7025,5,0,-5
7025,7025,7026,0,8,8
7026,7026,7027,8,1,-7
7027,7027,7028,1,7,6
7028,7028,7029,7,2,-5
7029,7029,7030,2,3,1
7030,7030,7031,3,3,0
7031,7031,7032,3,5,2
7032,7032,7033,5,7,2
7033,7033,7034,7,8,1
7034,7034,7035,8,8,0
7035,7035,7036,8,4,-4
7036,7036,7037,4,0,-4
7037,7037,7038,0,0,0
7038,7038,7039,0,1,1
7039,7039,7040,1,1,0
7040,7040,7041,1,2,1
7041,7041,7042,2,8,6
7042,7042,7043,8,3,-5
7043,7043,7044,3,5,2
7044,7044,7045,5,4,-1
7045,7045,7046,4,3,-1
7046,7046,7047,3,5,2
7047,7047,7048,5,8,3
7048,7048,7049,8,6,-2
7049,7049,7050,6,0,-6
7050,7050,7051,0,8,8
7051,7051,7052,8,0,-8
7052,7052,7053,0,9,9
7053,7053,7054,9,7,-2
7054,7054,7055,7,0,-7
7055,7055,7056,0,9,9
7056,7056,7057,9,1,-8
7057,7057,7058,1,3,2
7058,7058,7059,3,7,4
7059,7059,7060,7,1,-6
7060,7060,7061,1,9,8
7061,7061,7062,9,0,-9
7062,7062,7063,0,6,6
7063,7063,7064,6,6,0
7064,7064,7065,6,3,-3
7065,7065,7066,3,0,-3
7066,7066,7067,0,3,3
7067,7067,7068,3,5,2
7068,7068,7069,5,9,4
7069,7069,7070,9,9,0
7070,7070,7071,9,9,0
7071,7071,7072,9,2,-7
7072,7072,7073,2,5,3
7073,7073,7074,5,1,-4
7074,7074,7075,1,1,0
7075,7075,7076,1,8,7
7076,7076,7077,8,4,-4
7077,7077,7078,4,1,-3
7078,7078,7079,1,2,1
7079,7079,7080,2,3,1
7080,7080,7081,3,5,2
7081,7081,7082,5,2,-3
7082,7082,7083,2,4,2
7083,7083,7084,4,1,-3
7084,7084,7085,1,7,6
7085,7085,7086,7,6,-1
7086,7086,7087,6,9,3
7087,7087,7088,9,2,-7
7088,7088,7089,2,1,-1
7089,7089,7090,1,4,3
7090,7090,7091,4,5,1
7091,7091,7092,5,7,2
7092,7092,7093,7,2,-5
7093,7093,7094,2,9,7
7094,7094,7095,9,6,-3
7095,7095,7096,6,6,0
7096,7096,7097,6,3,-3
7097,7097,7098,3,9,6
7098,7098,7099,9,7,-2
7099,7099,7100,7,4,-3
7100,7100,7101,4,8,4
7101,7101,7102,8,6,-2
7102,7102,7103,6,5,-1
7103,7103,7104,5,6,1
7104,7104,7105,6,1,-5
7105,7105,7106,1,3,2
7106,7106,7107,3,2,-1
7107,7107,7108,2,9,7
7108,7108,7109,9,6,-3
7109,7109,7110,6,9,3
7110,7110,7111,9,6,-3
7111,7111,7112,6,5,-1
7112,7112,7113,5,7,2
7113,7113,7114,7,5,-2
7114,7114,7115,5,8,3
7115,7115,7116,8,1,-7
7116,7116,7117,1,8,7
7117,7117,7118,8,9,1
7118,7118,7119,9,1,-8
7119,7119,7120,1,4,3
7120,7120,7121,4,8,4
7121,7121,7122,8,8,0
7122,7122,7123,8,3,-5
7123,7123,7124,3,4,1
7124,7124,7125,4,7,3
7125,7125,7126,7,6,-1
7126,7126,7127,6,0,-6
7127,7127,7128,0,0,0
7128,7128,7129,0,0,0
7129,7129,7130,0,0,0
7130,7130,7131,0,1,1
7131,7131,7132,1,3,2
7132,7132,7133,3,5,2
7133,7133,7134,5,3,-2
7134,7134,7135,3,0,-3
7135,7135,7136,0,8,8
7136,7136,7137,8,5,-3
7137,7137,7138,5,1,-4
7138,7138,7139,1,2,1
7139,7139,7140,2,2,0
7140,7140,7141,2,8,6
7141,7141,7142,8,8,0
7142,7142,7143,8,0,-8
7143,7143,7144,0,5,5
7144,7144,7145,5,4,-1
7145,7145,7146,4,2,-2
7146,7146,7147,2,3,1
7147,7147,7148,3,9,6
7148,7148,7149,9,1,-8
7149,7149,7150,1,3,2
7150,7150,7151,3,8,5
7151,7151,7152,8,4,-4
7152,7152,7153,4,2,-2
7153,7153,7154,2,5,3
7154,7154,7155,5,9,4
7155,7155,7156,9,3,-6
7156,7156,7157,3,9,6
7157,7157,7158,9,0,-9
7158,7158,7159,0,5,5
7159,7159,7160,5,1,-4
7160,7160,7161,1,2,1
7161,7161,7162,2,3,1
7162,7162,7163,3,6,3
7163,7163,7164,6,0,-6
7164,7164,7165,0,5,5
7165,7165,7166,5,4,-1
7166,7166,7167,4,7,3
7167,7167,7168,7,8,1
7168,7168,7169,8,1,-7
7169,7169,7170,1,2,1
7170,7170,7171,2,9,7
7171,7171,7172,9,5,-4
7172,7172,7173,5,7,2
7173,7173,7174,7,7,0
7174,7174,7175,7,1,-6
7175,7175,7176,1,1,0
7176,7176,7177,1,2,1
7177,7177,7178,2,4,2
7178,7178,7179,4,6,2
7179,7179,7180,6,9,3
7180,7180,7181,9,0,-9
7181,7181,7182,0,8,8
7182,7182,7183,8,0,-8
7183,7183,7184,0,8,8
7184,7184,7185,8,1,-7
7185,7185,7186,1,4,3
7186,7186,7187,4,2,-2
7187,7187,7188,2,1,-1
7188,7188,7189,1,3,2
7189,7189,7190,3,8,5
7190,7190,7191,8,4,-4
7191,7191,7192,4,3,-1
7192,7192,7193,3,5,2
7193,7193,7194,5,9,4
7194,7194,7195,9,6,-3
7195,7195,7196,6,2,-4
7196,7196,7197,2,7,5
7197,7197,7198,7,9,2
7198,7198,7199,9,8,-1
7199,7199,7200,8,9,1
7200,7200,7201,9,9,0
7201,7201,7202,9,6,-3
7202,7202,7203,6,0,-6
7203,7203,7204,0,4,4
7204,7204,7205,4,1,-3
7205,7205,7206,1,6,5
7206,7206,7207,6,2,-4
7207,7207,7208,2,9,7
7208,7208,7209,9,3,-6
7209,7209,7210,3,7,4
7210,7210,7211,7,4,-3
7211,7211,7212,4,6,2
7212,7212,7213,6,7,1
7213,7213,7214,7,3,-4
7214,7214,7215,3,8,5
7215,7215,7216,8,5,-3
7216,7216,7217,5,9,4
7217,7217,7218,9,8,-1
7218,7218,7219,8,0,-8
7219,7219,7220,0,6,6
7220,7220,7221,6,1,-5
7221,7221,7222,1,1,0
7222,7222,7223,1,2,1
7223,7223,7224,2,6,4
7224,7224,7225,6,3,-3
7225,7225,7226,3,7,4
7226,7226,7227,7,4,-3
7227,7227,7228,4,8,4
7228,7228,7229,8,7,-1
7229,7229,7230,7,6,-1
7230,7230,7231,6,8,2
7231,7231,7232,8,5,-3
7232,7232,7233,5,9,4
7233,7233,7234,9,1,-8
7234,7234,7235,1,5,4
7235,7235,7236,5,7,2
7236,7236,7237,7,1,-6
7237,7237,7238,1,5,4
7238,7238,7239,5,9,4
7239,7239,7240,9,1,-8
7240,7240,7241,1,9,8
7241,7241,7242,9,2,-7
7242,7242,7243,2,0,-2
7243,7243,7244,0,5,5
7244,7244,7245,5,9,4
7245,7245,7246,9,5,-4
7246,7246,7247,5,0,-5
7247,7247,7248,0,4,4
7248,7248,7249,4,5,1
7249,7249,7250,5,3,-2
7250,7250,7251,3,9,6
7251,7251,7252,9,9,0
7252,7252,7253,9,1,-8
7253,7253,7254,1,0,-1
7254,7254,7255,0,7,7
7255,7255,7256,7,9,2
7256,7256,7257,9,2,-7
7257,7257,7258,2,9,7
7258,7258,7259,9,2,-7
7259,7259,7260,2,5,3
7260,7260,7261,5,3,-2
7261,7261,7262,3,2,-1
7262,7262,7263,2,3,1
7263,7263,7264,3,9,6
7264,7264,7265,9,2,-7
7265,7265,7266,2,2,0
7266,7266,7267,2,0,-2
7267,7267,7268,0,6,6
7268,7268,7269,6,9,3
7269,7269,7270,9,5,-4
7270,7270,7271,5,0,-5
7271,7271,7272,0,0,0
7272,7272,7273,0,6,6
7273,7273,7274,6,9,3
7274,7274,7275,9,1,-8
7275,7275,7276,1,5,4
7276,7276,7277,5,7,2
7277,7277,7278,7,7,0
7278,7278,7279,7,5,-2
7279,7279,7280,5,4,-1
7280,7280,7281,4,0,-4
7281,7281,7282,0,4,4
7282,7282,7283,4,3,-1
7283,7283,7284,3,7,4
7284,7284,7285,7,4,-3
7285,7285,7286,4,0,-4
7286,7286,7287,0,7,7
7287,7287,7288,7,3,-4
7288,7288,7289,3,6,3
7289,7289,7290,6,8,2
7290,7290,7291,8,6,-2
7291,7291,7292,6,2,-4
7292,7292,7293,2,3,1
7293,7293,7294,3,6,3
7294,7294,7295,6,3,-3
7295,7295,7296,3,4,1
7296,7296,7297,4,8,4
7297,7297,7298,8,6,-2
7298,7298,7299,6,4,-2
7299,7299,7300,4,8,4
7300,7300,7301,8,7,-1
7301,7301,7302,7,5,-2
7302,7302,7303,5,1,-4
7303,7303,7304,1,7,6
7304,7304,7305,7,0,-7
7305,7305,7306,0,7,7
7306,7306,7307,7,8,1
7307,7307,7308,8,8,0
7308,7308,7309,8,7,-1
7309,7309,7310,7,9,2
7310,7310,7311,9,5,-4
7311,7311,7312,5,9,4
7312,7312,7313,9,2,-7
7313,7313,7314,2,7,5
7314,7314,7315,7,1,-6
7315,7315,7316,1,8,7
7316,7316,7317,8,1,-7
7317,7317,7318,1,0,-1
7318,7318,7319,0,4,4
7319,7319,7320,4,8,4
7320,7320,7321,8,5,-3
7321,7321,7322,5,3,-2
7322,7322,7323,3,5,2
7323,7323,7324,5,1,-4
7324,7324,7325,1,0,-1
7325,7325,7326,0,2,2
7326,7326,7327,2,4,2
7327,7327,7328,4,8,4
7328,7328,7329,8,8,0
7329,7329,7330,8,1,-7
7330,7330,7331,1,7,6
7331,7331,7332,7,3,-4
7332,7332,7333,3,4,1
7333,7333,7334,4,7,3
7334,7334,7335,7,9,2
7335,7335,7336,9,3,-6
7336,7336,7337,3,2,-1
7337,7337,7338,2,0,-2
7338,7338,7339,0,3,3
7339,7339,7340,3,7,4
7340,7340,7341,7,6,-1
7341,7341,7342,6,6,0
7342,7342,7343,6,4,-2
7343,7343,7344,4,2,-2
7344,7344,7345,2,1,-1
7345,7345,7346,1,5,4
7346,7346,7347,5,2,-3
7347,7347,7348,2,7,5
7348,7348,7349,7,1,-6
7349,7349,7350,1,4,3
7350,7350,7351,4,5,1
7351,7351,7352,5,7,2
7352,7352,7353,7,2,-5
7353,7353,7354,2,5,3
7354,7354,7355,5,0,-5
7355,7355,7356,0,8,8
7356,7356,7357,8,4,-4
7357,7357,7358,4,0,-4
7358,7358,7359,0,8,8
7359,7359,7360,8,2,-6
7360,7360,7361,2,6,4
7361,7361,7362,6,7,1
7362,7362,7363,7,1,-6
7363,7363,7364,1,0,-1
7364,7364,7365,0,9,9
7365,7365,7366,9,4,-5
7366,7366,7367,4,3,-1
7367,7367,7368,3,5,2
7368,7368,7369,5,2,-3
7369,7369,7370,2,2,0
7370,7370,7371,2,0,-2
7371,7371,7372,0,0,0
7372,7372,7373,0,0,0
7373,7373,7374,0,5,5
7374,7374,7375,5,2,-3
7375,7375,7376,2,8,6
7376,7376,7377,8,5,-3
7377,7377,7378,5,0,-5
7378,7378,7379,0,6,6
7379,7379,7380,6,7,1
7380,7380,7381,7,9,2
7381,7381,7382,9,5,-4
7382,7382,7383,5,3,-2
7383,7383,7384,3,7,4
7384,7384,7385,7,6,-1
7385,7385,7386,6,7,1
7386,7386,7387,7,3,-4
7387,7387,7388,3,7,4
7388,7388,7389,7,6,-1
7389,7389,7390,6,5,-1
7390,7390,7391,5,0,-5
7391,7391,7392,0,2,2
7392,7392,7393,2,1,-1
7393,7393,7394,1,2,1
7394,7394,7395,2,2,0
7395,7395,7396,2,3,1
7396,7396,7397,3,3,0
7397,7397,7398,3,6,3
7398,7398,7399,6,4,-2
7399,7399,7400,4,8,4
7400,7400,7401,8,6,-2
7401,7401,7402,6,1,-5
7402,7402,7403,1,7,6
7403,7403,7404,7,1,-6
7404,7404,7405,1,8,7
7405,7405,7406,8,1,-7
7406,7406,7407,1,9,8
7407,7407,7408,9,2,-7
7408,7408,7409,2,0,-2
7409,7409,7410,0,1,1
7410,7410,7411,1,1,0
7411,7411,7412,1,3,2
7412,7412,7413,3,2,-1
7413,7413,7414,2,2,0
7414,7414,7415,2,3,1
7415,7415,7416,3,9,6
7416,7416,7417,9,4,-5
7417,7417,7418,4,7,3
7418,7418,7419,7,5,-2
7419,7419,7420,5,7,2
7420,7420,7421,7,1,-6
7421,7421,7422,1,3,2
7422,7422,7423,3,7,4
7423,7423,7424,7,1,-6
7424,7424,7425,1,8,7
7425,7425,7426,8,4,-4
7426,7426,7427,4,0,-4
7427,7427,7428,0,2,2
7428,7428,7429,2,1,-1
7429,7429,7430,1,9,8
7430,7430,7431,9,2,-7
7431,7431,7432,2,2,0
7432,7432,7433,2,3,1
7433,7433,7434,3,6,3
7434,7434,7435,6,1,-5
7435,7435,7436,1,8,7
7436,7436,7437,8,7,-1
7437,7437,7438,7,7,0
7438,7438,7439,7,8,1
7439,7439,7440,8,1,-7
7440,7440,7441,1,8,7
7441,7441,7442,8,4,-4
7442,7442,7443,4,5,1
7443,7443,7444,5,5,0
7444,7444,7445,5,7,2
7445,7445,7446,7,7,0
7446,7446,7447,7,9,2
7447,7447,7448,9,5,-4
7448,7448,7449,5,5,0
7449,7449,7450,5,8,3
7450,7450,7451,8,0,-8
7451,7451,7452,0,6,6
7452,7452,7453,6,8,2
7453,7453,7454,8,1,-7
7454,7454,7455,1,3,2
7455,7455,7456,3,6,3
7456,7456,7457,6,5,-1
7457,7457,7458,5,0,-5
7458,7458,7459,0,4,4
7459,7459,7460,4,6,2
7460,7460,7461,6,8,2
7461,7461,7462,8,0,-8
7462,7462,7463,0,3,3
7463,7463,7464,3,4,1
7464,7464,7465,4,0,-4
7465,7465,7466,0,0,0
7466,7466,7467,0,2,2
7467,7467,7468,2,9,7
7468,7468,7469,9,1,-8
7469,7469,7470,1,7,6
7470,7470,7471,7,0,-7
7471,7471,7472,0,1,1
7472,7472,7473,1,2,1
7473,7473,7474,2,9,7
7474,7474,7475,9,5,-4
7475,7475,7476,5,2,-3
7476,7476,7477,2,8,6
7477,7477,7478,8,9,1
7478,7478,7479,9,8,-1
7479,7479,7480,8,5,-3
7480,7480,7481,5,5,0
7481,7481,7482,5,5,0
7482,7482,7483,5,3,-2
7483,7483,7484,3,2,-1
7484,7484,7485,2,0,-2
7485,7485,7486,0,2,2
7486,7486,7487,2,4,2
7487,7487,7488,4,8,4
7488,7488,7489,8,4,-4
7489,7489,7490,4,6,2
7490,7490,7491,6,1,-5
7491,7491,7492,1,9,8
7492,7492,7493,9,6,-3
7493,7493,7494,6,7,1
7494,7494,7495,7,1,-6
7495,7495,7496,1,1,0
7496,7496,7497,1,3,2
7497,7497,7498,3,5,2
7498,7498,7499,5,0,-5
7499,7499,7500,0,2,2
7500,7500,7501,2,3,1
7501,7501,7502,3,4,1
7502,7502,7503,4,6,2
7503,7503,7504,6,6,0
7504,7504,7505,6,9,3
7505,7505,7506,9,0,-9
7506,7506,7507,0,3,3
7507,7507,7508,3,8,5
7508,7508,7509,8,7,-1
7509,7509,7510,7,2,-5
7510,7510,7511,2,9,7
7511,7511,7512,9,8,-1
7512,7512,7513,8,7,-1
7513,7513,7514,7,8,1
7514,7514,7515,8,0,-8
7515,7515,7516,0,6,6
7516,7516,7517,6,4,-2
7517,7517,7518,4,9,5
7518,7518,7519,9,8,-1
7519,7519,7520,8,2,-6
7520,7520,7521,2,3,1
7521,7521,7522,3,6,3
7522,7522,7523,6,2,-4
7523,7523,7524,2,1,-1
7524,7524,7525,1,7,6
7525,7525,7526,7,4,-3
7526,7526,7527,4,7,3
7527,7527,7528,7,2,-5
7528,7528,7529,2,9,7
7529,7529,7530,9,7,-2
7530,7530,7531,7,5,-2
7531,7531,7532,5,1,-4
7532,7532,7533,1,1,0
7533,7533,7534,1,7,6
7534,7534,7535,7,5,-2
7535,7535,7536,5,1,-4
7536,7536,7537,1,2,1
7537,7537,7538,2,9,7
7538,7538,7539,9,8,-1
7539,7539,7540,8,8,0
7540,7540,7541,8,9,1
7541,7541,7542,9,1,-8
7542,7542,7543,1,6,5
7543,7543,7544,6,6,0
7544,7544,7545,6,9,3
7545,7545,7546,9,5,-4
7546,7546,7547,5,7,2
7547,7547,7548,7,0,-7
7548,7548,7549,0,6,6
7549,7549,7550,6,8,2
7550,7550,7551,8,4,-4
7551,7551,7552,4,0,-4
7552,7552,7553,0,1,1
7553,7553,7554,1,2,1
7554,7554,7555,2,2,0
7555,7555,7556,2,3,1
7556,7556,7557,3,0,-3
7557,7557,7558,0,1,1
7558,7558,7559,1,6,5
7559,7559,7560,6,4,-2
7560,7560,7561,4,1,-3
7561,7561,7562,1,6,5
7562,7562,7563,6,1,-5
7563,7563,7564,1,6,5
7564,7564,7565,6,7,1
7565,7565,7566,7,0,-7
7566,7566,7567,0,2,2
7567,7567,7568,2,7,5
7568,7568,7569,7,3,-4
7569,7569,7570,3,8,5
7570,7570,7571,8,6,-2
7571,7571,7572,6,1,-5
7572,7572,7573,1,4,3
7573,7573,7574,4,1,-3
7574,7574,7575,1,8,7
7575,7575,7576,8,2,-6
7576,7576,7577,2,6,4
7577,7577,7578,6,4,-2
7578,7578,7579,4,4,0
7579,7579,7580,4,6,2
7580,7580,7581,6,6,0
7581,7581,7582,6,3,-3
7582,7582,7583,3,5,2
7583,7583,7584,5,3,-2
7584,7584,7585,3,0,-3
7585,7585,7586,0,8,8
7586,7586,7587,8,2,-6
7587,7587,7588,2,1,-1
7588,7588,7589,1,0,-1
7589,7589,7590,0,3,3
7590,7590,7591,3,5,2
7591,7591,7592,5,5,0
7592,7592,7593,5,6,1
7593,7593,7594,6,2,-4
7594,7594,7595,2,5,3
7595,7595,7596,5,4,-1
7596,7596,7597,4,0,-4
7597,7597,7598,0,6,6
7598,7598,7599,6,1,-5
7599,7599,7600,1,3,2
7600,7600,7601,3,2,-1
7601,7601,7602,2,9,7
7602,7602,7603,9,1,-8
7603,7603,7604,1,8,7
7604,7604,7605,8,7,-1
7605,7605,7606,7,8,1
7606,7606,7607,8,8,0
7607,7607,7608,8,7,-1
7608,7608,7609,7,1,-6
7609,7609,7610,1,7,6
7610,7610,7611,7,4,-3
7611,7611,7612,4,2,-2
7612,7612,7613,2,3,1
7613,7613,7614,3,2,-1
7614,7614,7615,2,2,0
7615,7615,7616,2,7,5
7616,7616,7617,7,8,1
7617,7617,7618,8,3,-5
7618,7618,7619,3,2,-1
7619,7619,7620,2,9,7
7620,7620,7621,9,7,-2
7621,7621,7622,7,1,-6
7622,7622,7623,1,9,8
7623,7623,7624,9,2,-7
7624,7624,7625,2,3,1
7625,7625,7626,3,3,0
7626,7626,7627,3,9,6
7627,7627,7628,9,2,-7
7628,7628,7629,2,0,-2
7629,7629,7630,0,1,1
7630,7630,7631,1,1,0
7631,7631,7632,1,1,0
7632,7632,7633,1,2,1
7633,7633,7634,2,3,1
7634,7634,7635,3,3,0
7635,7635,7636,3,8,5
7636,7636,7637,8,4,-4
7637,7637,7638,4,8,4
7638,7638,7639,8,5,-3
7639,7639,7640,5,5,0
7640,7640,7641,5,6,1
7641,7641,7642,6,8,2
7642,7642,7643,8,7,-1
7643,7643,7644,7,7,0
7644,7644,7645,7,8,1
7645,7645,7646,8,2,-6
7646,7646,7647,2,9,7
7647,7647,7648,9,0,-9
7648,7648,7649,0,0,0
7649,7649,7650,0,1,1
7650,7650,7651,1,1,0
7651,7651,7652,1,4,3
7652,7652,7653,4,2,-2
7653,7653,7654,2,2,0
7654,7654,7655,2,3,1
7655,7655,7656,3,1,-2
7656,7656,7657,1,4,3
7657,7657,7658,4,1,-3
7658,7658,7659,1,5,4
7659,7659,7660,5,3,-2
7660,7660,7661,3,6,3
7661,7661,7662,6,6,0
7662,7662,7663,6,7,1
7663,7663,7664,7,0,-7
7664,7664,7665,0,8,8
7665,7665,7666,8,3,-5
7666,7666,7667,3,9,6
7667,7667,7668,9,1,-8
7668,7668,7669,1,0,-1
7669,7669,7670,0,5,5
7670,7670,7671,5,1,-4
7671,7671,7672,1,3,2
7672,7672,7673,3,2,-1
7673,7673,7674,2,8,6
7674,7674,7675,8,3,-5
7675,7675,7676,3,9,6
7676,7676,7677,9,4,-5
7677,7677,7678,4,3,-1
7678,7678,7679,3,7,4
7679,7679,7680,7,9,2
7680,7680,7681,9,8,-1
7681,7681,7682,8,8,0
7682,7682,7683,8,9,1
7683,7683,7684,9,6,-3
7684,7684,7685,6,0,-6
7685,7685,7686,0,7,7
7686,7686,7687,7,0,-7
7687,7687,7688,0,2,2
7688,7688,7689,2,1,-1
7689,7689,7690,1,9,8
7690,7690,7691,9,0,-9
7691,7691,7692,0,3,3
7692,7692,7693,3,1,-2
7693,7693,7694,1,7,6
7694,7694,7695,7,2,-5
7695,7695,7696,2,1,-1
7696,7696,7697,1,7,6
7697,7697,7698,7,3,-4
7698,7698,7699,3,5,2
7699,7699,7700,5,6,1
7700,7700,7701,6,3,-3
7701,7701,7702,3,9,6
7702,7702,7703,9,4,-5
7703,7703,7704,4,8,4
7704,7704,7705,8,4,-4
7705,7705,7706,4,2,-2
7706,7706,7707,2,0,-2
7707,7707,7708,0,0,0
7708,7708,7709,0,0,0
7709,7709,7710,0,0,0
7710,7710,7711,0,6,6
7711,7711,7712,6,8,2
7712,7712,7713,8,9,1
7713,7713,7714,9,9,0
7714,7714,7715,9,6,-3
7715,7715,7716,6,1,-5
7716,7716,7717,1,6,5
7717,7717,7718,6,6,0
7718,7718,7719,6,2,-4
7719,7719,7720,2,1,-1
7720,7720,7721,1,3,2
7721,7721,7722,3,4,1
7722,7722,7723,4,4,0
7723,7723,7724,4,6,2
7724,7724,7725,6,4,-2
7725,7725,7726,4,4,0
7726,7726,7727,4,9,5
7727,7727,7728,9,0,-9
7728,7728,7729,0,1,1
7729,7729,7730,1,7,6
7730,7730,7731,7,7,0
7731,7731,7732,7,2,-5
7732,7732,7733,2,9,7
7733,7733,7734,9,4,-5
7734,7734,7735,4,5,1
7735,7735,7736,5,2,-3
7736,7736,7737,2,7,5
7737,7737,7738,7,5,-2
7738,7738,7739,5,5,0
7739,7739,7740,5,5,0
7740,7740,7741,5,6,1
7741,7741,7742,6,9,3
7742,7742,7743,9,2,-7
7743,7743,7744,2,6,4
7744,7744,7745,6,3,-3
7745,7745,7746,3,1,-2
7746,7746,7747,1,1,0
7747,7747,7748,1,1,0
7748,7748,7749,1,4,3
7749,7749,7750,4,8,4
7750,7750,7751,8,4,-4
7751,7751,7752,4,1,-3
7752,7752,7753,1,0,-1
7753,7753,7754,0,7,7
7754,7754,7755,7,9,2
7755,7755,7756,9,9,0
7756,7756,7757,9,9,0
7757,7757,7758,9,2,-7
7758,7758,7759,2,6,4
7759,7759,7760,6,2,-4
7760,7760,7761,2,1,-1
7761,7761,7762,1,3,2
7762,7762,7763,3,8,5
7763,7763,7764,8,1,-7
7764,7764,7765,1,3,2
7765,7765,7766,3,3,0
7766,7766,7767,3,3,0
7767,7767,7768,3,8,5
7768,7768,7769,8,7,-1
7769,7769,7770,7,7,0
7770,7770,7771,7,3,-4
7771,7771,7772,3,2,-1
7772,7772,7773,2,9,7
7773,7773,7774,9,9,0
7774,7774,7775,9,8,-1
7775,7775,7776,8,2,-6
7776,7776,7777,2,8,6
7777,7777,7778,8,3,-5
7778,7778,7779,3,4,1
7779,7779,7780,4,2,-2
7780,7780,7781,2,7,5
7781,7781,7782,7,2,-5
7782,7782,7783,2,7,5
7783,7783,7784,7,3,-4
7784,7784,7785,3,6,3
7785,7785,7786,6,0,-6
7786,7786,7787,0,2,2
7787,7787,7788,2,1,-1
7788,7788,7789,1,1,0
7789,7789,7790,1,2,1
7790,7790,7791,2,9,7
7791,7791,7792,9,2,-7
7792,7792,7793,2,8,6
7793,7793,7794,8,3,-5
7794,7794,7795,3,7,4
7795,7795,7796,7,2,-5
7796,7796,7797,2,8,6
7797,7797,7798,8,9,1
7798,7798,7799,9,8,-1
7799,7799,7800,8,3,-5
7800,7800,7801,3,2,-1
7801,7801,7802,2,5,3
7802,7802,7803,5,3,-2
7803,7803,7804,3,4,1
7804,7804,7805,4,9,5
7805,7805,7806,9,1,-8
7806,7806,7807,1,0,-1
7807,7807,7808,0,7,7
7808,7808,7809,7,7,0
7809,7809,7810,7,8,1
7810,7810,7811,8,9,1
7811,7811,7812,9,9,0
7812,7812,7813,9,0,-9
7813,7813,7814,0,8,8
7814,7814,7815,8,6,-2
7815,7815,7816,6,0,-6
7816,7816,7817,0,4,4
7817,7817,7818,4,2,-2
7818,7818,7819,2,1,-1
7819,7819,7820,1,5,4
7820,7820,7821,5,1,-4
7821,7821,7822,1,9,8
7822,7822,7823,9,2,-7
7823,7823,7824,2,8,6
7824,7824,7825,8,8,0
7825,7825,7826,8,4,-4
7826,7826,7827,4,2,-2
7827,7827,7828,2,1,-1
7828,7828,7829,1,6,5
7829,7829,7830,6,0,-6
7830,7830,7831,0,1,1
7831,7831,7832,1,3,2
7832,7832,7833,3,5,2
7833,7833,7834,5,1,-4
7834,7834,7835,1,0,-1
7835,7835,7836,0,8,8
7836,7836,7837,8,1,-7
7837,7837,7838,1,1,0
7838,7838,7839,1,2,1
7839,7839,7840,2,5,3
7840,7840,7841,5,3,-2
7841,7841,7842,3,5,2
7842,7842,7843,5,4,-1
7843,7843,7844,4,8,4
7844,7844,7845,8,5,-3
7845,7845,7846,5,0,-5
7846,7846,7847,0,6,6
7847,7847,7848,6,5,-1
7848,7848,7849,5,7,2
7849,7849,7850,7,1,-6
7850,7850,7851,1,8,7
7851,7851,7852,8,7,-1
7852,7852,7853,7,9,2
7853,7853,7854,9,4,-5
7854,7854,7855,4,0,-4
7855,7855,7856,0,8,8
7856,7856,7857,8,1,-7
7857,7857,7858,1,0,-1
7858,7858,7859,0,2,2
7859,7859,7860,2,1,-1
7860,7860,7861,1,3,2
7861,7861,7862,3,3,0
7862,7862,7863,3,4,1
7863,7863,7864,4,4,0
7864,7864,7865,4,5,1
7865,7865,7866,5,7,2
7866,7866,7867,7,6,-1
7867,7867,7868,6,6,0
7868,7868,7869,6,7,1
7869,7869,7870,7,2,-5
7870,7870,7871,2,8,6
7871,7871,7872,8,8,0
7872,7872,7873,8,9,1
7873,7873,7874,9,0,-9
7874,7874,7875,0,0,0
7875,7875,7876,0,1,1
7876,7876,7877,1,1,0
7877,7877,7878,1,3,2
7878,7878,7879,3,2,-1
7879,7879,7880,2,6,4
7880,7880,7881,6,3,-3
7881,7881,7882,3,0,-3
7882,7882,7883,0,4,4
7883,7883,7884,4,5,1
7884,7884,7885,5,5,0
7885,7885,7886,5,9,4
7886,7886,7887,9,6,-3
7887,7887,7888,6,5,-1
7888,7888,7889,5,7,2
7889,7889,7890,7,9,2
7890,7890,7891,9,8,-1
7891,7891,7892,8,0,-8
7892,7892,7893,0,9,9
7893,7893,7894,9,0,-9
7894,7894,7895,0,2,2
7895,7895,7896,2,1,-1
7896,7896,7897,1,2,1
7897,7897,7898,2,1,-1
7898,7898,7899,1,7,6
7899,7899,7900,7,5,-2
7900,7900,7901,5,6,1
7901,7901,7902,6,5,-1
7902,7902,7903,5,4,-1
7903,7903,7904,4,9,5
7904,7904,7905,9,0,-9
7905,7905,7906,0,7,7
7906,7906,7907,7,5,-2
7907,7907,7908,5,8,3
7908,7908,7909,8,8,0
7909,7909,7910,8,1,-7
7910,7910,7911,1,0,-1
7911,7911,7912,0,1,1
7912,7912,7913,1,7,6
7913,7913,7914,7,4,-3
7914,7914,7915,4,3,-1
7915,7915,7916,3,2,-1
7916,7916,7917,2,5,3
7917,7917,7918,5,8,3
7918,7918,7919,8,4,-4
7919,7919,7920,4,2,-2
7920,7920,7921,2,1,-1
7921,7921,7922,1,9,8
7922,7922,7923,9,8,-1
7923,7923,7924,8,8,0
7924,7924,7925,8,0,-8
7925,7925,7926,0,6,6
7926,7926,7927,6,5,-1
7927,7927,7928,5,8,3
7928,7928,7929,8,2,-6
7929,7929,7930,2,0,-2
7930,7930,7931,0,7,7
7931,7931,7932,7,0,-7
7932,7932,7933,0,2,2
7933,7933,7934,2,0,-2
7934,7934,7935,0,3,3
7935,7935,7936,3,9,6
7936,7936,7937,9,6,-3
7937,7937,7938,6,1,-5
7938,7938,7939,1,2,1
7939,7939,7940,2,9,7
7940,7940,7941,9,1,-8
7941,7941,7942,1,2,1
7942,7942,7943,2,7,5
7943,7943,7944,7,0,-7
7944,7944,7945,0,7,7
7945,7945,7946,7,9,2
7946,7946,7947,9,9,0
7947,7947,7948,9,0,-9
7948,7948,7949,0,9,9
7949,7949,7950,9,7,-2
7950,7950,7951,7,1,-6
7951,7951,7952,1,9,8
7952,7952,7953,9,2,-7
7953,7953,7954,2,0,-2
7954,7954,7955,0,4,4
7955,7955,7956,4,8,4
7956,7956,7957,8,6,-2
7957,7957,7958,6,4,-2
7958,7958,7959,4,7,3
7959,7959,7960,7,2,-5
7960,7960,7961,2,7,5
7961,7961,7962,7,5,-2
7962,7962,7963,5,5,0
7963,7963,7964,5,5,0
7964,7964,7965,5,4,-1
7965,7965,7966,4,3,-1
7966,7966,7967,3,5,2
7967,7967,7968,5,6,1
7968,7968,7969,6,0,-6
7969,7969,7970,0,6,6
7970,7970,7971,6,1,-5
7971,7971,7972,1,6,5
7972,7972,7973,6,1,-5
7973,7973,7974,1,4,3
7974,7974,7975,4,9,5
7975,7975,7976,9,3,-6
7976,7976,7977,3,9,6
7977,7977,7978,9,0,-9
7978,7978,7979,0,8,8
7979,7979,7980,8,3,-5
7980,7980,7981,3,0,-3
7981,7981,7982,0,3,3
7982,7982,7983,3,2,-1
7983,7983,7984,2,4,2
7984,7984,7985,4,0,-4
7985,7985,7986,0,2,2
7986,7986,7987,2,3,1
7987,7987,7988,3,5,2
7988,7988,7989,5,5,0
7989,7989,7990,5,6,1
7990,7990,7991,6,6,0
7991,7991,7992,6,7,1
7992,7992,7993,7,1,-6
7993,7993,7994,1,7,6
7994,7994,7995,7,8,1
7995,7995,7996,8,1,-7
7996,7996,7997,1,6,5
7997,7997,7998,6,5,-1
7998,7998,7999,5,4,-1
7999,7999,8000,4,0,-4
8000,8000,8001,0,6,6
8001,8001,8002,6,2,-4
8002,8002,8003,2,0,-2
8003,8003,8004,0,6,6
8004,8004,8005,6,9,3
8005,8005,8006,9,4,-5
8006,8006,8007,4,2,-2
8007,8007,8008,2,8,6
8008,8008,8009,8,6,-2
8009,8009,8010,6,5,-1
8010,8010,8011,5,4,-1
8011,8011,8012,4,3,-1
8012,8012,8013,3,3,0
8013,8013,8014,3,3,0
8014,8014,8015,3,9,6
8015,8015,8016,9,0,-9
8016,8016,8017,0,3,3
8017,8017,8018,3,3,0
8018,8018,8019,3,0,-3
8019,8019,8020,0,7,7
8020,8020,8021,7,0,-7
8021,8021,8022,0,5,5
8022,8022,8023,5,5,0
8023,8023,8024,5,2,-3
8024,8024,8025,2,2,0
8025,8025,8026,2,4,2
8026,8026,8027,4,5,1
8027,8027,8028,5,0,-5
8028,8028,8029,0,8,8
8029,8029,8030,8,9,1
8030,8030,8031,9,8,-1
8031,8031,8032,8,1,-7
8032,8032,8033,1,8,7
8033,8033,8034,8,6,-2
8034,8034,8035,6,9,3
8035,8035,8036,9,9,0
8036,8036,8037,9,4,-5
8037,8037,8038,4,7,3
8038,8038,8039,7,3,-4
8039,8039,8040,3,1,-2
8040,8040,8041,1,4,3
8041,8041,8042,4,6,2
8042,8042,8043,6,2,-4
8043,8043,8044,2,7,5
8044,8044,8045,7,8,1
8045,8045,8046,8,0,-8
8046,8046,8047,0,8,8
8047,8047,8048,8,3,-5
8048,8048,8049,3,7,4
8049,8049,8050,7,0,-7
8050,8050,8051,0,1,1
8051,8051,8052,1,3,2
8052,8052,8053,3,1,-2
8053,8053,8054,1,3,2
8054,8054,8055,3,3,0
8055,8055,8056,3,5,2
8056,8056,8057,5,6,1
8057,8057,8058,6,2,-4
8058,8058,8059,2,9,7
8059,8059,8060,9,9,0
8060,8060,8061,9,4,-5
8061,8061,8062,4,5,1
8062,8062,8063,5,1,-4
8063,8063,8064,1,6,5
8064,8064,8065,6,3,-3
8065,8065,8066,3,9,6
8066,8066,8067,9,8,-1
8067,8067,8068,8,7,-1
8068,8068,8069,7,7,0
8069,8069,8070,7,1,-6
8070,8070,8071,1,6,5
8071,8071,8072,6,6,0
8072,8072,8073,6,9,3
8073,8073,8074,9,6,-3
8074,8074,8075,6,3,-3
8075,8075,8076,3,6,3
8076,8076,8077,6,3,-3
8077,8077,8078,3,2,-1
8078,8078,8079,2,7,5
8079,8079,8080,7,1,-6
8080,8080,8081,1,4,3
8081,8081,8082,4,2,-2
8082,8082,8083,2,1,-1
8083,8083,8084,1,7,6
8084,8084,8085,7,9,2
8085,8085,8086,9,4,-5
8086,8086,8087,4,1,-3
8087,8087,8088,1,0,-1
8088,8088,8089,0,0,0
8089,8089,8090,0,7,7
8090,8090,8091,7,6,-1
8091,8091,8092,6,1,-5
8092,8092,8093,1,0,-1
8093,8093,8094,0,3,3
8094,8094,8095,3,1,-2
8095,8095,8096,1,0,-1
8096,8096,8097,0,2,2
8097,8097,8098,2,0,-2
8098,8098,8099,0,3,3
8099,8099,8100,3,6,3
8100,8100,8101,6,4,-2
8101,8101,8102,4,2,-2
8102,8102,8103,2,5,3
8103,8103,8104,5,5,0
8104,8104,8105,5,6,1
8105,8105,8106,6,1,-5
8106,8106,8107,1,7,6
8107,8107,8108,7,0,-7
8108,8108,8109,0,8,8
8109,8109,8110,8,0,-8
8110,8110,8111,0,9,9
8111,8111,8112,9,1,-8
8112,8112,8113,1,0,-1
8113,8113,8114,0,7,7
8114,8114,8115,7,3,-4
8115,8115,8116,3,0,-3
8116,8116,8117,0,4,4
8117,8117,8118,4,8,4
8118,8118,8119,8,5,-3
8119,8119,8120,5,3,-2
8120,8120,8121,3,6,3
8121,8121,8122,6,3,-3
8122,8122,8123,3,7,4
8123,8123,8124,7,1,-6
8124,8124,8125,1,8,7
8125,8125,8126,8,5,-3
8126,8126,8127,5,9,4
8127,8127,8128,9,5,-4
8128,8128,8129,5,0,-5
8129,8129,8130,0,7,7
8130,8130,8131,7,1,-6
8131,8131,8132,1,8,7
8132,8132,8133,8,2,-6
8133,8133,8134,2,0,-2
8134,8134,8135,0,3,3
8135,8135,8136,3,8,5
8136,8136,8137,8,7,-1
8137,8137,8138,7,7,0
8138,8138,8139,7,8,1
8139,8139,8140,8,6,-2
8140,8140,8141,6,9,3
8141,8141,8142,9,7,-2
8142,8142,8143,7,7,0
8143,8143,8144,7,7,0
8144,8144,8145,7,6,-1
8145,8145,8146,6,6,0
8146,8146,8147,6,0,-6
8147,8147,8148,0,8,8
8148,8148,8149,8,6,-2
8149,8149,8150,6,6,0
8150,8150,8151,6,6,0
8151,8151,8152,6,2,-4
8152,8152,8153,2,6,4
8153,8153,8154,6,2,-4
8154,8154,8155,2,9,7
8155,8155,8156,9,1,-8
8156,8156,8157,1,0,-1
8157,8157,8158,0,0,0
8158,8158,8159,0,0,0
8159,8159,8160,0,1,1
8160,8160,8161,1,1,0
8161,8161,8162,1,1,0
8162,8162,8163,1,3,2
8163,8163,8164,3,3,0
8164,8164,8165,3,9,6
8165,8165,8166,9,1,-8
8166,8166,8167,1,7,6
8167,8167,8168,7,7,0
8168,8168,8169,7,3,-4
8169,8169,8170,3,7,4
8170,8170,8171,7,8,1
8171,8171,8172,8,0,-8
8172,8172,8173,0,5,5
8173,8173,8174,5,4,-1
8174,8174,8175,4,8,4
8175,8175,8176,8,1,-7
8176,8176,8177,1,1,0
8177,8177,8178,1,5,4
8178,8178,8179,5,4,-1
8179,8179,8180,4,1,-3
8180,8180,8181,1,8,7
8181,8181,8182,8,7,-1
8182,8182,8183,7,5,-2
8183,8183,8184,5,3,-2
8184,8184,8185,3,1,-2
8185,8185,8186,1,7,6
8186,8186,8187,7,0,-7
8187,8187,8188,0,3,3
8188,8188,8189,3,1,-2
8189,8189,8190,1,5,4
8190,8190,8191,5,6,1
8191,8191,8192,6,3,-3
8192,8192,8193,3,0,-3
8193,8193,8194,0,1,1
8194,8194,8195,1,3,2
8195,8195,8196,3,7,4
8196,8196,8197,7,8,1
8197,8197,8198,8,7,-1
8198,8198,8199,7,9,2
8199,8199,8200,9,3,-6
8200,8200,8201,3,2,-1
8201,8201,8202,2,2,0
8202,8202,8203,2,1,-1
8203,8203,8204,1,2,1
8204,8204,8205,2,7,5
8205,8205,8206,7,6,-1
8206,8206,8207,6,4,-2
8207,8207,8208,4,4,0
8208,8208,8209,4,5,1
8209,8209,8210,5,8,3
8210,8210,8211,8,2,-6
8211,8211,8212,2,2,0
8212,8212,8213,2,8,6
8213,8213,8214,8,7,-1
8214,8214,8215,7,4,-3
8215,8215,8216,4,9,5
8216,8216,8217,9,7,-2
8217,8217,8218,7,1,-6
8218,8218,8219,1,1,0
8219,8219,8220,1,9,8
8220,8220,8221,9,8,-1
8221,8221,8222,8,1,-7
8222,8222,8223,1,0,-1
8223,8223,8224,0,6,6
8224,8224,8225,6,6,0
8225,8225,8226,6,2,-4
8226,8226,8227,2,3,1
8227,8227,8228,3,3,0
8228,8228,8229,3,2,-1
8229,8229,8230,2,3,1
8230,8230,8231,3,9,6
8231,8231,8232,9,7,-2
8232,8232,8233,7,0,-7
8233,8233,8234,0,8,8
8234,8234,8235,8,4,-4
8235,8235,8236,4,3,-1
8236,8236,8237,3,7,4
8237,8237,8238,7,9,2
8238,8238,8239,9,4,-5
8239,8239,8240,4,4,0
8240,8240,8241,4,3,-1
8241,8241,8242,3,8,5
8242,8242,8243,8,4,-4
8243,8243,8244,4,9,5
8244,8244,8245,9,5,-4
8245,8245,8246,5,3,-2
8246,8246,8247,3,0,-3
8247,8247,8248,0,7,7
8248,8248,8249,7,0,-7
8249,8249,8250,0,0,0
8250,8250,8251,0,2,2
8251,8251,8252,2,5,3
8252,8252,8253,5,0,-5
8253,8253,8254,0,3,3
8254,8254,8255,3,1,-2
8255,8255,8256,1,7,6
8256,8256,8257,7,2,-5
8257,8257,8258,2,1,-1
8258,8258,8259,1,3,2
8259,8259,8260,3,5,2
8260,8260,8261,5,4,-1
8261,8261,8262,4,0,-4
8262,8262,8263,0,5,5
8263,8263,8264,5,3,-2
8264,8264,8265,3,6,3
8265,8265,8266,6,4,-2
8266,8266,8267,4,7,3
8267,8267,8268,7,7,0
8268,8268,8269,7,8,1
8269,8269,8270,8,4,-4
8270,8270,8271,4,9,5
8271,8271,8272,9,0,-9
8272,8272,8273,0,0,0
8273,8273,8274,0,0,0
8274,8274,8275,0,1,1
8275,8275,8276,1,9,8
8276,8276,8277,9,2,-7
8277,8277,8278,2,4,2
8278,8278,8279,4,3,-1
8279,8279,8280,3,7,4
8280,8280,8281,7,4,-3
8281,8281,8282,4,6,2
8282,8282,8283,6,7,1
8283,8283,8284,7,0,-7
8284,8284,8285,0,8,8
8285,8285,8286,8,7,-1
8286,8286,8287,7,9,2
8287,8287,8288,9,0,-9
8288,8288,8289,0,0,0
8289,8289,8290,0,6,6
8290,8290,8291,6,1,-5
8291,8291,8292,1,2,1
8292,8292,8293,2,2,0
8293,8293,8294,2,0,-2
8294,8294,8295,0,3,3
8295,8295,8296,3,1,-2
8296,8296,8297,1,7,6
8297,8297,8298,7,4,-3
8298,8298,8299,4,8,4
8299,8299,8300,8,8,0
8300,8300,8301,8,9,1
8301,8301,8302,9,7,-2
8302,8302,8303,7,8,1
8303,8303,8304,8,0,-8
8304,8304,8305,0,6,6
8305,8305,8306,6,8,2
8306,8306,8307,8,5,-3
8307,8307,8308,5,9,4
8308,8308,8309,9,0,-9
8309,8309,8310,0,8,8
8310,8310,8311,8,6,-2
8311,8311,8312,6,6,0
8312,8312,8313,6,8,2
8313,8313,8314,8,6,-2
8314,8314,8315,6,9,3
8315,8315,8316,9,9,0
8316,8316,8317,9,4,-5
8317,8317,8318,4,9,5
8318,8318,8319,9,1,-8
8319,8319,8320,1,5,4
8320,8320,8321,5,9,4
8321,8321,8322,9,9,0
8322,8322,8323,9,0,-9
8323,8323,8324,0,8,8
8324,8324,8325,8,4,-4
8325,8325,8326,4,6,2
8326,8326,8327,6,8,2
8327,8327,8328,8,6,-2
8328,8328,8329,6,9,3
8329,8329,8330,9,1,-8
8330,8330,8331,1,1,0
8331,8331,8332,1,1,0
8332,8332,8333,1,4,3
8333,8333,8334,4,2,-2
8334,8334,8335,2,0,-2
8335,8335,8336,0,6,6
8336,8336,8337,6,5,-1
8337,8337,8338,5,3,-2
8338,8338,8339,3,5,2
8339,8339,8340,5,8,3
8340,8340,8341,8,4,-4
8341,8341,8342,4,2,-2
8342,8342,8343,2,0,-2
8343,8343,8344,0,4,4
8344,8344,8345,4,7,3
8345,8345,8346,7,4,-3
8346,8346,8347,4,6,2
8347,8347,8348,6,1,-5
8348,8348,8349,1,0,-1
8349,8349,8350,0,3,3
8350,8350,8351,3,1,-2
8351,8351,8352,1,6,5
8352,8352,8353,6,7,1
8353,8353,8354,7,0,-7
8354,8354,8355,0,0,0
8355,8355,8356,0,9,9
8356,8356,8357,9,6,-3
8357,8357,8358,6,9,3
8358,8358,8359,9,8,-1
8359,8359,8360,8,3,-5
8360,8360,8361,3,7,4
8361,8361,8362,7,7,0
8362,8362,8363,7,9,2
8363,8363,8364,9,7,-2
8364,8364,8365,7,8,1
8365,8365,8366,8,8,0
8366,8366,8367,8,6,-2
8367,8367,8368,6,0,-6
8368,8368,8369,0,0,0
8369,8369,8370,0,4,4
8370,8370,8371,4,8,4
8371,8371,8372,8,2,-6
8372,8372,8373,2,1,-1
8373,8373,8374,1,2,1
8374,8374,8375,2,7,5
8375,8375,8376,7,6,-1
8376,8376,8377,6,7,1
8377,8377,8378,7,8,1
8378,8378,8379,8,1,-7
8379,8379,8380,1,4,3
8380,8380,8381,4,3,-1
8381,8381,8382,3,1,-2
8382,8382,8383,1,1,0
8383,8383,8384,1,6,5
8384,8384,8385,6,0,-6
8385,8385,8386,0,8,8
8386,8386,8387,8,0,-8
8387,8387,8388,0,1,1
8388,8388,8389,1,7,6
8389,8389,8390,7,2,-5
8390,8390,8391,2,8,6
8391,8391,8392,8,5,-3
8392,8392,8393,5,9,4
8393,8393,8394,9,1,-8
8394,8394,8395,1,3,2
8395,8395,8396,3,7,4
8396,8396,8397,7,8,1
8397,8397,8398,8,6,-2
8398,8398,8399,6,4,-2
8399,8399,8400,4,4,0
8400,8400,8401,4,7,3
8401,8401,8402,7,1,-6
8402,8402,8403,1,2,1
8403,8403,8404,2,9,7
8404,8404,8405,9,3,-6
8405,8405,8406,3,3,0
8406,8406,8407,3,6,3
8407,8407,8408,6,9,3
8408,8408,8409,9,9,0
8409,8409,8410,9,6,-3
8410,8410,8411,6,2,-4
8411,8411,8412,2,4,2
8412,8412,8413,4,2,-2
8413,8413,8414,2,5,3
8414,8414,8415,5,4,-1
8415,8415,8416,4,9,5
8416,8416,8417,9,6,-3
8417,8417,8418,6,1,-5
8418,8418,8419,1,5,4
8419,8419,8420,5,6,1
8420,8420,8421,6,5,-1
8421,8421,8422,5,1,-4
8422,8422,8423,1,1,0
8423,8423,8424,1,9,8
8424,8424,8425,9,3,-6
8425,8425,8426,3,5,2
8426,8426,8427,5,3,-2
8427,8427,8428,3,2,-1
8428,8428,8429,2,7,5
8429,8429,8430,7,1,-6
8430,8430,8431,1,8,7
8431,8431,8432,8,8,0
8432,8432,8433,8,2,-6
8433,8433,8434,2,5,3
8434,8434,8435,5,5,0
8435,8435,8436,5,7,2
8436,8436,8437,7,7,0
8437,8437,8438,7,4,-3
8438,8438,8439,4,9,5
8439,8439,8440,9,9,0
8440,8440,8441,9,8,-1
8441,8441,8442,8,9,1
8442,8442,8443,9,2,-7
8443,8443,8444,2,7,5
8444,8444,8445,7,1,-6
8445,8445,8446,1,2,1
8446,8446,8447,2,3,1
8447,8447,8448,3,9,6
8448,8448,8449,9,0,-9
8449,8449,8450,0,3,3
8450,8450,8451,3,1,-2
8451,8451,8452,1,1,0
8452,8452,8453,1,2,1
8453,8453,8454,2,6,4
8454,8454,8455,6,3,-3
8455,8455,8456,3,1,-2
8456,8456,8457,1,4,3
8457,8457,8458,4,4,0
8458,8458,8459,4,5,1
8459,8459,8460,5,2,-3
8460,8460,8461,2,6,4
8461,8461,8462,6,6,0
8462,8462,8463,6,7,1
8463,8463,8464,7,1,-6
8464,8464,8465,1,8,7
8465,8465,8466,8,4,-4
8466,8466,8467,4,9,5
8467,8467,8468,9,9,0
8468,8468,8469,9,0,-9
8469,8469,8470,0,2,2
8470,8470,8471,2,1,-1
8471,8471,8472,1,0,-1
8472,8472,8473,0,2,2
8473,8473,8474,2,2,0
8474,8474,8475,2,3,1
8475,8475,8476,3,7,4
8476,8476,8477,7,4,-3
8477,8477,8478,4,6,2
8478,8478,8479,6,5,-1
8479,8479,8480,5,2,-3
8480,8480,8481,2,6,4
8481,8481,8482,6,8,2
8482,8482,8483,8,7,-1
8483,8483,8484,7,9,2
8484,8484,8485,9,8,-1
8485,8485,8486,8,1,-7
8486,8486,8487,1,9,8
8487,8487,8488,9,6,-3
8488,8488,8489,6,0,-6
8489,8489,8490,0,2,2
8490,8490,8491,2,1,-1
8491,8491,8492,1,9,8
8492,8492,8493,9,2,-7
8493,8493,8494,2,3,1
8494,8494,8495,3,4,1
8495,8495,8496,4,8,4
8496,8496,8497,8,6,-2
8497,8497,8498,6,3,-3
8498,8498,8499,3,7,4
8499,8499,8500,7,6,-1
8500,8500,8501,6,8,2
8501,8501,8502,8,7,-1
8502,8502,8503,7,9,2
8503,8503,8504,9,5,-4
8504,8504,8505,5,3,-2
8505,8505,8506,3,1,-2
8506,8506,8507,1,8,7
8507,8507,8508,8,4,-4
8508,8508,8509,4,0,-4
8509,8509,8510,0,9,9
8510,8510,8511,9,7,-2
8511,8511,8512,7,1,-6
8512,8512,8513,1,1,0
8513,8513,8514,1,9,8
8514,8514,8515,9,0,-9
8515,8515,8516,0,7,7
8516,8516,8517,7,7,0
8517,8517,8518,7,9,2
8518,8518,8519,9,5,-4
8519,8519,8520,5,8,3
8520,8520,8521,8,5,-3
8521,8521,8522,5,8,3
8522,8522,8523,8,6,-2
8523,8523,8524,6,3,-3
8524,8524,8525,3,9,6
8525,8525,8526,9,6,-3
8526,8526,8527,6,0,-6
8527,8527,8528,0,3,3
8528,8528,8529,3,1,-2
8529,8529,8530,1,1,0
8530,8530,8531,1,0,-1
8531,8531,8532,0,6,6
8532,8532,8533,6,0,-6
8533,8533,8534,0,4,4
8534,8534,8535,4,8,4
8535,8535,8536,8,8,0
8536,8536,8537,8,3,-5
8537,8537,8538,3,1,-2
8538,8538,8539,1,4,3
8539,8539,8540,4,0,-4
8540,8540,8541,0,3,3
8541,8541,8542,3,1,-2
8542,8542,8543,1,1,0
8543,8543,8544,1,3,2
8544,8544,8545,3,0,-3
8545,8545,8546,0,6,6
8546,8546,8547,6,9,3
8547,8547,8548,9,5,-4
8548,8548,8549,5,5,0
8549,8549,8550,5,1,-4
8550,8550,8551,1,3,2
8551,8551,8552,3,2,-1
8552,8552,8553,2,4,2
8553,8553,8554,4,3,-1
8554,8554,8555,3,9,6
8555,8555,8556,9,7,-2
8556,8556,8557,7,3,-4
8557,8557,8558,3,9,6
8558,8558,8559,9,7,-2
8559,8559,8560,7,4,-3
8560,8560,8561,4,6,2
8561,8561,8562,6,7,1
8562,8562,8563,7,9,2
8563,8563,8564,9,2,-7
8564,8564,8565,2,2,0
8565,8565,8566,2,7,5
8566,8566,8567,7,4,-3
8567,8567,8568,4,3,-1
8568,8568,8569,3,5,2
8569,8569,8570,5,4,-1
8570,8570,8571,4,7,3
8571,8571,8572,7,7,0
8572,8572,8573,7,2,-5
8573,8573,8574,2,1,-1
8574,8574,8575,1,1,0
8575,8575,8576,1,7,6
8576,8576,8577,7,6,-1
8577,8577,8578,6,1,-5
8578,8578,8579,1,4,3
8579,8579,8580,4,4,0
8580,8580,8581,4,9,5
8581,8581,8582,9,2,-7
8582,8582,8583,2,4,2
8583,8583,8584,4,8,4
8584,8584,8585,8,9,1
8585,8585,8586,9,9,0
8586,8586,8587,9,4,-5
8587,8587,8588,4,1,-3
8588,8588,8589,1,1,0
8589,8589,8590,1,6,5
8590,8590,8591,6,2,-4
8591,8591,8592,2,9,7
8592,8592,8593,9,2,-7
8593,8593,8594,2,7,5
8594,8594,8595,7,1,-6
8595,8595,8596,1,7,6
8596,8596,8597,7,3,-4
8597,8597,8598,3,2,-1
8598,8598,8599,2,2,0
8599,8599,8600,2,4,2
8600,8600,8601,4,9,5
8601,8601,8602,9,1,-8
8602,8602,8603,1,4,3
8603,8603,8604,4,7,3
8604,8604,8605,7,3,-4
8605,8605,8606,3,3,0
8606,8606,8607,3,8,5
8607,8607,8608,8,9,1
8608,8608,8609,9,2,-7
8609,8609,8610,2,1,-1
8610,8610,8611,1,2,1
8611,8611,8612,2,0,-2
8612,8612,8613,0,2,2
8613,8613,8614,2,2,0
8614,8614,8615,2,1,-1
8615,8615,8616,1,7,6
8616,8616,8617,7,2,-5
8617,8617,8618,2,8,6
8618,8618,8619,8,8,0
8619,8619,8620,8,9,1
8620,8620,8621,9,6,-3
8621,8621,8622,6,4,-2
8622,8622,8623,4,5,1
8623,8623,8624,5,5,0
8624,8624,8625,5,1,-4
8625,8625,8626,1,9,8
8626,8626,8627,9,6,-3
8627,8627,8628,6,6,0
8628,8628,8629,6,7,1
8629,8629,8630,7,9,2
8630,8630,8631,9,2,-7
8631,8631,8632,2,2,0
8632,8632,8633,2,1,-1
8633,8633,8634,1,4,3
8634,8634,8635,4,3,-1
8635,8635,8636,3,6,3
8636,8636,8637,6,7,1
8637,8637,8638,7,6,-1
8638,8638,8639,6,5,-1
8639,8639,8640,5,2,-3
8640,8640,8641,2,9,7
8641,8641,8642,9,5,-4
8642,8642,8643,5,3,-2
8643,8643,8644,3,4,1
8644,8644,8645,4,8,4
8645,8645,8646,8,5,-3
8646,8646,8647,5,7,2
8647,8647,8648,7,1,-6
8648,8648,8649,1,5,4
8649,8649,8650,5,4,-1
8650,8650,8651,4,7,3
8651,8651,8652,7,1,-6
8652,8652,8653,1,0,-1
8653,8653,8654,0,9,9
8654,8654,8655,9,7,-2
8655,8655,8656,7,5,-2
8656,8656,8657,5,4,-1
8657,8657,8658,4,6,2
8658,8658,8659,6,8,2
8659,8659,8660,8,1,-7
8660,8660,8661,1,8,7
8661,8661,8662,8,8,0
8662,8662,8663,8,3,-5
8663,8663,8664,3,1,-2
8664,8664,8665,1,7,6
8665,8665,8666,7,8,1
8666,8666,8667,8,6,-2
8667,8667,8668,6,5,-1
8668,8668,8669,5,9,4
8669,8669,8670,9,2,-7
8670,8670,8671,2,9,7
8671,8671,8672,9,3,-6
8672,8672,8673,3,4,1
8673,8673,8674,4,9,5
8674,8674,8675,9,8,-1
8675,8675,8676,8,5,-3
8676,8676,8677,5,4,-1
8677,8677,8678,4,1,-3
8678,8678,8679,1,1,0
8679,8679,8680,1,8,7
8680,8680,8681,8,0,-8
8681,8681,8682,0,0,0
8682,8682,8683,0,6,6
8683,8683,8684,6,3,-3
8684,8684,8685,3,6,3
8685,8685,8686,6,8,2
8686,8686,8687,8,0,-8
8687,8687,8688,0,6,6
8688,8688,8689,6,1,-5
8689,8689,8690,1,8,7
8690,8690,8691,8,2,-6
8691,8691,8692,2,6,4
8692,8692,8693,6,3,-3
8693,8693,8694,3,8,5
8694,8694,8695,8,4,-4
8695,8695,8696,4,4,0
8696,8696,8697,4,6,2
8697,8697,8698,6,7,1
8698,8698,8699,7,7,0
8699,8699,8700,7,3,-4
8700,8700,8701,3,8,5
8701,8701,8702,8,9,1
8702,8702,8703,9,0,-9
8703,8703,8704,0,1,1
8704,8704,8705,1,1,0
8705,8705,8706,1,4,3
8706,8706,8707,4,2,-2
8707,8707,8708,2,3,1
8708,8708,8709,3,3,0
8709,8709,8710,3,3,0
8710,8710,8711,3,4,1
8711,8711,8712,4,5,1
8712,8712,8713,5,5,0
8713,8713,8714,5,9,4
8714,8714,8715,9,6,-3
8715,8715,8716,6,3,-3
8716,8716,8717,3,7,4
8717,8717,8718,7,7,0
8718,8718,8719,7,8,1
8719,8719,8720,8,6,-2
8720,8720,8721,6,9,3
8721,8721,8722,9,8,-1
8722,8722,8723,8,0,-8
8723,8723,8724,0,0,0
8724,8724,8725,0,1,1
8725,8725,8726,1,6,5
8726,8726,8727,6,2,-4
8727,8727,8728,2,5,3
8728,8728,8729,5,3,-2
8729,8729,8730,3,8,5
8730,8730,8731,8,5,-3
8731,8731,8732,5,8,3
8732,8732,8733,8,6,-2
8733,8733,8734,6,5,-1
8734,8734,8735,5,7,2
8735,8735,8736,7,9,2
8736,8736,8737,9,4,-5
8737,8737,8738,4,1,-3
8738,8738,8739,1,0,-1
8739,8739,8740,0,2,2
8740,8740,8741,2,7,5
8741,8741,8742,7,2,-5
8742,8742,8743,2,2,0
8743,8743,8744,2,5,3
8744,8744,8745,5,9,4
8745,8745,8746,9,8,-1
8746,8746,8747,8,4,-4
8747,8747,8748,4,5,1
8748,8748,8749,5,2,-3
8749,8749,8750,2,9,7
8750,8750,8751,9,9,0
8751,8751,8752,9,2,-7
8752,8752,8753,2,8,6
8753,8753,8754,8,0,-8
8754,8754,8755,0,4,4
8755,8755,8756,4,3,-1
8756,8756,8757,3,5,2
8757,8757,8758,5,7,2
8758,8758,8759,7,8,1
8759,8759,8760,8,1,-7
8760,8760,8761,1,8,7
8761,8761,8762,8,3,-5
8762,8762,8763,3,0,-3
8763,8763,8764,0,8,8
8764,8764,8765,8,3,-5
8765,8765,8766,3,5,2
8766,8766,8767,5,5,0
8767,8767,8768,5,4,-1
8768,8768,8769,4,4,0
8769,8769,8770,4,6,2
8770,8770,8771,6,3,-3
8771,8771,8772,3,1,-2
8772,8772,8773,1,3,2
8773,8773,8774,3,6,3
8774,8774,8775,6,4,-2
8775,8775,8776,4,9,5
8776,8776,8777,9,6,-3
8777,8777,8778,6,1,-5
8778,8778,8779,1,5,4
8779,8779,8780,5,8,3
8780,8780,8781,8,1,-7
8781,8781,8782,1,8,7
8782,8782,8783,8,7,-1
8783,8783,8784,7,2,-5
8784,8784,8785,2,8,6
8785,8785,8786,8,3,-5
8786,8786,8787,3,4,1
8787,8787,8788,4,0,-4
8788,8788,8789,0,5,5
8789,8789,8790,5,3,-2
8790,8790,8791,3,7,4
8791,8791,8792,7,6,-1
8792,8792,8793,6,2,-4
8793,8793,8794,2,3,1
8794,8794,8795,3,3,0
8795,8795,8796,3,4,1
8796,8796,8797,4,6,2
8797,8797,8798,6,7,1
8798,8798,8799,7,6,-1
8799,8799,8800,6,3,-3
8800,8800,8801,3,7,4
8801,8801,8802,7,9,2
8802,8802,8803,9,7,-2
8803,8803,8804,7,7,0
8804,8804,8805,7,7,0
8805,8805,8806,7,1,-6
8806,8806,8807,1,6,5
8807,8807,8808,6,3,-3
8808,8808,8809,3,0,-3
8809,8809,8810,0,2,2
8810,8810,8811,2,1,-1
8811,8811,8812,1,0,-1
8812,8812,8813,0,0,0
8813,8813,8814,0,6,6
8814,8814,8815,6,1,-5
8815,8815,8816,1,3,2
8816,8816,8817,3,6,3
8817,8817,8818,6,3,-3
8818,8818,8819,3,5,2
8819,8819,8820,5,6,1
8820,8820,8821,6,3,-3
8821,8821,8822,3,6,3
8822,8822,8823,6,1,-5
8823,8823,8824,1,3,2
8824,8824,8825,3,4,1
8825,8825,8826,4,6,2
8826,8826,8827,6,7,1
8827,8827,8828,7,7,0
8828,8828,8829,7,6,-1
8829,8829,8830,6,3,-3
8830,8830,8831,3,2,-1
8831,8831,8832,2,4,2
8832,8832,8833,4,2,-2
8833,8833,8834,2,2,0
8834,8834,8835,2,5,3
8835,8835,8836,5,1,-4
8836,8836,8837,1,9,8
8837,8837,8838,9,0,-9
8838,8838,8839,0,1,1
8839,8839,8840,1,4,3
8840,8840,8841,4,2,-2
8841,8841,8842,2,4,2
8842,8842,8843,4,2,-2
8843,8843,8844,2,2,0
8844,8844,8845,2,7,5
8845,8845,8846,7,6,-1
8846,8846,8847,6,9,3
8847,8847,8848,9,6,-3
8848,8848,8849,6,7,1
8849,8849,8850,7,6,-1
8850,8850,8851,6,9,3
8851,8851,8852,9,2,-7
8852,8852,8853,2,2,0
8853,8853,8854,2,4,2
8854,8854,8855,4,0,-4
8855,8855,8856,0,5,5
8856,8856,8857,5,4,-1
8857,8857,8858,4,2,-2
8858,8858,8859,2,8,6
8859,8859,8860,8,6,-2
8860,8860,8861,6,7,1
8861,8861,8862,7,6,-1
8862,8862,8863,6,0,-6
8863,8863,8864,0,2,2
8864,8864,8865,2,3,1
8865,8865,8866,3,7,4
8866,8866,8867,7,8,1
8867,8867,8868,8,6,-2
8868,8868,8869,6,4,-2
8869,8869,8870,4,6,2
8870,8870,8871,6,6,0
8871,8871,8872,6,4,-2
8872,8872,8873,4,1,-3
8873,8873,8874,1,4,3
8874,8874,8875,4,4,0
8875,8875,8876,4,5,1
8876,8876,8877,5,0,-5
8877,8877,8878,0,2,2
8878,8878,8879,2,3,1
8879,8879,8880,3,3,0
8880,8880,8881,3,6,3
8881,8881,8882,6,3,-3
8882,8882,8883,3,2,-1
8883,8883,8884,2,3,1
8884,8884,8885,3,0,-3
8885,8885,8886,0,2,2
8886,8886,8887,2,4,2
8887,8887,8888,4,3,-1
8888,8888,8889,3,8,5
8889,8889,8890,8,4,-4
8890,8890,8891,4,1,-3
8891,8891,8892,1,8,7
8892,8892,8893,8,3,-5
8893,8893,8894,3,0,-3
8894,8894,8895,0,1,1
8895,8895,8896,1,0,-1
8896,8896,8897,0,0,0
8897,8897,8898,0,6,6
8898,8898,8899,6,9,3
8899,8899,8900,9,5,-4
8900,8900,8901,5,0,-5
8901,8901,8902,0,9,9
8902,8902,8903,9,1,-8
8903,8903,8904,1,1,0
8904,8904,8905,1,2,1
8905,8905,8906,2,4,2
8906,8906,8907,4,3,-1
8907,8907,8908,3,6,3
8908,8908,8909,6,5,-1
8909,8909,8910,5,7,2
8910,8910,8911,7,6,-1
8911,8911,8912,6,0,-6
8912,8912,8913,0,7,7
8913,8913,8914,7,4,-3
8914,8914,8915,4,8,4
8915,8915,8916,8,1,-7
8916,8916,8917,1,0,-1
8917,8917,8918,0,8,8
8918,8918,8919,8,1,-7
8919,8919,8920,1,8,7
8920,8920,8921,8,2,-6
8921,8921,8922,2,2,0
8922,8922,8923,2,3,1
8923,8923,8924,3,2,-1
8924,8924,8925,2,4,2
8925,8925,8926,4,0,-4
8926,8926,8927,0,5,5
8927,8927,8928,5,8,3
8928,8928,8929,8,6,-2
8929,8929,8930,6,4,-2
8930,8930,8931,4,7,3
8931,8931,8932,7,0,-7
8932,8932,8933,0,8,8
8933,8933,8934,8,1,-7
8934,8934,8935,1,0,-1
8935,8935,8936,0,3,3
8936,8936,8937,3,1,-2
8937,8937,8938,1,5,4
8938,8938,8939,5,2,-3
8939,8939,8940,2,6,4
8940,8940,8941,6,3,-3
8941,8941,8942,3,6,3
8942,8942,8943,6,4,-2
8943,8943,8944,4,4,0
8944,8944,8945,4,5,1
8945,8945,8946,5,3,-2
8946,8946,8947,3,6,3
8947,8947,8948,6,3,-3
8948,8948,8949,3,7,4
8949,8949,8950,7,4,-3
8950,8950,8951,4,8,4
8951,8951,8952,8,2,-6
8952,8952,8953,2,9,7
8953,8953,8954,9,7,-2
8954,8954,8955,7,8,1
8955,8955,8956,8,4,-4
8956,8956,8957,4,3,-1
8957,8957,8958,3,3,0
8958,8958,8959,3,7,4
8959,8959,8960,7,2,-5
8960,8960,8961,2,0,-2
8961,8961,8962,0,4,4
8962,8962,8963,4,1,-3
8963,8963,8964,1,4,3
8964,8964,8965,4,7,3
8965,8965,8966,7,2,-5
8966,8966,8967,2,3,1
8967,8967,8968,3,9,6
8968,8968,8969,9,0,-9
8969,8969,8970,0,1,1
8970,8970,8971,1,9,8
8971,8971,8972,9,2,-7
8972,8972,8973,2,4,2
8973,8973,8974,4,6,2
8974,8974,8975,6,5,-1
8975,8975,8976,5,3,-2
8976,8976,8977,3,2,-1
8977,8977,8978,2,2,0
8978,8978,8979,2,0,-2
8979,8979,8980,0,7,7
8980,8980,8981,7,6,-1
8981,8981,8982,6,0,-6
8982,8982,8983,0,2,2
8983,8983,8984,2,1,-1
8984,8984,8985,1,1,0
8985,8985,8986,1,5,4
8986,8986,8987,5,1,-4
8987,8987,8988,1,5,4
8988,8988,8989,5,1,-4
8989,8989,8990,1,7,6
8990,8990,8991,7,7,0
8991,8991,8992,7,1,-6
8992,8992,8993,1,2,1
8993,8993,8994,2,6,4
8994,8994,8995,6,4,-2
8995,8995,8996,4,4,0
8996,8996,8997,4,2,-2
8997,8997,8998,2,9,7
8998,8998,8999,9,9,0
8999,8999,9000,9,6,-3
9000,9000,9001,6,7,1
9001,9001,9002,7,9,2
9002,9002,9003,9,0,-9
9003,9003,9004,0,3,3
9004,9004,9005,3,0,-3
9005,9005,9006,0,3,3
9006,9006,9007,3,7,4
9007,9007,9008,7,8,1
9008,9008,9009,8,5,-3
9009,9009,9010,5,6,1
9010,9010,9011,6,1,-5
9011,9011,9012,1,1,0
9012,9012,9013,1,1,0
9013,9013,9014,1,8,7
9014,9014,9015,8,6,-2
9015,9015,9016,6,6,0
9016,9016,9017,6,1,-5
9017,9017,9018,1,0,-1
9018,9018,9019,0,8,8
9019,9019,9020,8,8,0
9020,9020,9021,8,2,-6
9021,9021,9022,2,7,5
9022,9022,9023,7,7,0
9023,9023,9024,7,6,-1
9024,9024,9025,6,4,-2
9025,9025,9026,4,4,0
9026,9026,9027,4,0,-4
9027,9027,9028,0,5,5
9028,9028,9029,5,4,-1
9029,9029,9030,4,4,0
9030,9030,9031,4,2,-2
9031,9031,9032,2,0,-2
9032,9032,9033,0,5,5
9033,9033,9034,5,0,-5
9034,9034,9035,0,0,0
9035,9035,9036,0,2,2
9036,9036,9037,2,3,1
9037,9037,9038,3,0,-3
9038,9038,9039,0,1,1
9039,9039,9040,1,4,3
9040,9040,9041,4,9,5
9041,9041,9042,9,6,-3
9042,9042,9043,6,1,-5
9043,9043,9044,1,5,4
9044,9044,9045,5,1,-4
9045,9045,9046,1,4,3
9046,9046,9047,4,0,-4
9047,9047,9048,0,0,0
9048,9048,9049,0,6,6
9049,9049,9050,6,8,2
9050,9050,9051,8,9,1
9051,9051,9052,9,7,-2
9052,9052,9053,7,3,-4
9053,9053,9054,3,2,-1
9054,9054,9055,2,0,-2
9055,9055,9056,0,0,0
9056,9056,9057,0,8,8
9057,9057,9058,8,6,-2
9058,9058,9059,6,3,-3
9059,9059,9060,3,7,4
9060,9060,9061,7,9,2
9061,9061,9062,9,5,-4
9062,9062,9063,5,6,1
9063,9063,9064,6,5,-1
9064,9064,9065,5,3,-2
9065,9065,9066,3,9,6
9066,9066,9067,9,0,-9
9067,9067,9068,0,6,6
9068,9068,9069,6,1,-5
9069,9069,9070,1,9,8
9070,9070,9071,9,4,-5
9071,9071,9072,4,1,-3
9072,9072,9073,1,5,4
9073,9073,9074,5,3,-2
9074,9074,9075,3,6,3
9075,9075,9076,6,8,2
9076,9076,9077,8,7,-1
9077,9077,9078,7,3,-4
9078,9078,9079,3,8,5
9079,9079,9080,8,3,-5
9080,9080,9081,3,9,6
9081,9081,9082,9,7,-2
9082,9082,9083,7,0,-7
9083,9083,9084,0,5,5
9084,9084,9085,5,1,-4
9085,9085,9086,1,7,6
9086,9086,9087,7,2,-5
9087,9087,9088,2,8,6
9088,9088,9089,8,3,-5
9089,9089,9090,3,6,3
9090,9090,9091,6,4,-2
9091,9091,9092,4,2,-2
9092,9092,9093,2,5,3
9093,9093,9094,5,6,1
9094,9094,9095,6,6,0
9095,9095,9096,6,5,-1
9096,9096,9097,5,7,2
9097,9097,9098,7,2,-5
9098,9098,9099,2,8,6
9099,9099,9100,8,4,-4
9100,9100,9101,4,0,-4
9101,9101,9102,0,7,7
9102,9102,9103,7,1,-6
9103,9103,9104,1,2,1
9104,9104,9105,2,2,0
9105,9105,9106,2,1,-1
9106,9106,9107,1,3,2
9107,9107,9108,3,4,1
9108,9108,9109,4,4,0
9109,9109,9110,4,1,-3
9110,9110,9111,1,5,4
9111,9111,9112,5,8,3
9112,9112,9113,8,6,-2
9113,9113,9114,6,9,3
9114,9114,9115,9,7,-2
9115,9115,9116,7,4,-3
9116,9116,9117,4,8,4
9117,9117,9118,8,9,1
9118,9118,9119,9,9,0
9119,9119,9120,9,6,-3
9120,9120,9121,6,1,-5
9121,9121,9122,1,9,8
9122,9122,9123,9,6,-3
9123,9123,9124,6,5,-1
9124,9124,9125,5,8,3
9125,9125,9126,8,6,-2
9126,9126,9127,6,9,3
9127,9127,9128,9,9,0
9128,9128,9129,9,9,0
9129,9129,9130,9,1,-8
9130,9130,9131,1,0,-1
9131,9131,9132,0,9,9
9132,9132,9133,9,1,-8
9133,9133,9134,1,8,7
9134,9134,9135,8,2,-6
9135,9135,9136,2,1,-1
9136,9136,9137,1,4,3
9137,9137,9138,4,5,1
9138,9138,9139,5,4,-1
9139,9139,9140,4,3,-1
9140,9140,9141,3,3,0
9141,9141,9142,3,0,-3
9142,9142,9143,0,7,7
9143,9143,9144,7,6,-1
9144,9144,9145,6,4,-2
9145,9145,9146,4,3,-1
9146,9146,9147,3,4,1
9147,9147,9148,4,4,0
9148,9148,9149,4,4,0
9149,9149,9150,4,9,5
9150,9150,9151,9,0,-9
9151,9151,9152,0,8,8
9152,9152,9153,8,3,-5
9153,9153,9154,3,8,5
9154,9154,9155,8,8,0
9155,9155,9156,8,6,-2
9156,9156,9157,6,7,1
9157,9157,9158,7,0,-7
9158,9158,9159,0,5,5
9159,9159,9160,5,5,0
9160,9160,9161,5,1,-4
9161,9161,9162,1,7,6
9162,9162,9163,7,5,-2
9163,9163,9164,5,8,3
9164,9164,9165,8,8,0
9165,9165,9166,8,0,-8
9166,9166,9167,0,9,9
9167,9167,9168,9,3,-6
9168,9168,9169,3,2,-1
9169,9169,9170,2,5,3
9170,9170,9171,5,5,0
9171,9171,9172,5,4,-1
9172,9172,9173,4,1,-3
9173,9173,9174,1,6,5
9174,9174,9175,6,1,-5
9175,9175,9176,1,9,8
9176,9176,9177,9,6,-3
9177,9177,9178,6,8,2
9178,9178,9179,8,2,-6
9179,9179,9180,2,3,1
9180,9180,9181,3,1,-2
9181,9181,9182,1,3,2
9182,9182,9183,3,3,0
9183,9183,9184,3,3,0
9184,9184,9185,3,8,5
9185,9185,9186,8,2,-6
9186,9186,9187,2,6,4
9187,9187,9188,6,7,1
9188,9188,9189,7,4,-3
9189,9189,9190,4,4,0
9190,9190,9191,4,9,5
9191,9191,9192,9,3,-6
9192,9192,9193,3,2,-1
9193,9193,9194,2,0,-2
9194,9194,9195,0,0,0
9195,9195,9196,0,0,0
9196,9196,9197,0,0,0
9197,9197,9198,0,7,7
9198,9198,9199,7,1,-6
9199,9199,9200,1,7,6
9200,9200,9201,7,6,-1
9201,9201,9202,6,6,0
9202,9202,9203,6,2,-4
9203,9203,9204,2,0,-2
9204,9204,9205,0,5,5
9205,9205,9206,5,6,1
9206,9206,9207,6,5,-1
9207,9207,9208,5,8,3
9208,9208,9209,8,0,-8
9209,9209,9210,0,6,6
9210,9210,9211,6,2,-4
9211,9211,9212,2,2,0
9212,9212,9213,2,8,6
9213,9213,9214,8,7,-1
9214,9214,9215,7,0,-7
9215,9215,9216,0,4,4
9216,9216,9217,4,6,2
9217,9217,9218,6,2,-4
9218,9218,9219,2,8,6
9219,9219,9220,8,8,0
9220,9220,9221,8,1,-7
9221,9221,9222,1,0,-1
9222,9222,9223,0,7,7
9223,9223,9224,7,7,0
9224,9224,9225,7,9,2
9225,9225,9226,9,3,-6
9226,9226,9227,3,1,-2
9227,9227,9228,1,5,4
9228,9228,9229,5,9,4
9229,9229,9230,9,3,-6
9230,9230,9231,3,2,-1
9231,9231,9232,2,5,3
9232,9232,9233,5,6,1
9233,9233,9234,6,8,2
9234,9234,9235,8,7,-1
9235,9235,9236,7,5,-2
9236,9236,9237,5,6,1
9237,9237,9238,6,9,3
9238,9238,9239,9,6,-3
9239,9239,9240,6,1,-5
9240,9240,9241,1,8,7
9241,9241,9242,8,2,-6
9242,9242,9243,2,7,5
9243,9243,9244,7,6,-1
9244,9244,9245,6,4,-2
9245,9245,9246,4,2,-2
9246,9246,9247,2,9,7
9247,9247,9248,9,2,-7
9248,9248,9249,2,2,0
9249,9249,9250,2,8,6
9250,9250,9251,8,1,-7
9251,9251,9252,1,2,1
9252,9252,9253,2,3,1
9253,9253,9254,3,6,3
9254,9254,9255,6,3,-3
9255,9255,9256,3,1,-2
9256,9256,9257,1,0,-1
9257,9257,9258,0,2,2
9258,9258,9259,2,5,3
9259,9259,9260,5,1,-4
9260,9260,9261,1,5,4
9261,9261,9262,5,6,1
9262,9262,9263,6,7,1
9263,9263,9264,7,1,-6
9264,9264,9265,1,9,8
9265,9265,9266,9,2,-7
9266,9266,9267,2,7,5
9267,9267,9268,7,3,-4
9268,9268,9269,3,0,-3
9269,9269,9270,0,7,7
9270,9270,9271,7,2,-5
9271,9271,9272,2,3,1
9272,9272,9273,3,7,4
9273,9273,9274,7,7,0
9274,9274,9275,7,9,2
9275,9275,9276,9,7,-2
9276,9276,9277,7,1,-6
9277,9277,9278,1,3,2
9278,9278,9279,3,3,0
9279,9279,9280,3,6,3
9280,9280,9281,6,6,0
9281,9281,9282,6,4,-2
9282,9282,9283,4,7,3
9283,9283,9284,7,2,-5
9284,9284,9285,2,8,6
9285,9285,9286,8,7,-1
9286,9286,9287,7,0,-7
9287,9287,9288,0,1,1
9288,9288,9289,1,3,2
9289,9289,9290,3,9,6
9290,9290,9291,9,5,-4
9291,9291,9292,5,1,-4
9292,9292,9293,1,3,2
9293,9293,9294,3,3,0
9294,9294,9295,3,6,3
9295,9295,9296,6,0,-6
9296,9296,9297,0,0,0
9297,9297,9298,0,1,1
9298,9298,9299,1,1,0
9299,9299,9300,1,3,2
9300,9300,9301,3,2,-1
9301,9301,9302,2,3,1
9302,9302,9303,3,3,0
9303,9303,9304,3,9,6
9304,9304,9305,9,6,-3
9305,9305,9306,6,9,3
9306,9306,9307,9,7,-2
9307,9307,9308,7,9,2
9308,9308,9309,9,8,-1
9309,9309,9310,8,0,-8
9310,9310,9311,0,9,9
9311,9311,9312,9,1,-8
9312,9312,9313,1,0,-1
9313,9313,9314,0,8,8
9314,9314,9315,8,1,-7
9315,9315,9316,1,6,5
9316,9316,9317,6,2,-4
9317,9317,9318,2,2,0
9318,9318,9319,2,3,1
9319,9319,9320,3,5,2
9320,9320,9321,5,4,-1
9321,9321,9322,4,0,-4
9322,9322,9323,0,5,5
9323,9323,9324,5,3,-2
9324,9324,9325,3,6,3
9325,9325,9326,6,5,-1
9326,9326,9327,5,7,2
9327,9327,9328,7,5,-2
9328,9328,9329,5,0,-5
9329,9329,9330,0,5,5
9330,9330,9331,5,1,-4
9331,9331,9332,1,1,0
9332,9332,9333,1,2,1
9333,9333,9334,2,8,6
9334,9334,9335,8,3,-5
9335,9335,9336,3,5,2
9336,9336,9337,5,4,-1
9337,9337,9338,4,6,2
9338,9338,9339,6,5,-1
9339,9339,9340,5,5,0
9340,9340,9341,5,6,1
9341,9341,9342,6,0,-6
9342,9342,9343,0,7,7
9343,9343,9344,7,5,-2
9344,9344,9345,5,8,3
9345,9345,9346,8,9,1
9346,9346,9347,9,9,0
9347,9347,9348,9,4,-5
9348,9348,9349,4,8,4
9349,9349,9350,8,1,-7
9350,9350,9351,1,7,6
9351,9351,9352,7,5,-2
9352,9352,9353,5,4,-1
9353,9353,9354,4,1,-3
9354,9354,9355,1,3,2
9355,9355,9356,3,7,4
9356,9356,9357,7,9,2
9357,9357,9358,9,8,-1
9358,9358,9359,8,8,0
9359,9359,9360,8,2,-6
9360,9360,9361,2,8,6
9361,9361,9362,8,4,-4
9362,9362,9363,4,3,-1
9363,9363,9364,3,8,5
9364,9364,9365,8,1,-7
9365,9365,9366,1,5,4
9366,9366,9367,5,5,0
9367,9367,9368,5,5,0
9368,9368,9369,5,8,3
9369,9369,9370,8,4,-4
9370,9370,9371,4,2,-2
9371,9371,9372,2,9,7
9372,9372,9373,9,7,-2
9373,9373,9374,7,2,-5
9374,9374,9375,2,4,2
9375,9375,9376,4,5,1
9376,9376,9377,5,2,-3
9377,9377,9378,2,1,-1
9378,9378,9379,1,6,5
9379,9379,9380,6,3,-3
9380,9380,9381,3,5,2
9381,9381,9382,5,7,2
9382,9382,9383,7,2,-5
9383,9383,9384,2,5,3
9384,9384,9385,5,4,-1
9385,9385,9386,4,3,-1
9386,9386,9387,3,5,2
9387,9387,9388,5,4,-1
9388,9388,9389,4,6,2
9389,9389,9390,6,9,3
9390,9390,9391,9,4,-5
9391,9391,9392,4,4,0
9392,9392,9393,4,1,-3
9393,9393,9394,1,9,8
9394,9394,9395,9,7,-2
9395,9395,9396,7,2,-5
9396,9396,9397,2,5,3
9397,9397,9398,5,2,-3
9398,9398,9399,2,1,-1
9399,9399,9400,1,3,2
9400,9400,9401,3,3,0
9401,9401,9402,3,0,-3
9402,9402,9403,0,3,3
9403,9403,9404,3,1,-2
9404,9404,9405,1,6,5
9405,9405,9406,6,0,-6
9406,9406,9407,0,9,9
9407,9407,9408,9,8,-1
9408,9408,9409,8,6,-2
9409,9409,9410,6,4,-2
9410,9410,9411,4,3,-1
9411,9411,9412,3,3,0
9412,9412,9413,3,3,0
9413,9413,9414,3,5,2
9414,9414,9415,5,1,-4
9415,9415,9416,1,7,6
9416,9416,9417,7,6,-1
9417,9417,9418,6,3,-3
9418,9418,9419,3,5,2
9419,9419,9420,5,3,-2
9420,9420,9421,3,6,3
9421,9421,9422,6,0,-6
9422,9422,9423,0,1,1
9423,9423,9424,1,3,2
9424,9424,9425,3,9,6
9425,9425,9426,9,7,-2
9426,9426,9427,7,3,-4
9427,9427,9428,3,9,6
9428,9428,9429,9,7,-2
9429,9429,9430,7,1,-6
9430,9430,9431,1,4,3
9431,9431,9432,4,7,3
9432,9432,9433,7,7,0
9433,9433,9434,7,7,0
9434,9434,9435,7,0,-7
9435,9435,9436,0,4,4
9436,9436,9437,4,9,5
9437,9437,9438,9,6,-3
9438,9438,9439,6,0,-6
9439,9439,9440,0,0,0
9440,9440,9441,0,0,0
9441,9441,9442,0,4,4
9442,9442,9443,4,3,-1
9443,9443,9444,3,7,4
9444,9444,9445,7,7,0
9445,9445,9446,7,6,-1
9446,9446,9447,6,9,3
9447,9447,9448,9,9,0
9448,9448,9449,9,2,-7
9449,9449,9450,2,5,3
9450,9450,9451,5,0,-5
9451,9451,9452,0,0,0
9452,9452,9453,0,1,1
9453,9453,9454,1,7,6
9454,9454,9455,7,0,-7
9455,9455,9456,0,0,0
9456,9456,9457,0,1,1
9457,9457,9458,1,0,-1
9458,9458,9459,0,0,0
9459,9459,9460,0,6,6
9460,9460,9461,6,4,-2
9461,9461,9462,4,5,1
9462,9462,9463,5,0,-5
9463,9463,9464,0,5,5
9464,9464,9465,5,4,-1
9465,9465,9466,4,3,-1
9466,9466,9467,3,7,4
9467,9467,9468,7,6,-1
9468,9468,9469,6,9,3
9469,9469,9470,9,7,-2
9470,9470,9471,7,2,-5
9471,9471,9472,2,2,0
9472,9472,9473,2,0,-2
9473,9473,9474,0,1,1
9474,9474,9475,1,6,5
9475,9475,9476,6,0,-6
9476,9476,9477,0,2,2
9477,9477,9478,2,0,-2
9478,9478,9479,0,2,2
9479,9479,9480,2,1,-1
9480,9480,9481,1,9,8
9481,9481,9482,9,3,-6
9482,9482,9483,3,9,6
9483,9483,9484,9,2,-7
9484,9484,9485,2,0,-2
9485,9485,9486,0,6,6
9486,9486,9487,6,1,-5
9487,9487,9488,1,2,1
9488,9488,9489,2,2,0
9489,9489,9490,2,8,6
9490,9490,9491,8,3,-5
9491,9491,9492,3,1,-2
9492,9492,9493,1,4,3
9493,9493,9494,4,7,3
9494,9494,9495,7,5,-2
9495,9495,9496,5,4,-1
9496,9496,9497,4,6,2
9497,9497,9498,6,7,1
9498,9498,9499,7,7,0
9499,9499,9500,7,6,-1
9500,9500,9501,6,8,2
9501,9501,9502,8,7,-1
9502,9502,9503,7,9,2
9503,9503,9504,9,9,0
9504,9504,9505,9,0,-9
9505,9505,9506,0,0,0
9506,9506,9507,0,1,1
9507,9507,9508,1,2,1
9508,9508,9509,2,2,0
9509,9509,9510,2,7,5
9510,9510,9511,7,3,-4
9511,9511,9512,3,6,3
9512,9512,9513,6,4,-2
9513,9513,9514,4,5,1
9514,9514,9515,5,5,0
9515,9515,9516,5,3,-2
9516,9516,9517,3,6,3
9517,9517,9518,6,2,-4
9518,9518,9519,2,7,5
9519,9519,9520,7,3,-4
9520,9520,9521,3,8,5
9521,9521,9522,8,7,-1
9522,9522,9523,7,0,-7
9523,9523,9524,0,0,0
9524,9524,9525,0,1,1
9525,9525,9526,1,6,5
9526,9526,9527,6,2,-4
9527,9527,9528,2,8,6
9528,9528,9529,8,3,-5
9529,9529,9530,3,0,-3
9530,9530,9531,0,5,5
9531,9531,9532,5,9,4
9532,9532,9533,9,6,-3
9533,9533,9534,6,6,0
9534,9534,9535,6,7,1
9535,9535,9536,7,4,-3
9536,9536,9537,4,8,4
9537,9537,9538,8,7,-1
9538,9538,9539,7,5,-2
9539,9539,9540,5,1,-4
9540,9540,9541,1,4,3
9541,9541,9542,4,2,-2
9542,9542,9543,2,8,6
9543,9543,9544,8,0,-8
9544,9544,9545,0,7,7
9545,9545,9546,7,2,-5
9546,9546,9547,2,4,2
9547,9547,9548,4,7,3
9548,9548,9549,7,7,0
9549,9549,9550,7,1,-6
9550,9550,9551,1,7,6
9551,9551,9552,7,0,-7
9552,9552,9553,0,3,3
9553,9553,9554,3,8,5
9554,9554,9555,8,9,1
9555,9555,9556,9,6,-3
9556,9556,9557,6,8,2
9557,9557,9558,8,4,-4
9558,9558,9559,4,8,4
9559,9559,9560,8,7,-1
9560,9560,9561,7,3,-4
9561,9561,9562,3,1,-2
9562,9562,9563,1,1,0
9563,9563,9564,1,8,7
9564,9564,9565,8,5,-3
9565,9565,9566,5,4,-1
9566,9566,9567,4,8,4
9567,9567,9568,8,5,-3
9568,9568,9569,5,2,-3
9569,9569,9570,2,1,-1
9570,9570,9571,1,7,6
9571,9571,9572,7,2,-5
9572,9572,9573,2,4,2
9573,9573,9574,4,6,2
9574,9574,9575,6,2,-4
9575,9575,9576,2,6,4
9576,9576,9577,6,6,0
9577,9577,9578,6,5,-1
9578,9578,9579,5,1,-4
9579,9579,9580,1,6,5
9580,9580,9581,6,5,-1
9581,9581,9582,5,7,2
9582,9582,9583,7,2,-5
9583,9583,9584,2,1,-1
9584,9584,9585,1,4,3
9585,9585,9586,4,4,0
9586,9586,9587,4,5,1
9587,9587,9588,5,7,2
9588,9588,9589,7,5,-2
9589,9589,9590,5,1,-4
9590,9590,9591,1,8,7
9591,9591,9592,8,3,-5
9592,9592,9593,3,6,3
9593,9593,9594,6,8,2
9594,9594,9595,8,4,-4
9595,9595,9596,4,6,2
9596,9596,9597,6,4,-2
9597,9597,9598,4,7,3
9598,9598,9599,7,1,-6
9599,9599,9600,1,2,1
9600,9600,9601,2,8,6
9601,9601,9602,8,3,-5
9602,9602,9603,3,7,4
9603,9603,9604,7,2,-5
9604,9604,9605,2,5,3
9605,9605,9606,5,7,2
9606,9606,9607,7,5,-2
9607,9607,9608,5,8,3
9608,9608,9609,8,1,-7
9609,9609,9610,1,3,2
9610,9610,9611,3,8,5
9611,9611,9612,8,3,-5
9612,9612,9613,3,9,6
9613,9613,9614,9,9,0
9614,9614,9615,9,1,-8
9615,9615,9616,1,1,0
9616,9616,9617,1,3,2
9617,9617,9618,3,1,-2
9618,9618,9619,1,6,5
9619,9619,9620,6,3,-3
9620,9620,9621,3,3,0
9621,9621,9622,3,1,-2
9622,9622,9623,1,3,2
9623,9623,9624,3,3,0
9624,9624,9625,3,2,-1
9625,9625,9626,2,4,2
9626,9626,9627,4,2,-2
9627,9627,9628,2,1,-1
9628,9628,9629,1,6,5
9629,9629,9630,6,9,3
9630,9630,9631,9,9,0
9631,9631,9632,9,4,-5
9632,9632,9633,4,9,5
9633,9633,9634,9,4,-5
9634,9634,9635,4,6,2
9635,9635,9636,6,3,-3
9636,9636,9637,3,3,0
9637,9637,9638,3,3,0
9638,9638,9639,3,3,0
9639,9639,9640,3,8,5
9640,9640,9641,8,8,0
9641,9641,9642,8,9,1
9642,9642,9643,9,1,-8
9643,9643,9644,1,7,6
9644,9644,9645,7,6,-1
9645,9645,9646,6,5,-1
9646,9646,9647,5,5,0
9647,9647,9648,5,3,-2
9648,9648,9649,3,6,3
9649,9649,9650,6,8,2
9650,9650,9651,8,8,0
9651,9651,9652,8,5,-3
9652,9652,9653,5,1,-4
9653,9653,9654,1,9,8
9654,9654,9655,9,9,0
9655,9655,9656,9,7,-2
9656,9656,9657,7,7,0
9657,9657,9658,7,2,-5
9658,9658,9659,2,6,4
9659,9659,9660,6,7,1
9660,9660,9661,7,8,1
9661,9661,9662,8,6,-2
9662,9662,9663,6,3,-3
9663,9663,9664,3,3,0
9664,9664,9665,3,7,4
9665,9665,9666,7,0,-7
9666,9666,9667,0,4,4
9667,9667,9668,4,2,-2
9668,9668,9669,2,7,5
9669,9669,9670,7,3,-4
9670,9670,9671,3,0,-3
9671,9671,9672,0,2,2
9672,9672,9673,2,9,7
9673,9673,9674,9,1,-8
9674,9674,9675,1,0,-1
9675,9675,9676,0,7,7
9676,9676,9677,7,0,-7
9677,9677,9678,0,1,1
9678,9678,9679,1,3,2
9679,9679,9680,3,3,0
9680,9680,9681,3,7,4
9681,9681,9682,7,2,-5
9682,9682,9683,2,9,7
9683,9683,9684,9,5,-4
9684,9684,9685,5,3,-2
9685,9685,9686,3,8,5
9686,9686,9687,8,0,-8
9687,9687,9688,0,0,0
9688,9688,9689,0,2,2
9689,9689,9690,2,5,3
9690,9690,9691,5,0,-5
9691,9691,9692,0,6,6
9692,9692,9693,6,1,-5
9693,9693,9694,1,8,7
9694,9694,9695,8,0,-8
9695,9695,9696,0,3,3
9696,9696,9697,3,1,-2
9697,9697,9698,1,0,-1
9698,9698,9699,0,0,0
9699,9699,9700,0,6,6
9700,9700,9701,6,4,-2
9701,9701,9702,4,6,2
9702,9702,9703,6,0,-6
9703,9703,9704,0,4,4
9704,9704,9705,4,1,-3
9705,9705,9706,1,3,2
9706,9706,9707,3,0,-3
9707,9707,9708,0,9,9
9708,9708,9709,9,4,-5
9709,9709,9710,4,0,-4
9710,9710,9711,0,7,7
9711,9711,9712,7,2,-5
9712,9712,9713,2,9,7
9713,9713,9714,9,4,-5
9714,9714,9715,4,2,-2
9715,9715,9716,2,7,5
9716,9716,9717,7,0,-7
9717,9717,9718,0,4,4
9718,9718,9719,4,6,2
9719,9719,9720,6,0,-6
9720,9720,9721,0,2,2
9721,9721,9722,2,2,0
9722,9722,9723,2,6,4
9723,9723,9724,6,7,1
9724,9724,9725,7,2,-5
9725,9725,9726,2,8,6
9726,9726,9727,8,2,-6
9727,9727,9728,2,9,7
9728,9728,9729,9,9,0
9729,9729,9730,9,3,-6
9730,9730,9731,3,9,6
9731,9731,9732,9,8,-1
9732,9732,9733,8,0,-8
9733,9733,9734,0,1,1
9734,9734,9735,1,1,0
9735,9735,9736,1,2,1
9736,9736,9737,2,2,0
9737,9737,9738,2,5,3
9738,9738,9739,5,3,-2
9739,9739,9740,3,7,4
9740,9740,9741,7,4,-3
9741,9741,9742,4,0,-4
9742,9742,9743,0,5,5
9743,9743,9744,5,0,-5
9744,9744,9745,0,6,6
9745,9745,9746,6,4,-2
9746,9746,9747,4,7,3
9747,9747,9748,7,2,-5
9748,9748,9749,2,8,6
9749,9749,9750,8,0,-8
9750,9750,9751,0,9,9
9751,9751,9752,9,9,0
9752,9752,9753,9,0,-9
9753,9753,9754,0,9,9
9754,9754,9755,9,1,-8
9755,9755,9756,1,2,1
9756,9756,9757,2,2,0
9757,9757,9758,2,9,7
9758,9758,9759,9,3,-6
9759,9759,9760,3,6,3
9760,9760,9761,6,4,-2
9761,9761,9762,4,8,4
9762,9762,9763,8,5,-3
9763,9763,9764,5,8,3
9764,9764,9765,8,6,-2
9765,9765,9766,6,3,-3
9766,9766,9767,3,7,4
9767,9767,9768,7,7,0
9768,9768,9769,7,8,1
9769,9769,9770,8,5,-3
9770,9770,9771,5,9,4
9771,9771,9772,9,2,-7
9772,9772,9773,2,0,-2
9773,9773,9774,0,7,7
9774,9774,9775,7,1,-6
9775,9775,9776,1,2,1
9776,9776,9777,2,2,0
9777,9777,9778,2,3,1
9778,9778,9779,3,3,0
9779,9779,9780,3,2,-1
9780,9780,9781,2,4,2
9781,9781,9782,4,8,4
9782,9782,9783,8,5,-3
9783,9783,9784,5,9,4
9784,9784,9785,9,6,-3
9785,9785,9786,6,3,-3
9786,9786,9787,3,7,4
9787,9787,9788,7,7,0
9788,9788,9789,7,8,1
9789,9789,9790,8,0,-8
9790,9790,9791,0,9,9
9791,9791,9792,9,8,-1
9792,9792,9793,8,7,-1
9793,9793,9794,7,8,1
9794,9794,9795,8,4,-4
9795,9795,9796,4,1,-3
9796,9796,9797,1,3,2
9797,9797,9798,3,6,3
9798,9798,9799,6,8,2
9799,9799,9800,8,5,-3
9800,9800,9801,5,5,0
9801,9801,9802,5,6,1
9802,9802,9803,6,1,-5
9803,9803,9804,1,1,0
9804,9804,9805,1,8,7
9805,9805,9806,8,0,-8
9806,9806,9807,0,5,5
9807,9807,9808,5,6,1
9808,9808,9809,6,2,-4
9809,9809,9810,2,9,7
9810,9810,9811,9,8,-1
9811,9811,9812,8,3,-5
9812,9812,9813,3,6,3
9813,9813,9814,6,5,-1
9814,9814,9815,5,1,-4
9815,9815,9816,1,6,5
9816,9816,9817,6,9,3
9817,9817,9818,9,6,-3
9818,9818,9819,6,2,-4
9819,9819,9820,2,0,-2
9820,9820,9821,0,4,4
9821,9821,9822,4,0,-4
9822,9822,9823,0,0,0
9823,9823,9824,0,5,5
9824,9824,9825,5,9,4
9825,9825,9826,9,2,-7
9826,9826,9827,2,9,7
9827,9827,9828,9,6,-3
9828,9828,9829,6,3,-3
9829,9829,9830,3,2,-1
9830,9830,9831,2,7,5
9831,9831,9832,7,8,1
9832,9832,9833,8,7,-1
9833,9833,9834,7,0,-7
9834,9834,9835,0,9,9
9835,9835,9836,9,2,-7
9836,9836,9837,2,1,-1
9837,9837,9838,1,9,8
9838,9838,9839,9,8,-1
9839,9839,9840,8,0,-8
9840,9840,9841,0,2,2
9841,9841,9842,2,1,-1
9842,9842,9843,1,7,6
9843,9843,9844,7,8,1
9844,9844,9845,8,5,-3
9845,9845,9846,5,9,4
9846,9846,9847,9,8,-1
9847,9847,9848,8,3,-5
9848,9848,9849,3,5,2
9849,9849,9850,5,2,-3
9850,9850,9851,2,3,1
9851,9851,9852,3,8,5
9852,9852,9853,8,2,-6
9853,9853,9854,2,7,5
9854,9854,9855,7,2,-5
9855,9855,9856,2,1,-1
9856,9856,9857,1,0,-1
9857,9857,9858,0,5,5
9858,9858,9859,5,5,0
9859,9859,9860,5,6,1
9860,9860,9861,6,8,2
9861,9861,9862,8,2,-6
9862,9862,9863,2,6,4
9863,9863,9864,6,3,-3
9864,9864,9865,3,0,-3
9865,9865,9866,0,8,8
9866,9866,9867,8,4,-4
9867,9867,9868,4,3,-1
9868,9868,9869,3,0,-3
9869,9869,9870,0,9,9
9870,9870,9871,9,3,-6
9871,9871,9872,3,6,3
9872,9872,9873,6,8,2
9873,9873,9874,8,0,-8
9874,9874,9875,0,1,1
9875,9875,9876,1,9,8
9876,9876,9877,9,0,-9
9877,9877,9878,0,7,7
9878,9878,9879,7,3,-4
9879,9879,9880,3,4,1
9880,9880,9881,4,0,-4
9881,9881,9882,0,7,7
9882,9882,9883,7,4,-3
9883,9883,9884,4,1,-3
9884,9884,9885,1,7,6
9885,9885,9886,7,7,0
9886,9886,9887,7,4,-3
9887,9887,9888,4,7,3
9888,9888,9889,7,9,2
9889,9889,9890,9,0,-9
9890,9890,9891,0,2,2
9891,9891,9892,2,6,4
9892,9892,9893,6,9,3
9893,9893,9894,9,2,-7
9894,9894,9895,2,1,-1
9895,9895,9896,1,9,8
9896,9896,9897,9,2,-7
9897,9897,9898,2,5,3
9898,9898,9899,5,5,0
9899,9899,9900,5,8,3
9900,9900,9901,8,7,-1
9901,9901,9902,7,1,-6
9902,9902,9903,1,1,0
9903,9903,9904,1,3,2
9904,9904,9905,3,7,4
9905,9905,9906,7,1,-6
9906,9906,9907,1,1,0
9907,9907,9908,1,7,6
9908,9908,9909,7,6,-1
9909,9909,9910,6,1,-5
9910,9910,9911,1,7,6
9911,9911,9912,7,2,-5
9912,9912,9913,2,3,1
9913,9913,9914,3,0,-3
9914,9914,9915,0,3,3
9915,9915,9916,3,3,0
9916,9916,9917,3,6,3
9917,9917,9918,6,8,2
9918,9918,9919,8,5,-3
9919,9919,9920,5,4,-1
9920,9920,9921,4,6,2
9921,9921,9922,6,0,-6
9922,9922,9923,0,2,2
9923,9923,9924,2,8,6
9924,9924,9925,8,8,0
9925,9925,9926,8,6,-2
9926,9926,9927,6,7,1
9927,9927,9928,7,6,-1
9928,9928,9929,6,6,0
9929,9929,9930,6,1,-5
9930,9930,9931,1,4,3
9931,9931,9932,4,3,-1
9932,9932,9933,3,9,6
9933,9933,9934,9,0,-9
9934,9934,9935,0,8,8
9935,9935,9936,8,8,0
9936,9936,9937,8,8,0
9937,9937,9938,8,9,1
9938,9938,9939,9,2,-7
9939,9939,9940,2,4,2
9940,9940,9941,4,9,5
9941,9941,9942,9,1,-8
9942,9942,9943,1,6,5
9943,9943,9944,6,8,2
9944,9944,9945,8,5,-3
9945,9945,9946,5,6,1
9946,9946,9947,6,5,-1
9947,9947,9948,5,8,3
9948,9948,9949,8,9,1
9949,9949,9950,9,9,0
9950,9950,9951,9,5,-4
9951,9951,9952,5,8,3
9952,9952,9953,8,3,-5
9953,9953,9954,3,7,4
9954,9954,9955,7,7,0
9955,9955,9956,7,8,1
9956,9956,9957,8,4,-4
9957,9957,9958,4,5,1
9958,9958,9959,5,3,-2
9959,9959,9960,3,1,-2
9960,9960,9961,1,6,5
9961,9961,9962,6,2,-4
9962,9962,9963,2,0,-2
9963,9963,9964,0,2,2
9964,9964,9965,2,0,-2
9965,9965,9966,0,0,0
9966,9966,9967,0,6,6
9967,9967,9968,6,9,3
9968,9968,9969,9,9,0
9969,9969,9970,9,8,-1
9970,9970,9971,8,0,-8
9971,9971,9972,0,2,2
9972,9972,9973,2,1,-1
9973,9973,9974,1,3,2
9974,9974,9975,3,1,-2
9975,9975,9976,1,4,3
9976,9976,9977,4,3,-1
9977,9977,9978,3,0,-3
9978,9978,9979,0,2,2
9979,9979,9980,2,4,2
9980,9980,9981,4,1,-3
9981,9981,9982,1,8,7
9982,9982,9983,8,0,-8
9983,9983,9984,0,4,4
9984,9984,9985,4,0,-4
9985,9985,9986,0,0,0
9986,9986,9987,0,1,1
9987,9987,9988,1,7,6
9988,9988,9989,7,2,-5
9989,9989,9990,2,7,5
9990,9990,9991,7,3,-4
9991,9991,9992,3,7,4
9992,9992,9993,7,4,-3
9993,9993,9994,4,0,-4
9994,9994,9995,0,5,5
9995,9995,9996,5,8,3
9996,9996,9997,8,6,-2
9997,9997,9998,6,9,3
9998,9998,9999,9,7,-2
9999,9999,10000,7,3,-4
10000,10000,10001,3,8,5
10001,10001,10002,8,7,-1
10002,10002,10003,7,9,2
10003,10003,10004,9,9,0
10004,10004,10005,9,0,-9
10005,10005,10006,0,1,1
10006,10006,10007,1,1,0
10007,10007,10008,1,5,4
10008,10008,10009,5,2,-3
10009,10009,10010,2,0,-2
10010,10010,10011,0,3,3
10011,10011,10012,3,8,5
10012,10012,10013,8,4,-4
10013,10013,10014,4,7,3
10014,10014,10015,7,5,-2
10015,10015,10016,5,2,-3
10016,10016,10017,2,6,4
10017,10017,10018,6,4,-2
10018,10018,10019,4,7,3
10019,10019,10020,7,1,-6
10020,10020,10021,1,8,7
10021,10021,10022,8,0,-8
10022,10022,10023,0,9,9
10023,10023,10024,9,2,-7
10024,10024,10025,2,0,-2
10025,10025,10026,0,0,0
10026,10026,10027,0,1,1
10027,10027,10028,1,9,8
10028,10028,10029,9,2,-7
10029,10029,10030,2,5,3
10030,10030,10031,5,3,-2
10031,10031,10032,3,6,3
10032,10032,10033,6,4,-2
10033,10033,10034,4,3,-1
10034,10034,10035,3,5,2
10035,10035,10036,5,6,1
10036,10036,10037,6,6,0
10037,10037,10038,6,9,3
10038,10038,10039,9,7,-2
10039,10039,10040,7,1,-6
10040,10040,10041,1,8,7
10041,10041,10042,8,3,-5
10042,10042,10043,3,9,6
10043,10043,10044,9,6,-3
10044,10044,10045,6,0,-6
10045,10045,10046,0,7,7
10046,10046,10047,7,9,2
10047,10047,10048,9,1,-8
10048,10048,10049,1,5,4
10049,10049,10050,5,7,2
10050,10050,10051,7,5,-2
10051,10051,10052,5,3,-2
10052,10052,10053,3,6,3
10053,10053,10054,6,8,2
10054,10054,10055,8,9,1
10055,10055,10056,9,5,-4
10056,10056,10057,5,8,3
10057,10057,10058,8,1,-7
10058,10058,10059,1,9,8
10059,10059,10060,9,4,-5
10060,10060,10061,4,8,4
10061,10061,10062,8,5,-3
10062,10062,10063,5,7,2
10063,10063,10064,7,8,1
10064,10064,10065,8,5,-3
10065,10065,10066,5,8,3
10066,10066,10067,8,1,-7
10067,10067,10068,1,1,0
10068,10068,10069,1,0,-1
10069,10069,10070,0,9,9
10070,10070,10071,9,0,-9
10071,10071,10072,0,2,2
10072,10072,10073,2,2,0
10073,10073,10074,2,3,1
10074,10074,10075,3,2,-1
10075,10075,10076,2,6,4
10076,10076,10077,6,7,1
10077,10077,10078,7,2,-5
10078,10078,10079,2,8,6
10079,10079,10080,8,0,-8
10080,10080,10081,0,2,2
10081,10081,10082,2,2,0
10082,10082,10083,2,0,-2
10083,10083,10084,0,2,2
10084,10084,10085,2,1,-1
10085,10085,10086,1,7,6
10086,10086,10087,7,2,-5
10087,10087,10088,2,9,7
10088,10088,10089,9,6,-3
10089,10089,10090,6,2,-4
10090,10090,10091,2,3,1
10091,10091,10092,3,5,2
10092,10092,10093,5,3,-2
10093,10093,10094,3,9,6
10094,10094,10095,9,7,-2
10095,10095,10096,7,7,0
10096,10096,10097,7,3,-4
10097,10097,10098,3,1,-2
10098,10098,10099,1,3,2
10099,10099,10100,3,2,-1
10100,10100,10101,2,6,4
10101,10101,10102,6,9,3
10102,10102,10103,9,4,-5
10103,10103,10104,4,4,0
10104,10104,10105,4,9,5
10105,10105,10106,9,2,-7
10106,10106,10107,2,0,-2
10107,10107,10108,0,6,6
10108,10108,10109,6,9,3
10109,10109,10110,9,1,-8
10110,10110,10111,1,5,4
10111,10111,10112,5,9,4
10112,10112,10113,9,2,-7
10113,10113,10114,2,4,2
10114,10114,10115,4,8,4
10115,10115,10116,8,3,-5
10116,10116,10117,3,2,-1
10117,10117,10118,2,1,-1
10118,10118,10119,1,0,-1
10119,10119,10120,0,0,0
10120,10120,10121,0,0,0
10121,10121,10122,0,2,2
10122,10122,10123,2,1,-1
10123,10123,10124,1,8,7
10124,10124,10125,8,3,-5
10125,10125,10126,3,8,5
10126,10126,10127,8,2,-6
10127,10127,10128,2,0,-2
10128,10128,10129,0,1,1
10129,10129,10130,1,2,1
10130,10130,10131,2,7,5
10131,10131,10132,7,9,2
10132,10132,10133,9,4,-5
10133,10133,10134,4,1,-3
10134,10134,10135,1,6,5
10135,10135,10136,6,1,-5
10136,10136,10137,1,3,2
10137,10137,10138,3,2,-1
10138,10138,10139,2,1,-1
10139,10139,10140,1,0,-1
10140,10140,10141,0,3,3
10141,10141,10142,3,9,6
10142,10142,10143,9,9,0
10143,10143,10144,9,3,-6
10144,10144,10145,3,1,-2
10145,10145,10146,1,5,4
10146,10146,10147,5,7,2
10147,10147,10148,7,7,0
10148,10148,10149,7,6,-1
10149,10149,10150,6,4,-2
10150,10150,10151,4,8,4
10151,10151,10152,8,1,-7
10152,10152,10153,1,4,3
10153,10153,10154,4,7,3
10154,10154,10155,7,3,-4
10155,10155,10156,3,1,-2
10156,10156,10157,1,1,0
10157,10157,10158,1,2,1
10158,10158,10159,2,4,2
10159,10159,10160,4,7,3
10160,10160,10161,7,3,-4
10161,10161,10162,3,5,2
10162,10162,10163,5,6,1
10163,10163,10164,6,6,0
10164,10164,10165,6,9,3
10165,10165,10166,9,9,0
10166,10166,10167,9,0,-9
10167,10167,10168,0,0,0
10168,10168,10169,0,1,1
10169,10169,10170,1,7,6
10170,10170,10171,7,7,0
10171,10171,10172,7,4,-3
10172,10172,10173,4,5,1
10173,10173,10174,5,6,1
10174,10174,10175,6,4,-2
10175,10175,10176,4,0,-4
10176,10176,10177,0,4,4
10177,10177,10178,4,7,3
10178,10178,10179,7,7,0
10179,10179,10180,7,1,-6
10180,10180,10181,1,7,6
10181,10181,10182,7,5,-2
10182,10182,10183,5,9,4
10183,10183,10184,9,9,0
10184,10184,10185,9,5,-4
10185,10185,10186,5,9,4
10186,10186,10187,9,8,-1
10187,10187,10188,8,0,-8
10188,10188,10189,0,8,8
10189,10189,10190,8,6,-2
10190,10190,10191,6,4,-2
10191,10191,10192,4,5,1
10192,10192,10193,5,9,4
10193,10193,10194,9,2,-7
10194,10194,10195,2,0,-2
10195,10195,10196,0,4,4
10196,10196,10197,4,8,4
10197,10197,10198,8,9,1
10198,10198,10199,9,9,0
10199,10199,10200,9,2,-7
10200,10200,10201,2,8,6
10201,10201,10202,8,7,-1
10202,10202,10203,7,0,-7
10203,10203,10204,0,0,0
10204,10204,10205,0,1,1
10205,10205,10206,1,3,2
10206,10206,10207,3,2,-1
10207,10207,10208,2,9,7
10208,10208,10209,9,4,-5
10209,10209,10210,4,3,-1
10210,10210,10211,3,5,2
10211,10211,10212,5,4,-1
10212,10212,10213,4,6,2
10213,10213,10214,6,3,-3
10214,10214,10215,3,7,4
10215,10215,10216,7,4,-3
10216,10216,10217,4,8,4
10217,10217,10218,8,6,-2
10218,10218,10219,6,9,3
10219,10219,10220,9,1,-8
10220,10220,10221,1,0,-1
10221,10221,10222,0,8,8
10222,10222,10223,8,1,-7
10223,10223,10224,1,6,5
10224,10224,10225,6,4,-2
10225,10225,10226,4,5,1
10226,10226,10227,5,5,0
10227,10227,10228,5,2,-3
10228,10228,10229,2,6,4
10229,10229,10230,6,0,-6
10230,10230,10231,0,7,7
10231,10231,10232,7,9,2
10232,10232,10233,9,8,-1
10233,10233,10234,8,6,-2
10234,10234,10235,6,9,3
10235,10235,10236,9,4,-5
10236,10236,10237,4,0,-4
10237,10237,10238,0,3,3
10238,10238,10239,3,1,-2
10239,10239,10240,1,0,-1
10240,10240,10241,0,4,4
10241,10241,10242,4,0,-4
10242,10242,10243,0,7,7
10243,10243,10244,7,5,-2
10244,10244,10245,5,0,-5
10245,10245,10246,0,6,6
10246,10246,10247,6,9,3
10247,10247,10248,9,1,-8
10248,10248,10249,1,9,8
10249,10249,10250,9,8,-1
10250,10250,10251,8,7,-1
10251,10251,10252,7,4,-3
10252,10252,10253,4,7,3
10253,10253,10254,7,0,-7
10254,10254,10255,0,5,5
10255,10255,10256,5,2,-3
10256,10256,10257,2,1,-1
10257,10257,10258,1,5,4
10258,10258,10259,5,0,-5
10259,10259,10260,0,3,3
10260,10260,10261,3,0,-3
10261,10261,10262,0,4,4
10262,10262,10263,4,7,3
10263,10263,10264,7,2,-5
10264,10264,10265,2,0,-2
10265,10265,10266,0,1,1
10266,10266,10267,1,1,0
10267,10267,10268,1,1,0
10268,10268,10269,1,4,3
10269,10269,10270,4,6,2
10270,10270,10271,6,6,0
10271,10271,10272,6,0,-6
10272,10272,10273,0,6,6
10273,10273,10274,6,8,2
10274,10274,10275,8,6,-2
10275,10275,10276,6,0,-6
10276,10276,10277,0,5,5
10277,10277,10278,5,3,-2
10278,10278,10279,3,2,-1
10279,10279,10280,2,5,3
10280,10280,10281,5,8,3
10281,10281,10282,8,3,-5
10282,10282,10283,3,0,-3
10283,10283,10284,0,9,9
10284,10284,10285,9,1,-8
10285,10285,10286,1,5,4
10286,10286,10287,5,7,2
10287,10287,10288,7,5,-2
10288,10288,10289,5,6,1
10289,10289,10290,6,1,-5
10290,10290,10291,1,2,1
10291,10291,10292,2,9,7
10292,10292,10293,9,1,-8
10293,10293,10294,1,6,5
10294,10294,10295,6,7,1
10295,10295,10296,7,7,0
10296,10296,10297,7,7,0
10297,10297,10298,7,6,-1
10298,10298,10299,6,6,0
10299,10299,10300,6,2,-4
10300,10300,10301,2,1,-1
10301,10301,10302,1,7,6
10302,10302,10303,7,4,-3
10303,10303,10304,4,6,2
10304,10304,10305,6,9,3
10305,10305,10306,9,9,0
10306,10306,10307,9,6,-3
10307,10307,10308,6,2,-4
10308,10308,10309,2,7,5
10309,10309,10310,7,4,-3
10310,10310,10311,4,4,0
10311,10311,10312,4,2,-2
10312,10312,10313,2,4,2
10313,10313,10314,4,3,-1
10314,10314,10315,3,7,4
10315,10315,10316,7,5,-2
10316,10316,10317,5,2,-3
10317,10317,10318,2,1,-1
10318,10318,10319,1,8,7
10319,10319,10320,8,4,-4
10320,10320,10321,4,2,-2
10321,10321,10322,2,3,1
10322,10322,10323,3,0,-3
10323,10323,10324,0,7,7
10324,10324,10325,7,1,-6
10325,10325,10326,1,0,-1
10326,10326,10327,0,2,2
10327,10327,10328,2,3,1
10328,10328,10329,3,3,0
10329,10329,10330,3,3,0
10330,10330,10331,3,4,1
10331,10331,10332,4,6,2
10332,10332,10333,6,5,-1
10333,10333,10334,5,0,-5
10334,10334,10335,0,6,6
10335,10335,10336,6,9,3
10336,10336,10337,9,7,-2
10337,10337,10338,7,4,-3
10338,10338,10339,4,8,4
10339,10339,10340,8,0,-8
10340,10340,10341,0,9,9
10341,10341,10342,9,1,-8
10342,10342,10343,1,0,-1
10343,10343,10344,0,6,6
10344,10344,10345,6,1,-5
10345,10345,10346,1,1,0
10346,10346,10347,1,2,1
10347,10347,10348,2,0,-2
10348,10348,10349,0,3,3
10349,10349,10350,3,4,1
10350,10350,10351,4,4,0
10351,10351,10352,4,0,-4
10352,10352,10353,0,5,5
10353,10353,10354,5,2,-3
10354,10354,10355,2,6,4
10355,10355,10356,6,6,0
10356,10356,10357,6,7,1
10357,10357,10358,7,8,1
10358,10358,10359,8,8,0
10359,10359,10360,8,3,-5
10360,10360,10361,3,9,6
10361,10361,10362,9,1,-8
10362,10362,10363,1,0,-1
10363,10363,10364,0,1,1
10364,10364,10365,1,1,0
10365,10365,10366,1,0,-1
10366,10366,10367,0,2,2
10367,10367,10368,2,2,0
10368,10368,10369,2,3,1
10369,10369,10370,3,5,2
10370,10370,10371,5,4,-1
10371,10371,10372,4,0,-4
10372,10372,10373,0,5,5
10373,10373,10374,5,9,4
10374,10374,10375,9,6,-3
10375,10375,10376,6,1,-5
10376,10376,10377,1,7,6
10377,10377,10378,7,1,-6
10378,10378,10379,1,8,7
10379,10379,10380,8,0,-8
10380,10380,10381,0,9,9
10381,10381,10382,9,9,0
10382,10382,10383,9,6,-3
10383,10383,10384,6,0,-6
10384,10384,10385,0,5,5
10385,10385,10386,5,5,0
10386,10386,10387,5,9,4
10387,10387,10388,9,7,-2
10388,10388,10389,7,3,-4
10389,10389,10390,3,3,0
10390,10390,10391,3,4,1
10391,10391,10392,4,7,3
10392,10392,10393,7,3,-4
10393,10393,10394,3,7,4
10394,10394,10395,7,8,1
10395,10395,10396,8,4,-4
10396,10396,10397,4,5,1
10397,10397,10398,5,8,3
10398,10398,10399,8,1,-7
10399,10399,10400,1,5,4
10400,10400,10401,5,5,0
10401,10401,10402,5,3,-2
10402,10402,10403,3,2,-1
10403,10403,10404,2,1,-1
10404,10404,10405,1,3,2
10405,10405,10406,3,2,-1
10406,10406,10407,2,0,-2
10407,10407,10408,0,7,7
10408,10408,10409,7,1,-6
10409,10409,10410,1,9,8
10410,10410,10411,9,2,-7
10411,10411,10412,2,5,3
10412,10412,10413,5,1,-4
10413,10413,10414,1,9,8
10414,10414,10415,9,3,-6
10415,10415,10416,3,1,-2
10416,10416,10417,1,2,1
10417,10417,10418,2,6,4
10418,10418,10419,6,6,0
10419,10419,10420,6,1,-5
10420,10420,10421,1,5,4
10421,10421,10422,5,8,3
10422,10422,10423,8,3,-5
10423,10423,10424,3,3,0
10424,10424,10425,3,0,-3
10425,10425,10426,0,8,8
10426,10426,10427,8,7,-1
10427,10427,10428,7,9,2
10428,10428,10429,9,2,-7
10429,10429,10430,2,3,1
10430,10430,10431,3,7,4
10431,10431,10432,7,5,-2
10432,10432,10433,5,4,-1
10433,10433,10434,4,5,1
10434,10434,10435,5,6,1
10435,10435,10436,6,2,-4
10436,10436,10437,2,4,2
10437,10437,10438,4,9,5
10438,10438,10439,9,0,-9
10439,10439,10440,0,6,6
10440,10440,10441,6,5,-1
10441,10441,10442,5,6,1
10442,10442,10443,6,9,3
10443,10443,10444,9,8,-1
10444,10444,10445,8,9,1
10445,10445,10446,9,8,-1
10446,10446,10447,8,8,0
10447,10447,10448,8,1,-7
10448,10448,10449,1,9,8
10449,10449,10450,9,3,-6
10450,10450,10451,3,5,2
10451,10451,10452,5,6,1
10452,10452,10453,6,3,-3
10453,10453,10454,3,3,0
10454,10454,10455,3,1,-2
10455,10455,10456,1,0,-1
10456,10456,10457,0,7,7
10457,10457,10458,7,1,-6
10458,10458,10459,1,4,3
10459,10459,10460,4,4,0
10460,10460,10461,4,7,3
10461,10461,10462,7,4,-3
10462,10462,10463,4,6,2
10463,10463,10464,6,2,-4
10464,10464,10465,2,5,3
10465,10465,10466,5,3,-2
10466,10466,10467,3,4,1
10467,10467,10468,4,1,-3
10468,10468,10469,1,0,-1
10469,10469,10470,0,3,3
10470,10470,10471,3,0,-3
10471,10471,10472,0,2,2
10472,10472,10473,2,6,4
10473,10473,10474,6,7,1
10474,10474,10475,7,6,-1
10475,10475,10476,6,2,-4
10476,10476,10477,2,2,0
10477,10477,10478,2,9,7
10478,10478,10479,9,0,-9
10479,10479,10480,0,9,9
10480,10480,10481,9,6,-3
10481,10481,10482,6,8,2
10482,10482,10483,8,3,-5
10483,10483,10484,3,6,3
10484,10484,10485,6,7,1
10485,10485,10486,7,8,1
10486,10486,10487,8,7,-1
10487,10487,10488,7,0,-7
10488,10488,10489,0,4,4
10489,10489,10490,4,8,4
10490,10490,10491,8,4,-4
10491,10491,10492,4,5,1
10492,10492,10493,5,3,-2
10493,10493,10494,3,4,1
10494,10494,10495,4,9,5
10495,10495,10496,9,7,-2
10496,10496,10497,7,2,-5
10497,10497,10498,2,5,3
10498,10498,10499,5,8,3
10499,10499,10500,8,1,-7
10500,10500,10501,1,9,8
10501,10501,10502,9,2,-7
10502,10502,10503,2,6,4
10503,10503,10504,6,4,-2
10504,10504,10505,4,0,-4
10505,10505,10506,0,5,5
10506,10506,10507,5,9,4
10507,10507,10508,9,1,-8
10508,10508,10509,1,5,4
10509,10509,10510,5,7,2
10510,10510,10511,7,3,-4
10511,10511,10512,3,6,3
10512,10512,10513,6,8,2
10513,10513,10514,8,2,-6
10514,10514,10515,2,8,6
10515,10515,10516,8,9,1
10516,10516,10517,9,7,-2
10517,10517,10518,7,3,-4
10518,10518,10519,3,1,-2
10519,10519,10520,1,3,2
10520,10520,10521,3,4,1
10521,10521,10522,4,7,3
10522,10522,10523,7,0,-7
10523,10523,10524,0,9,9
10524,10524,10525,9,4,-5
10525,10525,10526,4,2,-2
10526,10526,10527,2,3,1
10527,10527,10528,3,2,-1
10528,10528,10529,2,9,7
10529,10529,10530,9,0,-9
10530,10530,10531,0,0,0
10531,10531,10532,0,6,6
10532,10532,10533,6,7,1
10533,10533,10534,7,6,-1
10534,10534,10535,6,2,-4
10535,10535,10536,2,5,3
10536,10536,10537,5,1,-4
10537,10537,10538,1,5,4
10538,10538,10539,5,9,4
10539,10539,10540,9,6,-3
10540,10540,10541,6,1,-5
10541,10541,10542,1,0,-1
10542,10542,10543,0,5,5
10543,10543,10544,5,7,2
10544,10544,10545,7,1,-6
10545,10545,10546,1,5,4
10546,10546,10547,5,7,2
10547,10547,10548,7,7,0
10548,10548,10549,7,4,-3
10549,10549,10550,4,6,2
10550,10550,10551,6,8,2
10551,10551,10552,8,6,-2
10552,10552,10553,6,6,0
10553,10553,10554,6,2,-4
10554,10554,10555,2,1,-1
10555,10555,10556,1,1,0
10556,10556,10557,1,6,5
10557,10557,10558,6,4,-2
10558,10558,10559,4,8,4
10559,10559,10560,8,4,-4
10560,10560,10561,4,8,4
10561,10561,10562,8,1,-7
10562,10562,10563,1,0,-1
10563,10563,10564,0,0,0
10564,10564,10565,0,1,1
10565,10565,10566,1,5,4
10566,10566,10567,5,2,-3
10567,10567,10568,2,1,-1
10568,10568,10569,1,3,2
10569,10569,10570,3,2,-1
10570,10570,10571,2,4,2
10571,10571,10572,4,8,4
10572,10572,10573,8,7,-1
10573,10573,10574,7,2,-5
10574,10574,10575,2,8,6
10575,10575,10576,8,9,1
10576,10576,10577,9,9,0
10577,10577,10578,9,5,-4
10578,10578,10579,5,0,-5
10579,10579,10580,0,1,1
10580,10580,10581,1,1,0
10581,10581,10582,1,2,1
10582,10582,10583,2,2,0
10583,10583,10584,2,8,6
10584,10584,10585,8,3,-5
10585,10585,10586,3,5,2
10586,10586,10587,5,4,-1
10587,10587,10588,4,9,5
10588,10588,10589,9,5,-4
10589,10589,10590,5,7,2
10590,10590,10591,7,6,-1
10591,10591,10592,6,8,2
10592,10592,10593,8,7,-1
10593,10593,10594,7,4,-3
10594,10594,10595,4,8,4
10595,10595,10596,8,8,0
10596,10596,10597,8,9,1
10597,10597,10598,9,5,-4
10598,10598,10599,5,0,-5
10599,10599,10600,0,6,6
10600,10600,10601,6,1,-5
10601,10601,10602,1,1,0
10602,10602,10603,1,2,1
10603,10603,10604,2,0,-2
10604,10604,10605,0,3,3
10605,10605,10606,3,3,0
10606,10606,10607,3,4,1
10607,10607,10608,4,3,-1
10608,10608,10609,3,7,4
10609,10609,10610,7,5,-2
10610,10610,10611,5,8,3
10611,10611,10612,8,4,-4
10612,10612,10613,4,9,5
10613,10613,10614,9,9,0
10614,10614,10615,9,1,-8
10615,10615,10616,1,2,1
10616,10616,10617,2,6,4
10617,10617,10618,6,4,-2
10618,10618,10619,4,8,4
10619,10619,10620,8,2,-6
10620,10620,10621,2,9,7
10621,10621,10622,9,5,-4
10622,10622,10623,5,9,4
10623,10623,10624,9,1,-8
10624,10624,10625,1,0,-1
10625,10625,10626,0,4,4
10626,10626,10627,4,1,-3
10627,10627,10628,1,8,7
10628,10628,10629,8,2,-6
10629,10629,10630,2,6,4
10630,10630,10631,6,4,-2
10631,10631,10632,4,8,4
10632,10632,10633,8,4,-4
10633,10633,10634,4,4,0
10634,10634,10635,4,3,-1
10635,10635,10636,3,4,1
10636,10636,10637,4,7,3
10637,10637,10638,7,1,-6
10638,10638,10639,1,4,3
10639,10639,10640,4,7,3
10640,10640,10641,7,4,-3
10641,10641,10642,4,4,0
10642,10642,10643,4,4,0
10643,10643,10644,4,3,-1
10644,10644,10645,3,0,-3
10645,10645,10646,0,9,9
10646,10646,10647,9,3,-6
10647,10647,10648,3,7,4
10648,10648,10649,7,8,1
10649,10649,10650,8,6,-2
10650,10650,10651,6,7,1
10651,10651,10652,7,5,-2
10652,10652,10653,5,5,0
10653,10653,10654,5,6,1
10654,10654,10655,6,8,2
10655,10655,10656,8,5,-3
10656,10656,10657,5,2,-3
10657,10657,10658,2,9,7
10658,10658,10659,9,1,-8
10659,10659,10660,1,9,8
10660,10660,10661,9,5,-4
10661,10661,10662,5,1,-4
10662,10662,10663,1,8,7
10663,10663,10664,8,0,-8
10664,10664,10665,0,5,5
10665,10665,10666,5,3,-2
10666,10666,10667,3,1,-2
10667,10667,10668,1,3,2
10668,10668,10669,3,1,-2
10669,10669,10670,1,4,3
10670,10670,10671,4,6,2
10671,10671,10672,6,6,0
10672,10672,10673,6,2,-4
10673,10673,10674,2,3,1
10674,10674,10675,3,1,-2
10675,10675,10676,1,3,2
10676,10676,10677,3,3,0
10677,10677,10678,3,3,0
10678,10678,10679,3,4,1
10679,10679,10680,4,2,-2
10680,10680,10681,2,9,7
10681,10681,10682,9,7,-2
10682,10682,10683,7,4,-3
10683,10683,10684,4,1,-3
10684,10684,10685,1,9,8
10685,10685,10686,9,1,-8
10686,10686,10687,1,2,1
10687,10687,10688,2,2,0
10688,10688,10689,2,0,-2
10689,10689,10690,0,4,4
10690,10690,10691,4,0,-4
10691,10691,10692,0,1,1
10692,10692,10693,1,4,3
10693,10693,10694,4,8,4
10694,10694,10695,8,4,-4
10695,10695,10696,4,3,-1
10696,10696,10697,3,6,3
10697,10697,10698,6,6,0
10698,10698,10699,6,2,-4
10699,10699,10700,2,0,-2
10700,10700,10701,0,5,5
10701,10701,10702,5,7,2
10702,10702,10703,7,5,-2
10703,10703,10704,5,4,-1
10704,10704,10705,4,0,-4
10705,10705,10706,0,9,9
10706,10706,10707,9,2,-7
10707,10707,10708,2,7,5
10708,10708,10709,7,6,-1
10709,10709,10710,6,8,2
10710,10710,10711,8,8,0
10711,10711,10712,8,1,-7
10712,10712,10713,1,1,0
10713,10713,10714,1,2,1
10714,10714,10715,2,7,5
10715,10715,10716,7,7,0
10716,10716,10717,7,9,2
10717,10717,10718,9,7,-2
10718,10718,10719,7,1,-6
10719,10719,10720,1,8,7
10720,10720,10721,8,9,1
10721,10721,10722,9,9,0
10722,10722,10723,9,2,-7
10723,10723,10724,2,4,2
10724,10724,10725,4,6,2
10725,10725,10726,6,8,2
10726,10726,10727,8,7,-1
10727,10727,10728,7,3,-4
10728,10728,10729,3,6,3
10729,10729,10730,6,3,-3
10730,10730,10731,3,6,3
10731,10731,10732,6,0,-6
10732,10732,10733,0,8,8
10733,10733,10734,8,3,-5
10734,10734,10735,3,7,4
10735,10735,10736,7,4,-3
10736,10736,10737,4,4,0
10737,10737,10738,4,8,4
10738,10738,10739,8,2,-6
10739,10739,10740,2,5,3
10740,10740,10741,5,1,-4
10741,10741,10742,1,5,4
10742,10742,10743,5,3,-2
10743,10743,10744,3,7,4
10744,10744,10745,7,3,-4
10745,10745,10746,3,9,6
10746,10746,10747,9,0,-9
10747,10747,10748,0,6,6
10748,10748,10749,6,5,-1
10749,10749,10750,5,0,-5
10750,10750,10751,0,5,5
10751,10751,10752,5,9,4
10752,10752,10753,9,8,-1
10753,10753,10754,8,6,-2
10754,10754,10755,6,0,-6
10755,10755,10756,0,3,3
10756,10756,10757,3,3,0
10757,10757,10758,3,4,1
10758,10758,10759,4,7,3
10759,10759,10760,7,3,-4
10760,10760,10761,3,9,6
10761,10761,10762,9,3,-6
10762,10762,10763,3,7,4
10763,10763,10764,7,5,-2
10764,10764,10765,5,3,-2
10765,10765,10766,3,2,-1
10766,10766,10767,2,6,4
10767,10767,10768,6,4,-2
10768,10768,10769,4,7,3
10769,10769,10770,7,5,-2
10770,10770,10771,5,8,3
10771,10771,10772,8,9,1
10772,10772,10773,9,0,-9
10773,10773,10774,0,6,6
10774,10774,10775,6,3,-3
10775,10775,10776,3,2,-1
10776,10776,10777,2,5,3
10777,10777,10778,5,4,-1
10778,10778,10779,4,3,-1
10779,10779,10780,3,9,6
10780,10780,10781,9,0,-9
10781,10781,10782,0,5,5
10782,10782,10783,5,1,-4
10783,10783,10784,1,9,8
10784,10784,10785,9,2,-7
10785,10785,10786,2,6,4
10786,10786,10787,6,3,-3
10787,10787,10788,3,7,4
10788,10788,10789,7,4,-3
10789,10789,10790,4,6,2
10790,10790,10791,6,5,-1
10791,10791,10792,5,6,1
10792,10792,10793,6,6,0
10793,10793,10794,6,9,3
10794,10794,10795,9,7,-2
10795,10795,10796,7,3,-4
10796,10796,10797,3,8,5
10797,10797,10798,8,5,-3
10798,10798,10799,5,9,4
10799,10799,10800,9,8,-1
10800,10800,10801,8,0,-8
10801,10801,10802,0,2,2
10802,10802,10803,2,1,-1
10803,10803,10804,1,5,4
10804,10804,10805,5,2,-3
10805,10805,10806,2,0,-2
10806,10806,10807,0,3,3
10807,10807,10808,3,9,6
10808,10808,10809,9,4,-5
10809,10809,10810,4,9,5
10810,10810,10811,9,5,-4
10811,10811,10812,5,4,-1
10812,10812,10813,4,6,2
10813,10813,10814,6,5,-1
10814,10814,10815,5,7,2
10815,10815,10816,7,6,-1
10816,10816,10817,6,8,2
10817,10817,10818,8,8,0
10818,10818,10819,8,9,1
10819,10819,10820,9,9,0
10820,10820,10821,9,0,-9
10821,10821,10822,0,5,5
10822,10822,10823,5,1,-4
10823,10823,10824,1,2,1
10824,10824,10825,2,2,0
10825,10825,10826,2,3,1
10826,10826,10827,3,3,0
10827,10827,10828,3,7,4
10828,10828,10829,7,4,-3
10829,10829,10830,4,3,-1
10830,10830,10831,3,5,2
10831,10831,10832,5,4,-1
10832,10832,10833,4,6,2
10833,10833,10834,6,1,-5
10834,10834,10835,1,7,6
10835,10835,10836,7,6,-1
10836,10836,10837,6,8,2
10837,10837,10838,8,1,-7
10838,10838,10839,1,9,8
10839,10839,10840,9,0,-9
10840,10840,10841,0,7,7
10841,10841,10842,7,1,-6
10842,10842,10843,1,6,5
10843,10843,10844,6,0,-6
10844,10844,10845,0,4,4
10845,10845,10846,4,2,-2
10846,10846,10847,2,3,1
10847,10847,10848,3,9,6
10848,10848,10849,9,0,-9
10849,10849,10850,0,4,4
10850,10850,10851,4,6,2
10851,10851,10852,6,1,-5
10852,10852,10853,1,6,5
10853,10853,10854,6,4,-2
10854,10854,10855,4,6,2
10855,10855,10856,6,8,2
10856,10856,10857,8,9,1
10857,10857,10858,9,4,-5
10858,10858,10859,4,0,-4
10859,10859,10860,0,9,9
10860,10860,10861,9,0,-9
10861,10861,10862,0,8,8
10862,10862,10863,8,1,-7
10863,10863,10864,1,7,6
10864,10864,10865,7,3,-4
10865,10865,10866,3,8,5
10866,10866,10867,8,9,1
10867,10867,10868,9,1,-8
10868,10868,10869,1,4,3
10869,10869,10870,4,4,0
10870,10870,10871,4,5,1
10871,10871,10872,5,3,-2
10872,10872,10873,3,7,4
10873,10873,10874,7,0,-7
10874,10874,10875,0,9,9
10875,10875,10876,9,3,-6
10876,10876,10877,3,5,2
10877,10877,10878,5,1,-4
10878,10878,10879,1,6,5
10879,10879,10880,6,3,-3
10880,10880,10881,3,8,5
10881,10881,10882,8,3,-5
10882,10882,10883,3,9,6
10883,10883,10884,9,5,-4
10884,10884,10885,5,1,-4
10885,10885,10886,1,1,0
10886,10886,10887,1,3,2
10887,10887,10888,3,4,1
10888,10888,10889,4,8,4
10889,10889,10890,8,7,-1
10890,10890,10891,7,5,-2
10891,10891,10892,5,1,-4
10892,10892,10893,1,7,6
10893,10893,10894,7,5,-2
10894,10894,10895,5,8,3
10895,10895,10896,8,3,-5
10896,10896,10897,3,1,-2
10897,10897,10898,1,2,1
10898,10898,10899,2,4,2
10899,10899,10900,4,3,-1
10900,10900,10901,3,8,5
10901,10901,10902,8,3,-5
10902,10902,10903,3,5,2
10903,10903,10904,5,5,0
10904,10904,10905,5,8,3
10905,10905,10906,8,9,1
10906,10906,10907,9,1,-8
10907,10907,10908,1,4,3
10908,10908,10909,4,0,-4
10909,10909,10910,0,6,6
10910,10910,10911,6,7,1
10911,10911,10912,7,4,-3
10912,10912,10913,4,6,2
10913,10913,10914,6,0,-6
10914,10914,10915,0,1,1
10915,10915,10916,1,0,-1
10916,10916,10917,0,6,6
10917,10917,10918,6,4,-2
10918,10918,10919,4,0,-4
10919,10919,10920,0,2,2
10920,10920,10921,2,3,1
10921,10921,10922,3,1,-2
10922,10922,10923,1,4,3
10923,10923,10924,4,0,-4
10924,10924,10925,0,6,6
10925,10925,10926,6,1,-5
10926,10926,10927,1,8,7
10927,10927,10928,8,4,-4
10928,10928,10929,4,9,5
10929,10929,10930,9,6,-3
10930,10930,10931,6,2,-4
10931,10931,10932,2,7,5
10932,10932,10933,7,1,-6
10933,10933,10934,1,9,8
10934,10934,10935,9,7,-2
10935,10935,10936,7,8,1
10936,10936,10937,8,4,-4
10937,10937,10938,4,0,-4
10938,10938,10939,0,5,5
10939,10939,10940,5,7,2
10940,10940,10941,7,2,-5
10941,10941,10942,2,4,2
10942,10942,10943,4,5,1
10943,10943,10944,5,9,4
10944,10944,10945,9,2,-7
10945,10945,10946,2,7,5
10946,10946,10947,7,1,-6
10947,10947,10948,1,8,7
10948,10948,10949,8,2,-6
10949,10949,10950,2,6,4
10950,10950,10951,6,9,3
10951,10951,10952,9,4,-5
10952,10952,10953,4,3,-1
10953,10953,10954,3,5,2
10954,10954,10955,5,9,4
10955,10955,10956,9,6,-3
10956,10956,10957,6,2,-4
10957,10957,10958,2,5,3
10958,10958,10959,5,2,-3
10959,10959,10960,2,4,2
10960,10960,10961,4,5,1
10961,10961,10962,5,2,-3
10962,10962,10963,2,8,6
10963,10963,10964,8,4,-4
10964,10964,10965,4,7,3
10965,10965,10966,7,3,-4
10966,10966,10967,3,4,1
10967,10967,10968,4,6,2
10968,10968,10969,6,7,1
10969,10969,10970,7,9,2
10970,10970,10971,9,1,-8
10971,10971,10972,1,2,1
10972,10972,10973,2,8,6
10973,10973,10974,8,0,-8
10974,10974,10975,0,0,0
10975,10975,10976,0,6,6
10976,10976,10977,6,9,3
10977,10977,10978,9,2,-7
10978,10978,10979,2,6,4
10979,10979,10980,6,6,0
10980,10980,10981,6,8,2
10981,10981,10982,8,1,-7
10982,10982,10983,1,1,0
10983,10983,10984,1,3,2
10984,10984,10985,3,1,-2
10985,10985,10986,1,7,6
10986,10986,10987,7,5,-2
10987,10987,10988,5,2,-3
10988,10988,10989,2,7,5
10989,10989,10990,7,4,-3
10990,10990,10991,4,6,2
10991,10991,10992,6,0,-6
10992,10992,10993,0,3,3
10993,10993,10994,3,3,0
10994,10994,10995,3,5,2
10995,10995,10996,5,6,1
10996,10996,10997,6,4,-2
10997,10997,10998,4,3,-1
10998,10998,10999,3,2,-1
10999,10999,11000,2,6,4
11000,11000,11001,6,9,3
11001,11001,11002,9,3,-6
11002,11002,11003,3,0,-3
11003,11003,11004,0,1,1
11004,11004,11005,1,4,3
11005,11005,11006,4,2,-2
11006,11006,11007,2,7,5
11007,11007,11008,7,4,-3
11008,11008,11009,4,4,0
11009,11009,11010,4,3,-1
11010,11010,11011,3,3,0
11011,11011,11012,3,3,0
11012,11012,11013,3,2,-1
11013,11013,11014,2,0,-2
11014,11014,11015,0,9,9
11015,11015,11016,9,4,-5
11016,11016,11017,4,2,-2
11017,11017,11018,2,2,0
11018,11018,11019,2,0,-2
11019,11019,11020,0,7,7
11020,11020,11021,7,3,-4
11021,11021,11022,3,0,-3
11022,11022,11023,0,4,4
11023,11023,11024,4,4,0
11024,11024,11025,4,5,1
11025,11025,11026,5,0,-5
11026,11026,11027,0,0,0
11027,11027,11028,0,8,8
11028,11028,11029,8,0,-8
11029,11029,11030,0,2,2
11030,11030,11031,2,3,1
11031,11031,11032,3,2,-1
11032,11032,11033,2,2,0
11033,11033,11034,2,3,1
11034,11034,11035,3,8,5
11035,11035,11036,8,0,-8
11036,11036,11037,0,3,3
11037,11037,11038,3,6,3
11038,11038,11039,6,3,-3
11039,11039,11040,3,4,1
11040,11040,11041,4,0,-4
11041,11041,11042,0,3,3
11042,11042,11043,3,1,-2
11043,11043,11044,1,4,3
11044,11044,11045,4,0,-4
11045,11045,11046,0,4,4
11046,11046,11047,4,1,-3
11047,11047,11048,1,6,5
11048,11048,11049,6,7,1
11049,11049,11050,7,1,-6
11050,11050,11051,1,1,0
11051,11051,11052,1,0,-1
11052,11052,11053,0,3,3
11053,11053,11054,3,7,4
11054,11054,11055,7,5,-2
11055,11055,11056,5,7,2
11056,11056,11057,7,1,-6
11057,11057,11058,1,1,0
11058,11058,11059,1,7,6
11059,11059,11060,7,0,-7
11060,11060,11061,0,1,1
11061,11061,11062,1,6,5
11062,11062,11063,6,8,2
11063,11063,11064,8,5,-3
11064,11064,11065,5,6,1
11065,11065,11066,6,2,-4
11066,11066,11067,2,8,6
11067,11067,11068,8,9,1
11068,11068,11069,9,1,-8
11069,11069,11070,1,8,7
11070,11070,11071,8,0,-8
11071,11071,11072,0,0,0
11072,11072,11073,0,4,4
11073,11073,11074,4,9,5
11074,11074,11075,9,3,-6
11075,11075,11076,3,7,4
11076,11076,11077,7,0,-7
11077,11077,11078,0,9,9
11078,11078,11079,9,1,-8
11079,11079,11080,1,7,6
11080,11080,11081,7,2,-5
11081,11081,11082,2,1,-1
11082,11082,11083,1,3,2
11083,11083,11084,3,2,-1
11084,11084,11085,2,7,5
11085,11085,11086,7,2,-5
11086,11086,11087,2,8,6
11087,11087,11088,8,7,-1
11088,11088,11089,7,9,2
11089,11089,11090,9,9,0
11090,11090,11091,9,0,-9
11091,11091,11092,0,7,7
11092,11092,11093,7,1,-6
11093,11093,11094,1,5,4
11094,11094,11095,5,2,-3
11095,11095,11096,2,9,7
11096,11096,11097,9,3,-6
11097,11097,11098,3,6,3
11098,11098,11099,6,7,1
11099,11099,11100,7,6,-1
11100,11100,11101,6,8,2
11101,11101,11102,8,9,1
11102,11102,11103,9,9,0
11103,11103,11104,9,3,-6
11104,11104,11105,3,0,-3
11105,11105,11106,0,2,2
11106,11106,11107,2,1,-1
11107,11107,11108,1,8,7
11108,11108,11109,8,2,-6
11109,11109,11110,2,2,0
11110,11110,11111,2,3,1
11111,11111,11112,3,1,-2
11112,11112,11113,1,4,3
11113,11113,11114,4,3,-1
11114,11114,11115,3,5,2
11115,11115,11116,5,0,-5
11116,11116,11117,0,6,6
11117,11117,11118,6,5,-1
11118,11118,11119,5,7,2
11119,11119,11120,7,8,1
11120,11120,11121,8,8,0
11121,11121,11122,8,7,-1
11122,11122,11123,7,9,2
11123,11123,11124,9,4,-5
11124,11124,11125,4,7,3
11125,11125,11126,7,4,-3
11126,11126,11127,4,4,0
11127,11127,11128,4,6,2
11128,11128,11129,6,0,-6
11129,11129,11130,0,7,7
11130,11130,11131,7,4,-3
11131,11131,11132,4,6,2
11132,11132,11133,6,0,-6
11133,11133,11134,0,1,1
11134,11134,11135,1,1,0
11135,11135,11136,1,5,4
11136,11136,11137,5,7,2
11137,11137,11138,7,3,-4
11138,11138,11139,3,9,6
11139,11139,11140,9,6,-3
11140,11140,11141,6,5,-1
11141,11141,11142,5,8,3
11142,11142,11143,8,1,-7
11143,11143,11144,1,4,3
11144,11144,11145,4,4,0
11145,11145,11146,4,8,4
11146,11146,11147,8,2,-6
11147,11147,11148,2,4,2
11148,11148,11149,4,8,4
11149,11149,11150,8,9,1
11150,11150,11151,9,9,0
11151,11151,11152,9,1,-8
11152,11152,11153,1,4,3
11153,11153,11154,4,5,1
11154,11154,11155,5,3,-2
11155,11155,11156,3,1,-2
11156,11156,11157,1,1,0
11157,11157,11158,1,6,5
11158,11158,11159,6,7,1
11159,11159,11160,7,8,1
11160,11160,11161,8,8,0
11161,11161,11162,8,0,-8
11162,11162,11163,0,2,2
11163,11163,11164,2,7,5
11164,11164,11165,7,4,-3
11165,11165,11166,4,7,3
11166,11166,11167,7,4,-3
11167,11167,11168,4,7,3
11168,11168,11169,7,3,-4
11169,11169,11170,3,7,4
11170,11170,11171,7,3,-4
11171,11171,11172,3,0,-3
11172,11172,11173,0,6,6
11173,11173,11174,6,6,0
11174,11174,11175,6,9,3
11175,11175,11176,9,8,-1
11176,11176,11177,8,9,1
11177,11177,11178,9,1,-8
11178,11178,11179,1,5,4
11179,11179,11180,5,7,2
11180,11180,11181,7,8,1
11181,11181,11182,8,5,-3
11182,11182,11183,5,6,1
11183,11183,11184,6,4,-2
11184,11184,11185,4,7,3
11185,11185,11186,7,9,2
11186,11186,11187,9,0,-9
11187,11187,11188,0,7,7
11188,11188,11189,7,6,-1
11189,11189,11190,6,9,3
11190,11190,11191,9,8,-1
11191,11191,11192,8,9,1
11192,11192,11193,9,2,-7
11193,11193,11194,2,9,7
11194,11194,11195,9,6,-3
11195,11195,11196,6,9,3
11196,11196,11197,9,3,-6
11197,11197,11198,3,5,2
11198,11198,11199,5,9,4
11199,11199,11200,9,1,-8
11200,11200,11201,1,3,2
11201,11201,11202,3,9,6
11202,11202,11203,9,2,-7
11203,11203,11204,2,7,5
11204,11204,11205,7,1,-6
11205,11205,11206,1,9,8
11206,11206,11207,9,7,-2
11207,11207,11208,7,9,2
11208,11208,11209,9,4,-5
11209,11209,11210,4,8,4
11210,11210,11211,8,8,0
11211,11211,11212,8,9,1
11212,11212,11213,9,8,-1
11213,11213,11214,8,1,-7
11214,11214,11215,1,9,8
11215,11215,11216,9,3,-6
11216,11216,11217,3,0,-3
11217,11217,11218,0,6,6
11218,11218,11219,6,3,-3
11219,11219,11220,3,7,4
11220,11220,11221,7,3,-4
11221,11221,11222,3,0,-3
11222,11222,11223,0,9,9
11223,11223,11224,9,9,0
11224,11224,11225,9,9,0
11225,11225,11226,9,6,-3
11226,11226,11227,6,4,-2
11227,11227,11228,4,1,-3
11228,11228,11229,1,1,0
11229,11229,11230,1,2,1
11230,11230,11231,2,0,-2
11231,11231,11232,0,3,3
11232,11232,11233,3,3,0
11233,11233,11234,3,3,0
11234,11234,11235,3,7,4
11235,11235,11236,7,1,-6
11236,11236,11237,1,5,4
11237,11237,11238,5,5,0
11238,11238,11239,5,8,3
11239,11239,11240,8,0,-8
11240,11240,11241,0,8,8
11241,11241,11242,8,2,-6
11242,11242,11243,2,2,0
11243,11243,11244,2,3,1
11244,11244,11245,3,9,6
11245,11245,11246,9,9,0
11246,11246,11247,9,7,-2
11247,11247,11248,7,1,-6
11248,11248,11249,1,1,0
11249,11249,11250,1,2,1
11250,11250,11251,2,2,0
11251,11251,11252,2,9,7
11252,11252,11253,9,6,-3
11253,11253,11254,6,7,1
11254,11254,11255,7,4,-3
11255,11255,11256,4,4,0
11256,11256,11257,4,2,-2
11257,11257,11258,2,8,6
11258,11258,11259,8,3,-5
11259,11259,11260,3,5,2
11260,11260,11261,5,6,1
11261,11261,11262,6,1,-5
11262,11262,11263,1,6,5
11263,11263,11264,6,4,-2
11264,11264,11265,4,5,1
11265,11265,11266,5,7,2
11266,11266,11267,7,0,-7
11267,11267,11268,0,1,1
11268,11268,11269,1,0,-1
11269,11269,11270,0,5,5
11270,11270,11271,5,2,-3
11271,11271,11272,2,1,-1
11272,11272,11273,1,8,7
11273,11273,11274,8,7,-1
11274,11274,11275,7,1,-6
11275,11275,11276,1,9,8
11276,11276,11277,9,6,-3
11277,11277,11278,6,1,-5
11278,11278,11279,1,1,0
11279,11279,11280,1,9,8
11280,11280,11281,9,0,-9
11281,11281,11282,0,6,6
11282,11282,11283,6,4,-2
11283,11283,11284,4,3,-1
11284,11284,11285,3,3,0
11285,11285,11286,3,2,-1
11286,11286,11287,2,1,-1
11287,11287,11288,1,8,7
11288,11288,11289,8,6,-2
11289,11289,11290,6,7,1
11290,11290,11291,7,1,-6
11291,11291,11292,1,1,0
11292,11292,11293,1,9,8
11293,11293,11294,9,7,-2
11294,11294,11295,7,0,-7
11295,11295,11296,0,3,3
11296,11296,11297,3,1,-2
11297,11297,11298,1,2,1
11298,11298,11299,2,2,0
11299,11299,11300,2,9,7
11300,11300,11301,9,3,-6
11301,11301,11302,3,8,5
11302,11302,11303,8,4,-4
11303,11303,11304,4,0,-4
11304,11304,11305,0,5,5
11305,11305,11306,5,2,-3
11306,11306,11307,2,6,4
11307,11307,11308,6,1,-5
11308,11308,11309,1,7,6
11309,11309,11310,7,5,-2
11310,11310,11311,5,8,3
11311,11311,11312,8,1,-7
11312,11312,11313,1,9,8
11313,11313,11314,9,4,-5
11314,11314,11315,4,0,-4
11315,11315,11316,0,6,6
11316,11316,11317,6,1,-5
11317,11317,11318,1,0,-1
11318,11318,11319,0,2,2
11319,11319,11320,2,0,-2
11320,11320,11321,0,3,3
11321,11321,11322,3,8,5
11322,11322,11323,8,4,-4
11323,11323,11324,4,5,1
11324,11324,11325,5,5,0
11325,11325,11326,5,1,-4
11326,11326,11327,1,6,5
11327,11327,11328,6,7,1
11328,11328,11329,7,7,0
11329,11329,11330,7,0,-7
11330,11330,11331,0,8,8
11331,11331,11332,8,7,-1
11332,11332,11333,7,9,2
11333,11333,11334,9,7,-2
11334,11334,11335,7,0,-7
11335,11335,11336,0,6,6
11336,11336,11337,6,1,-5
11337,11337,11338,1,5,4
11338,11338,11339,5,2,-3
11339,11339,11340,2,0,-2
11340,11340,11341,0,3,3
11341,11341,11342,3,1,-2
11342,11342,11343,1,4,3
11343,11343,11344,4,2,-2
11344,11344,11345,2,5,3
11345,11345,11346,5,2,-3
11346,11346,11347,2,6,4
11347,11347,11348,6,6,0
11348,11348,11349,6,7,1
11349,11349,11350,7,7,0
11350,11350,11351,7,8,1
11351,11351,11352,8,1,-7
11352,11352,11353,1,9,8
11353,11353,11354,9,0,-9
11354,11354,11355,0,8,8
11355,11355,11356,8,5,-3
11356,11356,11357,5,6,1
11357,11357,11358,6,1,-5
11358,11358,11359,1,5,4
11359,11359,11360,5,1,-4
11360,11360,11361,1,0,-1
11361,11361,11362,0,1,1
11362,11362,11363,1,6,5
11363,11363,11364,6,2,-4
11364,11364,11365,2,8,6
11365,11365,11366,8,9,1
11366,11366,11367,9,9,0
11367,11367,11368,9,9,0
11368,11368,11369,9,4,-5
11369,11369,11370,4,7,3
11370,11370,11371,7,1,-6
11371,11371,11372,1,7,6
11372,11372,11373,7,9,2
11373,11373,11374,9,8,-1
11374,11374,11375,8,5,-3
11375,11375,11376,5,9,4
11376,11376,11377,9,3,-6
11377,11377,11378,3,4,1
11378,11378,11379,4,0,-4
11379,11379,11380,0,2,2
11380,11380,11381,2,4,2
11381,11381,11382,4,8,4
11382,11382,11383,8,8,0
11383,11383,11384,8,2,-6
11384,11384,11385,2,9,7
11385,11385,11386,9,6,-3
11386,11386,11387,6,1,-5
11387,11387,11388,1,9,8
11388,11388,11389,9,4,-5
11389,11389,11390,4,6,2
11390,11390,11391,6,0,-6
11391,11391,11392,0,3,3
11392,11392,11393,3,5,2
11393,11393,11394,5,2,-3
11394,11394,11395,2,1,-1
11395,11395,11396,1,5,4
11396,11396,11397,5,5,0
11397,11397,11398,5,8,3
11398,11398,11399,8,7,-1
11399,11399,11400,7,7,0
11400,11400,11401,7,6,-1
11401,11401,11402,6,5,-1
11402,11402,11403,5,0,-5
11403,11403,11404,0,1,1
11404,11404,11405,1,1,0
11405,11405,11406,1,8,7
11406,11406,11407,8,7,-1
11407,11407,11408,7,4,-3
11408,11408,11409,4,0,-4
11409,11409,11410,0,5,5
11410,11410,11411,5,6,1
11411,11411,11412,6,1,-5
11412,11412,11413,1,8,7
11413,11413,11414,8,4,-4
11414,11414,11415,4,9,5
11415,11415,11416,9,9,0
11416,11416,11417,9,5,-4
11417,11417,11418,5,1,-4
11418,11418,11419,1,4,3
11419,11419,11420,4,2,-2
11420,11420,11421,2,7,5
11421,11421,11422,7,0,-7
11422,11422,11423,0,9,9
11423,11423,11424,9,4,-5
11424,11424,11425,4,8,4
11425,11425,11426,8,7,-1
11426,11426,11427,7,6,-1
11427,11427,11428,6,0,-6
11428,11428,11429,0,0,0
11429,11429,11430,0,7,7
11430,11430,11431,7,8,1
11431,11431,11432,8,1,-7
11432,11432,11433,1,1,0
11433,11433,11434,1,4,3
11434,11434,11435,4,7,3
11435,11435,11436,7,2,-5
11436,11436,11437,2,7,5
11437,11437,11438,7,2,-5
11438,11438,11439,2,1,-1
11439,11439,11440,1,1,0
11440,11440,11441,1,3,2
11441,11441,11442,3,9,6
11442,11442,11443,9,2,-7
11443,11443,11444,2,8,6
11444,11444,11445,8,1,-7
11445,11445,11446,1,2,1
11446,11446,11447,2,4,2
11447,11447,11448,4,6,2
11448,11448,11449,6,2,-4
11449,11449,11450,2,8,6
11450,11450,11451,8,0,-8
11451,11451,11452,0,9,9
11452,11452,11453,9,0,-9
11453,11453,11454,0,3,3
11454,11454,11455,3,7,4
11455,11455,11456,7,5,-2
11456,11456,11457,5,8,3
11457,11457,11458,8,2,-6
11458,11458,11459,2,4,2
11459,11459,11460,4,4,0
11460,11460,11461,4,6,2
11461,11461,11462,6,0,-6
11462,11462,11463,0,4,4
11463,11463,11464,4,9,5
11464,11464,11465,9,9,0
11465,11465,11466,9,6,-3
11466,11466,11467,6,3,-3
11467,11467,11468,3,4,1
11468,11468,11469,4,8,4
11469,11469,11470,8,5,-3
11470,11470,11471,5,4,-1
11471,11471,11472,4,5,1
11472,11472,11473,5,7,2
11473,11473,11474,7,9,2
11474,11474,11475,9,2,-7
11475,11475,11476,2,3,1
11476,11476,11477,3,5,2
11477,11477,11478,5,8,3
11478,11478,11479,8,6,-2
11479,11479,11480,6,3,-3
11480,11480,11481,3,3,0
11481,11481,11482,3,8,5
11482,11482,11483,8,6,-2
11483,11483,11484,6,5,-1
11484,11484,11485,5,9,4
11485,11485,11486,9,5,-4
11486,11486,11487,5,6,1
11487,11487,11488,6,7,1
11488,11488,11489,7,3,-4
11489,11489,11490,3,6,3
11490,11490,11491,6,2,-4
11491,11491,11492,2,5,3
11492,11492,11493,5,2,-3
11493,11493,11494,2,4,2
11494,11494,11495,4,4,0
11495,11495,11496,4,4,0
11496,11496,11497,4,6,2
11497,11497,11498,6,7,1
11498,11498,11499,7,9,2
11499,11499,11500,9,5,-4
11500,11500,11501,5,0,-5
11501,11501,11502,0,1,1
11502,11502,11503,1,2,1
11503,11503,11504,2,1,-1
11504,11504,11505,1,5,4
11505,11505,11506,5,8,3
11506,11506,11507,8,5,-3
11507,11507,11508,5,1,-4
11508,11508,11509,1,1,0
11509,11509,11510,1,7,6
11510,11510,11511,7,3,-4
11511,11511,11512,3,4,1
11512,11512,11513,4,3,-1
11513,11513,11514,3,0,-3
11514,11514,11515,0,9,9
11515,11515,11516,9,7,-2
11516,11516,11517,7,7,0
11517,11517,11518,7,1,-6
11518,11518,11519,1,2,1
11519,11519,11520,2,3,1
11520,11520,11521,3,2,-1
11521,11521,11522,2,1,-1
11522,11522,11523,1,5,4
11523,11523,11524,5,3,-2
11524,11524,11525,3,7,4
11525,11525,11526,7,0,-7
11526,11526,11527,0,9,9
11527,11527,11528,9,7,-2
11528,11528,11529,7,8,1
11529,11529,11530,8,6,-2
11530,11530,11531,6,2,-4
11531,11531,11532,2,0,-2
11532,11532,11533,0,1,1
11533,11533,11534,1,7,6
11534,11534,11535,7,3,-4
11535,11535,11536,3,9,6
11536,11536,11537,9,1,-8
11537,11537,11538,1,9,8
11538,11538,11539,9,3,-6
11539,11539,11540,3,7,4
11540,11540,11541,7,0,-7
11541,11541,11542,0,5,5
11542,11542,11543,5,1,-4
11543,11543,11544,1,3,2
11544,11544,11545,3,3,0
11545,11545,11546,3,8,5
11546,11546,11547,8,4,-4
11547,11547,11548,4,7,3
11548,11548,11549,7,5,-2
11549,11549,11550,5,9,4
11550,11550,11551,9,6,-3
11551,11551,11552,6,2,-4
11552,11552,11553,2,7,5
11553,11553,11554,7,3,-4
11554,11554,11555,3,8,5
11555,11555,11556,8,3,-5
11556,11556,11557,3,9,6
11557,11557,11558,9,1,-8
11558,11558,11559,1,0,-1
11559,11559,11560,0,2,2
11560,11560,11561,2,1,-1
11561,11561,11562,1,0,-1
11562,11562,11563,0,2,2
11563,11563,11564,2,7,5
11564,11564,11565,7,3,-4
11565,11565,11566,3,7,4
11566,11566,11567,7,4,-3
11567,11567,11568,4,8,4
11568,11568,11569,8,5,-3
11569,11569,11570,5,3,-2
11570,11570,11571,3,6,3
11571,11571,11572,6,5,-1
11572,11572,11573,5,7,2
11573,11573,11574,7,0,-7
11574,11574,11575,0,8,8
11575,11575,11576,8,2,-6
11576,11576,11577,2,0,-2
11577,11577,11578,0,4,4
11578,11578,11579,4,1,-3
11579,11579,11580,1,9,8
11580,11580,11581,9,2,-7
11581,11581,11582,2,9,7
11582,11582,11583,9,3,-6
11583,11583,11584,3,0,-3
11584,11584,11585,0,4,4
11585,11585,11586,4,8,4
11586,11586,11587,8,5,-3
11587,11587,11588,5,0,-5
11588,11588,11589,0,6,6
11589,11589,11590,6,5,-1
11590,11590,11591,5,7,2
11591,11591,11592,7,6,-1
11592,11592,11593,6,9,3
11593,11593,11594,9,7,-2
11594,11594,11595,7,7,0
11595,11595,11596,7,5,-2
11596,11596,11597,5,0,-5
11597,11597,11598,0,4,4
11598,11598,11599,4,5,1
11599,11599,11600,5,2,-3
11600,11600,11601,2,2,0
11601,11601,11602,2,8,6
11602,11602,11603,8,9,1
11603,11603,11604,9,1,-8
11604,11604,11605,1,0,-1
11605,11605,11606,0,1,1
11606,11606,11607,1,1,0
11607,11607,11608,1,1,0
11608,11608,11609,1,5,4
11609,11609,11610,5,6,1
11610,11610,11611,6,8,2
11611,11611,11612,8,0,-8
11612,11612,11613,0,8,8
11613,11613,11614,8,8,0
11614,11614,11615,8,0,-8
11615,11615,11616,0,7,7
11616,11616,11617,7,9,2
11617,11617,11618,9,3,-6
11618,11618,11619,3,3,0
11619,11619,11620,3,0,-3
11620,11620,11621,0,2,2
11621,11621,11622,2,1,-1
11622,11622,11623,1,7,6
11623,11623,11624,7,4,-3
11624,11624,11625,4,8,4
11625,11625,11626,8,9,1
11626,11626,11627,9,4,-5
11627,11627,11628,4,9,5
11628,11628,11629,9,4,-5
11629,11629,11630,4,1,-3
11630,11630,11631,1,5,4
11631,11631,11632,5,2,-3
11632,11632,11633,2,9,7
11633,11633,11634,9,1,-8
11634,11634,11635,1,6,5
11635,11635,11636,6,0,-6
11636,11636,11637,0,1,1
11637,11637,11638,1,5,4
11638,11638,11639,5,0,-5
11639,11639,11640,0,7,7
11640,11640,11641,7,4,-3
11641,11641,11642,4,7,3
11642,11642,11643,7,5,-2
11643,11643,11644,5,5,0
11644,11644,11645,5,3,-2
11645,11645,11646,3,4,1
11646,11646,11647,4,9,5
11647,11647,11648,9,2,-7
11648,11648,11649,2,4,2
11649,11649,11650,4,7,3
11650,11650,11651,7,3,-4
11651,11651,11652,3,4,1
11652,11652,11653,4,4,0
11653,11653,11654,4,0,-4
11654,11654,11655,0,2,2
11655,11655,11656,2,5,3
11656,11656,11657,5,0,-5
11657,11657,11658,0,4,4
11658,11658,11659,4,5,1
11659,11659,11660,5,7,2
11660,11660,11661,7,0,-7
11661,11661,11662,0,8,8
11662,11662,11663,8,1,-7
11663,11663,11664,1,7,6
11664,11664,11665,7,3,-4
11665,11665,11666,3,1,-2
11666,11666,11667,1,2,1
11667,11667,11668,2,9,7
11668,11668,11669,9,9,0
11669,11669,11670,9,4,-5
11670,11670,11671,4,1,-3
11671,11671,11672,1,8,7
11672,11672,11673,8,6,-2
11673,11673,11674,6,5,-1
11674,11674,11675,5,0,-5
11675,11675,11676,0,1,1
11676,11676,11677,1,1,0
11677,11677,11678,1,6,5
11678,11678,11679,6,1,-5
11679,11679,11680,1,6,5
11680,11680,11681,6,8,2
11681,11681,11682,8,9,1
11682,11682,11683,9,0,-9
11683,11683,11684,0,6,6
11684,11684,11685,6,4,-2
11685,11685,11686,4,7,3
11686,11686,11687,7,7,0
11687,11687,11688,7,9,2
11688,11688,11689,9,7,-2
11689,11689,11690,7,4,-3
11690,11690,11691,4,6,2
11691,11691,11692,6,4,-2
11692,11692,11693,4,3,-1
11693,11693,11694,3,0,-3
11694,11694,11695,0,5,5
11695,11695,11696,5,5,0
11696,11696,11697,5,6,1
11697,11697,11698,6,9,3
11698,11698,11699,9,6,-3
11699,11699,11700,6,2,-4
11700,11700,11701,2,0,-2
11701,11701,11702,0,1,1
11702,11702,11703,1,7,6
11703,11703,11704,7,8,1
11704,11704,11705,8,3,-5
11705,11705,11706,3,5,2
11706,11706,11707,5,5,0
11707,11707,11708,5,3,-2
11708,11708,11709,3,4,1
11709,11709,11710,4,3,-1
11710,11710,11711,3,2,-1
11711,11711,11712,2,0,-2
11712,11712,11713,0,4,4
11713,11713,11714,4,3,-1
11714,11714,11715,3,1,-2
11715,11715,11716,1,7,6
11716,11716,11717,7,8,1
11717,11717,11718,8,2,-6
11718,11718,11719,2,3,1
11719,11719,11720,3,8,5
11720,11720,11721,8,5,-3
11721,11721,11722,5,8,3
11722,11722,11723,8,6,-2
11723,11723,11724,6,8,2
11724,11724,11725,8,5,-3
11725,11725,11726,5,8,3
11726,11726,11727,8,2,-6
11727,11727,11728,2,1,-1
11728,11728,11729,1,0,-1
11729,11729,11730,0,6,6
11730,11730,11731,6,6,0
11731,11731,11732,6,9,3
11732,11732,11733,9,7,-2
11733,11733,11734,7,8,1
11734,11734,11735,8,1,-7
11735,11735,11736,1,7,6
11736,11736,11737,7,2,-5
11737,11737,11738,2,2,0
11738,11738,11739,2,5,3
11739,11739,11740,5,4,-1
11740,11740,11741,4,8,4
11741,11741,11742,8,0,-8
11742,11742,11743,0,1,1
11743,11743,11744,1,4,3
11744,11744,11745,4,9,5
11745,11745,11746,9,0,-9
11746,11746,11747,0,3,3
11747,11747,11748,3,2,-1
11748,11748,11749,2,8,6
11749,11749,11750,8,8,0
11750,11750,11751,8,8,0
11751,11751,11752,8,3,-5
11752,11752,11753,3,8,5
11753,11753,11754,8,0,-8
11754,11754,11755,0,3,3
11755,11755,11756,3,3,0
11756,11756,11757,3,7,4
11757,11757,11758,7,0,-7
11758,11758,11759,0,6,6
11759,11759,11760,6,1,-5
11760,11760,11761,1,8,7
11761,11761,11762,8,9,1
11762,11762,11763,9,7,-2
11763,11763,11764,7,4,-3
11764,11764,11765,4,1,-3
11765,11765,11766,1,7,6
11766,11766,11767,7,4,-3
11767,11767,11768,4,7,3
11768,11768,11769,7,6,-1
11769,11769,11770,6,4,-2
11770,11770,11771,4,7,3
11771,11771,11772,7,2,-5
11772,11772,11773,2,9,7
11773,11773,11774,9,2,-7
11774,11774,11775,2,9,7
11775,11775,11776,9,5,-4
11776,11776,11777,5,3,-2
11777,11777,11778,3,7,4
11778,11778,11779,7,0,-7
11779,11779,11780,0,0,0
11780,11780,11781,0,3,3
11781,11781,11782,3,5,2
11782,11782,11783,5,4,-1
11783,11783,11784,4,6,2
11784,11784,11785,6,5,-1
11785,11785,11786,5,7,2
11786,11786,11787,7,6,-1
11787,11787,11788,6,3,-3
11788,11788,11789,3,7,4
11789,11789,11790,7,5,-2
11790,11790,11791,5,0,-5
11791,11791,11792,0,0,0
11792,11792,11793,0,1,1
11793,11793,11794,1,0,-1
11794,11794,11795,0,2,2
11795,11795,11796,2,8,6
11796,11796,11797,8,3,-5
11797,11797,11798,3,7,4
11798,11798,11799,7,4,-3
11799,11799,11800,4,6,2
11800,11800,11801,6,5,-1
11801,11801,11802,5,5,0
11802,11802,11803,5,6,1
11803,11803,11804,6,3,-3
11804,11804,11805,3,7,4
11805,11805,11806,7,5,-2
11806,11806,11807,5,0,-5
11807,11807,11808,0,8,8
11808,11808,11809,8,1,-7
11809,11809,11810,1,7,6
11810,11810,11811,7,2,-5
11811,11811,11812,2,2,0
11812,11812,11813,2,3,1
11813,11813,11814,3,9,6
11814,11814,11815,9,4,-5
11815,11815,11816,4,9,5
11816,11816,11817,9,5,-4
11817,11817,11818,5,4,-1
11818,11818,11819,4,6,2
11819,11819,11820,6,9,3
11820,11820,11821,9,7,-2
11821,11821,11822,7,7,0
11822,11822,11823,7,8,1
11823,11823,11824,8,4,-4
11824,11824,11825,4,9,5
11825,11825,11826,9,2,-7
11826,11826,11827,2,8,6
11827,11827,11828,8,6,-2
11828,11828,11829,6,7,1
11829,11829,11830,7,9,2
11830,11830,11831,9,7,-2
11831,11831,11832,7,6,-1
11832,11832,11833,6,0,-6
11833,11833,11834,0,0,0
11834,11834,11835,0,1,1
11835,11835,11836,1,8,7
11836,11836,11837,8,3,-5
11837,11837,11838,3,7,4
11838,11838,11839,7,5,-2
11839,11839,11840,5,9,4
11840,11840,11841,9,2,-7
11841,11841,11842,2,5,3
11842,11842,11843,5,8,3
11843,11843,11844,8,2,-6
11844,11844,11845,2,0,-2
11845,11845,11846,0,0,0
11846,11846,11847,0,9,9
11847,11847,11848,9,0,-9
11848,11848,11849,0,6,6
11849,11849,11850,6,5,-1
11850,11850,11851,5,0,-5
11851,11851,11852,0,4,4
11852,11852,11853,4,9,5
11853,11853,11854,9,7,-2
11854,11854,11855,7,1,-6
11855,11855,11856,1,2,1
11856,11856,11857,2,1,-1
11857,11857,11858,1,8,7
11858,11858,11859,8,8,0
11859,11859,11860,8,0,-8
11860,11860,11861,0,4,4
11861,11861,11862,4,9,5
11862,11862,11863,9,3,-6
11863,11863,11864,3,5,2
11864,11864,11865,5,2,-3
11865,11865,11866,2,6,4
11866,11866,11867,6,1,-5
11867,11867,11868,1,1,0
11868,11868,11869,1,2,1
11869,11869,11870,2,6,4
11870,11870,11871,6,6,0
11871,11871,11872,6,8,2
11872,11872,11873,8,5,-3
11873,11873,11874,5,3,-2
11874,11874,11875,3,6,3
11875,11875,11876,6,5,-1
11876,11876,11877,5,7,2
11877,11877,11878,7,6,-1
11878,11878,11879,6,4,-2
11879,11879,11880,4,8,4
11880,11880,11881,8,8,0
11881,11881,11882,8,5,-3
11882,11882,11883,5,1,-4
11883,11883,11884,1,9,8
11884,11884,11885,9,8,-1
11885,11885,11886,8,4,-4
11886,11886,11887,4,0,-4
11887,11887,11888,0,0,0
11888,11888,11889,0,5,5
11889,11889,11890,5,8,3
11890,11890,11891,8,9,1
11891,11891,11892,9,6,-3
11892,11892,11893,6,4,-2
11893,11893,11894,4,7,3
11894,11894,11895,7,1,-6
11895,11895,11896,1,2,1
11896,11896,11897,2,9,7
11897,11897,11898,9,7,-2
11898,11898,11899,7,2,-5
11899,11899,11900,2,9,7
11900,11900,11901,9,1,-8
11901,11901,11902,1,0,-1
11902,11902,11903,0,9,9
11903,11903,11904,9,8,-1
11904,11904,11905,8,6,-2
11905,11905,11906,6,9,3
11906,11906,11907,9,7,-2
11907,11907,11908,7,8,1
11908,11908,11909,8,9,1
11909,11909,11910,9,3,-6
11910,11910,11911,3,0,-3
11911,11911,11912,0,9,9
11912,11912,11913,9,4,-5
11913,11913,11914,4,0,-4
11914,11914,11915,0,6,6
11915,11915,11916,6,4,-2
11916,11916,11917,4,1,-3
11917,11917,11918,1,9,8
11918,11918,11919,9,7,-2
11919,11919,11920,7,0,-7
11920,11920,11921,0,3,3
11921,11921,11922,3,5,2
11922,11922,11923,5,8,3
11923,11923,11924,8,9,1
11924,11924,11925,9,9,0
11925,11925,11926,9,9,0
11926,11926,11927,9,6,-3
11927,11927,11928,6,5,-1
11928,11928,11929,5,3,-2
11929,11929,11930,3,4,1
11930,11930,11931,4,9,5
11931,11931,11932,9,6,-3
11932,11932,11933,6,0,-6
11933,11933,11934,0,9,9
11934,11934,11935,9,5,-4
11935,11935,11936,5,5,0
11936,11936,11937,5,7,2
11937,11937,11938,7,9,2
11938,11938,11939,9,1,-8
11939,11939,11940,1,8,7
11940,11940,11941,8,6,-2
11941,11941,11942,6,8,2
11942,11942,11943,8,1,-7
11943,11943,11944,1,7,6
11944,11944,11945,7,0,-7
11945,11945,11946,0,7,7
11946,11946,11947,7,9,2
11947,11947,11948,9,0,-9
11948,11948,11949,0,3,3
11949,11949,11950,3,8,5
11950,11950,11951,8,3,-5
11951,11951,11952,3,6,3
11952,11952,11953,6,4,-2
11953,11953,11954,4,1,-3
11954,11954,11955,1,4,3
11955,11955,11956,4,4,0
11956,11956,11957,4,0,-4
11957,11957,11958,0,3,3
11958,11958,11959,3,6,3
11959,11959,11960,6,3,-3
11960,11960,11961,3,2,-1
11961,11961,11962,2,4,2
11962,11962,11963,4,5,1
11963,11963,11964,5,6,1
11964,11964,11965,6,4,-2
11965,11965,11966,4,5,1
11966,11966,11967,5,4,-1
11967,11967,11968,4,1,-3
11968,11968,11969,1,0,-1
11969,11969,11970,0,9,9
11970,11970,11971,9,2,-7
11971,11971,11972,2,6,4
11972,11972,11973,6,0,-6
11973,11973,11974,0,0,0
11974,11974,11975,0,1,1
11975,11975,11976,1,6,5
11976,11976,11977,6,2,-4
11977,11977,11978,2,3,1
11978,11978,11979,3,3,0
11979,11979,11980,3,5,2
11980,11980,11981,5,4,-1
11981,11981,11982,4,1,-3
11982,11982,11983,1,5,4
11983,11983,11984,5,8,3
11984,11984,11985,8,6,-2
11985,11985,11986,6,4,-2
11986,11986,11987,4,7,3
11987,11987,11988,7,4,-3
11988,11988,11989,4,8,4
11989,11989,11990,8,9,1
11990,11990,11991,9,9,0
11991,11991,11992,9,9,0
11992,11992,11993,9,0,-9
11993,11993,11994,0,7,7
11994,11994,11995,7,1,-6
11995,11995,11996,1,6,5
11996,11996,11997,6,2,-4
11997,11997,11998,2,8,6
11998,11998,11999,8,3,-5
11999,11999,12000,3,7,4
12000,12000,12001,7,4,-3
12001,12001,12002,4,6,2
12002,12002,12003,6,5,-1
12003,12003,12004,5,0,-5
12004,12004,12005,0,6,6
12005,12005,12006,6,9,3
12006,12006,12007,9,7,-2
12007,12007,12008,7,0,-7
12008,12008,12009,0,8,8
12009,12009,12010,8,8,0
12010,12010,12011,8,0,-8
12011,12011,12012,0,3,3
12012,12012,12013,3,1,-2
12013,12013,12014,1,8,7
12014,12014,12015,8,2,-6
12015,12015,12016,2,5,3
12016,12016,12017,5,3,-2
12017,12017,12018,3,7,4
12018,12018,12019,7,4,-3
12019,12019,12020,4,0,-4
12020,12020,12021,0,5,5
12021,12021,12022,5,3,-2
12022,12022,12023,3,6,3
12023,12023,12024,6,3,-3
12024,12024,12025,3,7,4
12025,12025,12026,7,8,1
12026,12026,12027,8,8,0
12027,12027,12028,8,4,-4
12028,12028,12029,4,9,5
12029,12029,12030,9,1,-8
12030,12030,12031,1,7,6
12031,12031,12032,7,8,1
12032,12032,12033,8,4,-4
12033,12033,12034,4,4,0
12034,12034,12035,4,3,-1
12035,12035,12036,3,4,1
12036,12036,12037,4,8,4
12037,12037,12038,8,1,-7
12038,12038,12039,1,5,4
12039,12039,12040,5,1,-4
12040,12040,12041,1,1,0
12041,12041,12042,1,1,0
12042,12042,12043,1,8,7
12043,12043,12044,8,3,-5
12044,12044,12045,3,8,5
12045,12045,12046,8,5,-3
12046,12046,12047,5,6,1
12047,12047,12048,6,7,1
12048,12048,12049,7,1,-6
12049,12049,12050,1,9,8
12050,12050,12051,9,9,0
12051,12051,12052,9,4,-5
12052,12052,12053,4,2,-2
12053,12053,12054,2,8,6
12054,12054,12055,8,4,-4
12055,12055,12056,4,1,-3
12056,12056,12057,1,0,-1
12057,12057,12058,0,4,4
12058,12058,12059,4,9,5
12059,12059,12060,9,1,-8
12060,12060,12061,1,9,8
12061,12061,12062,9,7,-2
12062,12062,12063,7,3,-4
12063,12063,12064,3,4,1
12064,12064,12065,4,7,3
12065,12065,12066,7,8,1
12066,12066,12067,8,7,-1
12067,12067,12068,7,6,-1
12068,12068,12069,6,9,3
12069,12069,12070,9,4,-5
12070,12070,12071,4,1,-3
12071,12071,12072,1,1,0
12072,12072,12073,1,8,7
12073,12073,12074,8,9,1
12074,12074,12075,9,4,-5
12075,12075,12076,4,9,5
12076,12076,12077,9,4,-5
12077,12077,12078,4,1,-3
12078,12078,12079,1,2,1
12079,12079,12080,2,3,1
12080,12080,12081,3,7,4
12081,12081,12082,7,5,-2
12082,12082,12083,5,5,0
12083,12083,12084,5,8,3
12084,12084,12085,8,8,0
12085,12085,12086,8,3,-5
12086,12086,12087,3,5,2
12087,12087,12088,5,6,1
12088,12088,12089,6,3,-3
12089,12089,12090,3,6,3
12090,12090,12091,6,2,-4
12091,12091,12092,2,5,3
12092,12092,12093,5,2,-3
12093,12093,12094,2,3,1
12094,12094,12095,3,0,-3
12095,12095,12096,0,9,9
12096,12096,12097,9,5,-4
12097,12097,12098,5,4,-1
12098,12098,12099,4,8,4
12099,12099,12100,8,3,-5
12100,12100,12101,3,6,3
12101,12101,12102,6,4,-2
12102,12102,12103,4,0,-4
12103,12103,12104,0,6,6
12104,12104,12105,6,4,-2
12105,12105,12106,4,1,-3
12106,12106,12107,1,0,-1
12107,12107,12108,0,3,3
12108,12108,12109,3,3,0
12109,12109,12110,3,5,2
12110,12110,12111,5,8,3
12111,12111,12112,8,8,0
12112,12112,12113,8,1,-7
12113,12113,12114,1,6,5
12114,12114,12115,6,0,-6
12115,12115,12116,0,7,7
12116,12116,12117,7,3,-4
12117,12117,12118,3,8,5
12118,12118,12119,8,0,-8
12119,12119,12120,0,9,9
12120,12120,12121,9,4,-5
12121,12121,12122,4,4,0
12122,12122,12123,4,7,3
12123,12123,12124,7,3,-4
12124,12124,12125,3,4,1
12125,12125,12126,4,7,3
12126,12126,12127,7,9,2
12127,12127,12128,9,1,-8
12128,12128,12129,1,2,1
12129,12129,12130,2,8,6
12130,12130,12131,8,9,1
12131,12131,12132,9,1,-8
12132,12132,12133,1,1,0
12133,12133,12134,1,0,-1
12134,12134,12135,0,2,2
12135,12135,12136,2,1,-1
12136,12136,12137,1,5,4
12137,12137,12138,5,7,2
12138,12138,12139,7,7,0
12139,12139,12140,7,0,-7
12140,12140,12141,0,1,1
12141,12141,12142,1,0,-1
12142,12142,12143,0,7,7
12143,12143,12144,7,0,-7
12144,12144,12145,0,1,1
12145,12145,12146,1,5,4
12146,12146,12147,5,6,1
12147,12147,12148,6,3,-3
12148,12148,12149,3,7,4
12149,12149,12150,7,0,-7
12150,12150,12151,0,3,3
12151,12151,12152,3,3,0
12152,12152,12153,3,3,0
12153,12153,12154,3,1,-2
12154,12154,12155,1,6,5
12155,12155,12156,6,2,-4
12156,12156,12157,2,5,3
12157,12157,12158,5,1,-4
12158,12158,12159,1,6,5
12159,12159,12160,6,9,3
12160,12160,12161,9,2,-7
12161,12161,12162,2,9,7
12162,12162,12163,9,8,-1
12163,12163,12164,8,8,0
12164,12164,12165,8,7,-1
12165,12165,12166,7,1,-6
12166,12166,12167,1,6,5
12167,12167,12168,6,0,-6
12168,12168,12169,0,4,4
12169,12169,12170,4,6,2
12170,12170,12171,6,9,3
12171,12171,12172,9,9,0
12172,12172,12173,9,8,-1
12173,12173,12174,8,8,0
12174,12174,12175,8,9,1
12175,12175,12176,9,7,-2
12176,12176,12177,7,6,-1
12177,12177,12178,6,1,-5
12178,12178,12179,1,9,8
12179,12179,12180,9,0,-9
12180,12180,12181,0,5,5
12181,12181,12182,5,8,3
12182,12182,12183,8,3,-5
12183,12183,12184,3,0,-3
12184,12184,12185,0,7,7
12185,12185,12186,7,3,-4
12186,12186,12187,3,4,1
12187,12187,12188,4,7,3
12188,12188,12189,7,3,-4
12189,12189,12190,3,8,5
12190,12190,12191,8,6,-2
12191,12191,12192,6,4,-2
12192,12192,12193,4,0,-4
12193,12193,12194,0,4,4
12194,12194,12195,4,0,-4
12195,12195,12196,0,2,2
12196,12196,12197,2,4,2
12197,12197,12198,4,8,4
12198,12198,12199,8,6,-2
12199,12199,12200,6,9,3
12200,12200,12201,9,6,-3
12201,12201,12202,6,9,3
12202,12202,12203,9,9,0
12203,12203,12204,9,2,-7
12204,12204,12205,2,0,-2
12205,12205,12206,0,7,7
12206,12206,12207,7,1,-6
12207,12207,12208,1,7,6
12208,12208,12209,7,1,-6
12209,12209,12210,1,5,4
12210,12210,12211,5,3,-2
12211,12211,12212,3,1,-2
12212,12212,12213,1,2,1
12213,12213,12214,2,3,1
12214,12214,12215,3,1,-2
12215,12215,12216,1,6,5
12216,12216,12217,6,0,-6
12217,12217,12218,0,3,3
12218,12218,12219,3,0,-3
12219,12219,12220,0,6,6
12220,12220,12221,6,1,-5
12221,12221,12222,1,3,2
12222,12222,12223,3,2,-1
12223,12223,12224,2,4,2
12224,12224,12225,4,3,-1
12225,12225,12226,3,1,-2
12226,12226,12227,1,4,3
12227,12227,12228,4,3,-1
12228,12228,12229,3,5,2
12229,12229,12230,5,1,-4
12230,12230,12231,1,6,5
12231,12231,12232,6,5,-1
12232,12232,12233,5,7,2
12233,12233,12234,7,2,-5
12234,12234,12235,2,8,6
12235,12235,12236,8,1,-7
12236,12236,12237,1,9,8
12237,12237,12238,9,2,-7
12238,12238,12239,2,0,-2
12239,12239,12240,0,9,9
12240,12240,12241,9,1,-8
12241,12241,12242,1,8,7
12242,12242,12243,8,2,-6
12243,12243,12244,2,3,1
12244,12244,12245,3,3,0
12245,12245,12246,3,3,0
12246,12246,12247,3,4,1
12247,12247,12248,4,9,5
12248,12248,12249,9,5,-4
12249,12249,12250,5,8,3
12250,12250,12251,8,6,-2
12251,12251,12252,6,7,1
12252,12252,12253,7,7,0
12253,12253,12254,7,2,-5
12254,12254,12255,2,8,6
12255,12255,12256,8,4,-4
12256,12256,12257,4,9,5
12257,12257,12258,9,6,-3
12258,12258,12259,6,0,-6
12259,12259,12260,0,3,3
12260,12260,12261,3,1,-2
12261,12261,12262,1,6,5
12262,12262,12263,6,2,-4
12263,12263,12264,2,0,-2
12264,12264,12265,0,3,3
12265,12265,12266,3,0,-3
12266,12266,12267,0,4,4
12267,12267,12268,4,8,4
12268,12268,12269,8,5,-3
12269,12269,12270,5,6,1
12270,12270,12271,6,6,0
12271,12271,12272,6,9,3
12272,12272,12273,9,7,-2
12273,12273,12274,7,3,-4
12274,12274,12275,3,8,5
12275,12275,12276,8,0,-8
12276,12276,12277,0,9,9
12277,12277,12278,9,7,-2
12278,12278,12279,7,4,-3
12279,12279,12280,4,9,5
12280,12280,12281,9,2,-7
12281,12281,12282,2,8,6
12282,12282,12283,8,6,-2
12283,12283,12284,6,5,-1
12284,12284,12285,5,4,-1
12285,12285,12286,4,2,-2
12286,12286,12287,2,7,5
12287,12287,12288,7,8,1
12288,12288,12289,8,5,-3
12289,12289,12290,5,6,1
12290,12290,12291,6,4,-2
12291,12291,12292,4,7,3
12292,12292,12293,7,7,0
12293,12293,12294,7,9,2
12294,12294,12295,9,8,-1
12295,12295,12296,8,7,-1
12296,12296,12297,7,9,2
12297,12297,12298,9,8,-1
12298,12298,12299,8,2,-6
12299,12299,12300,2,3,1
12300,12300,12301,3,9,6
12301,12301,12302,9,2,-7
12302,12302,12303,2,3,1
12303,12303,12304,3,7,4
12304,12304,12305,7,9,2
12305,12305,12306,9,4,-5
12306,12306,12307,4,3,-1
12307,12307,12308,3,8,5
12308,12308,12309,8,8,0
12309,12309,12310,8,1,-7
12310,12310,12311,1,2,1
12311,12311,12312,2,3,1
12312,12312,12313,3,0,-3
12313,12313,12314,0,1,1
12314,12314,12315,1,9,8
12315,12315,12316,9,4,-5
12316,12316,12317,4,8,4
12317,12317,12318,8,1,-7
12318,12318,12319,1,6,5
12319,12319,12320,6,9,3
12320,12320,12321,9,0,-9
12321,12321,12322,0,4,4
12322,12322,12323,4,1,-3
12323,12323,12324,1,0,-1
12324,12324,12325,0,0,0
12325,12325,12326,0,3,3
12326,12326,12327,3,4,1
12327,12327,12328,4,4,0
12328,12328,12329,4,3,-1
12329,12329,12330,3,3,0
12330,12330,12331,3,5,2
12331,12331,12332,5,4,-1
12332,12332,12333,4,3,-1
12333,12333,12334,3,3,0
12334,12334,12335,3,8,5
12335,12335,12336,8,1,-7
12336,12336,12337,1,0,-1
12337,12337,12338,0,3,3
12338,12338,12339,3,0,-3
12339,12339,12340,0,6,6
12340,12340,12341,6,5,-1
12341,12341,12342,5,9,4
12342,12342,12343,9,4,-5
12343,12343,12344,4,3,-1
12344,12344,12345,3,3,0
12345,12345,12346,3,3,0
12346,12346,12347,3,5,2
12347,12347,12348,5,7,2
12348,12348,12349,7,3,-4
12349,12349,12350,3,3,0
12350,12350,12351,3,0,-3
12351,12351,12352,0,2,2
12352,12352,12353,2,8,6
12353,12353,12354,8,6,-2
12354,12354,12355,6,3,-3
12355,12355,12356,3,1,-2
12356,12356,12357,1,0,-1
12357,12357,12358,0,5,5
12358,12358,12359,5,6,1
12359,12359,12360,6,0,-6
12360,12360,12361,0,2,2
12361,12361,12362,2,1,-1
12362,12362,12363,1,7,6
12363,12363,12364,7,7,0
12364,12364,12365,7,1,-6
12365,12365,12366,1,2,1
12366,12366,12367,2,1,-1
12367,12367,12368,1,9,8
12368,12368,12369,9,8,-1
12369,12369,12370,8,2,-6
12370,12370,12371,2,1,-1
12371,12371,12372,1,2,1
12372,12372,12373,2,7,5
12373,12373,12374,7,0,-7
12374,12374,12375,0,1,1
12375,12375,12376,1,5,4
12376,12376,12377,5,3,-2
12377,12377,12378,3,8,5
12378,12378,12379,8,8,0
12379,12379,12380,8,9,1
12380,12380,12381,9,5,-4
12381,12381,12382,5,1,-4
12382,12382,12383,1,1,0
12383,12383,12384,1,4,3
12384,12384,12385,4,2,-2
12385,12385,12386,2,5,3
12386,12386,12387,5,0,-5
12387,12387,12388,0,1,1
12388,12388,12389,1,9,8
12389,12389,12390,9,7,-2
12390,12390,12391,7,7,0
12391,12391,12392,7,3,-4
12392,12392,12393,3,6,3
12393,12393,12394,6,1,-5
12394,12394,12395,1,7,6
12395,12395,12396,7,4,-3
12396,12396,12397,4,4,0
12397,12397,12398,4,4,0
12398,12398,12399,4,1,-3
12399,12399,12400,1,8,7
12400,12400,12401,8,6,-2
12401,12401,12402,6,6,0
12402,12402,12403,6,7,1
12403,12403,12404,7,2,-5
12404,12404,12405,2,5,3
12405,12405,12406,5,9,4
12406,12406,12407,9,1,-8
12407,12407,12408,1,7,6
12408,12408,12409,7,2,-5
12409,12409,12410,2,6,4
12410,12410,12411,6,6,0
12411,12411,12412,6,1,-5
12412,12412,12413,1,7,6
12413,12413,12414,7,0,-7
12414,12414,12415,0,1,1
12415,12415,12416,1,3,2
12416,12416,12417,3,9,6
12417,12417,12418,9,4,-5
12418,12418,12419,4,8,4
12419,12419,12420,8,7,-1
12420,12420,12421,7,0,-7
12421,12421,12422,0,2,2
12422,12422,12423,2,6,4
12423,12423,12424,6,2,-4
12424,12424,12425,2,9,7
12425,12425,12426,9,2,-7
12426,12426,12427,2,4,2
12427,12427,12428,4,7,3
12428,12428,12429,7,9,2
12429,12429,12430,9,3,-6
12430,12430,12431,3,9,6
12431,12431,12432,9,9,0
12432,12432,12433,9,6,-3
12433,12433,12434,6,1,-5
12434,12434,12435,1,2,1
12435,12435,12436,2,1,-1
12436,12436,12437,1,3,2
12437,12437,12438,3,4,1
12438,12438,12439,4,7,3
12439,12439,12440,7,9,2
12440,12440,12441,9,1,-8
12441,12441,12442,1,9,8
12442,12442,12443,9,9,0
12443,12443,12444,9,8,-1
12444,12444,12445,8,2,-6
12445,12445,12446,2,3,1
12446,12446,12447,3,2,-1
12447,12447,12448,2,6,4
12448,12448,12449,6,5,-1
12449,12449,12450,5,6,1
12450,12450,12451,6,3,-3
12451,12451,12452,3,6,3
12452,12452,12453,6,7,1
12453,12453,12454,7,7,0
12454,12454,12455,7,8,1
12455,12455,12456,8,0,-8
12456,12456,12457,0,0,0
12457,12457,12458,0,4,4
12458,12458,12459,4,1,-3
12459,12459,12460,1,4,3
12460,12460,12461,4,2,-2
12461,12461,12462,2,6,4
12462,12462,12463,6,3,-3
12463,12463,12464,3,7,4
12464,12464,12465,7,4,-3
12465,12465,12466,4,8,4
12466,12466,12467,8,5,-3
12467,12467,12468,5,6,1
12468,12468,12469,6,6,0
12469,12469,12470,6,5,-1
12470,12470,12471,5,7,2
12471,12471,12472,7,4,-3
12472,12472,12473,4,8,4
12473,12473,12474,8,2,-6
12474,12474,12475,2,9,7
12475,12475,12476,9,5,-4
12476,12476,12477,5,0,-5
12477,12477,12478,0,7,7
12478,12478,12479,7,1,-6
12479,12479,12480,1,6,5
12480,12480,12481,6,2,-4
12481,12481,12482,2,8,6
12482,12482,12483,8,3,-5
12483,12483,12484,3,5,2
12484,12484,12485,5,4,-1
12485,12485,12486,4,1,-3
12486,12486,12487,1,5,4
12487,12487,12488,5,5,0
12488,12488,12489,5,6,1
12489,12489,12490,6,3,-3
12490,12490,12491,3,7,4
12491,12491,12492,7,7,0
12492,12492,12493,7,8,1
12493,12493,12494,8,8,0
12494,12494,12495,8,9,1
12495,12495,12496,9,9,0
12496,12496,12497,9,0,-9
12497,12497,12498,0,3,3
12498,12498,12499,3,1,-2
12499,12499,12500,1,0,-1
12500,12500,12501,0,2,2
12501,12501,12502,2,5,3
12502,12502,12503,5,3,-2
12503,12503,12504,3,0,-3
12504,12504,12505,0,4,4
12505,12505,12506,4,3,-1
12506,12506,12507,3,5,2
12507,12507,12508,5,1,-4
12508,12508,12509,1,6,5
12509,12509,12510,6,1,-5
12510,12510,12511,1,7,6
12511,12511,12512,7,1,-6
12512,12512,12513,1,8,7
12513,12513,12514,8,2,-6
12514,12514,12515,2,9,7
12515,12515,12516,9,0,-9
12516,12516,12517,0,2,2
12517,12517,12518,2,6,4
12518,12518,12519,6,5,-1
12519,12519,12520,5,6,1
12520,12520,12521,6,1,-5
12521,12521,12522,1,8,7
12522,12522,12523,8,6,-2
12523,12523,12524,6,7,1
12524,12524,12525,7,4,-3
12525,12525,12526,4,7,3
12526,12526,12527,7,3,-4
12527,12527,12528,3,6,3
12528,12528,12529,6,9,3
12529,12529,12530,9,4,-5
12530,12530,12531,4,9,5
12531,12531,12532,9,1,-8
12532,12532,12533,1,0,-1
12533,12533,12534,0,8,8
12534,12534,12535,8,9,1
12535,12535,12536,9,3,-6
12536,12536,12537,3,7,4
12537,12537,12538,7,4,-3
12538,12538,12539,4,1,-3
12539,12539,12540,1,5,4
12540,12540,12541,5,6,1
12541,12541,12542,6,0,-6
12542,12542,12543,0,4,4
12543,12543,12544,4,3,-1
12544,12544,12545,3,3,0
12545,12545,12546,3,3,0
12546,12546,12547,3,6,3
12547,12547,12548,6,5,-1
12548,12548,12549,5,2,-3
12549,12549,12550,2,0,-2
12550,12550,12551,0,2,2
12551,12551,12552,2,6,4
12552,12552,12553,6,0,-6
12553,12553,12554,0,0,0
12554,12554,12555,0,0,0
12555,12555,12556,0,1,1
12556,12556,12557,1,8,7
12557,12557,12558,8,7,-1
12558,12558,12559,7,2,-5
12559,12559,12560,2,2,0
12560,12560,12561,2,5,3
12561,12561,12562,5,9,4
12562,12562,12563,9,9,0
12563,12563,12564,9,4,-5
12564,12564,12565,4,8,4
12565,12565,12566,8,5,-3
12566,12566,12567,5,6,1
12567,12567,12568,6,0,-6
12568,12568,12569,0,5,5
12569,12569,12570,5,9,4
12570,12570,12571,9,7,-2
12571,12571,12572,7,5,-2
12572,12572,12573,5,0,-5
12573,12573,12574,0,5,5
12574,12574,12575,5,0,-5
12575,12575,12576,0,7,7
12576,12576,12577,7,4,-3
12577,12577,12578,4,1,-3
12578,12578,12579,1,7,6
12579,12579,12580,7,8,1
12580,12580,12581,8,4,-4
12581,12581,12582,4,2,-2
12582,12582,12583,2,3,1
12583,12583,12584,3,0,-3
12584,12584,12585,0,2,2
12585,12585,12586,2,8,6
12586,12586,12587,8,2,-6
12587,12587,12588,2,5,3
12588,12588,12589,5,4,-1
12589,12589,12590,4,1,-3
12590,12590,12591,1,1,0
12591,12591,12592,1,3,2
12592,12592,12593,3,3,0
12593,12593,12594,3,8,5
12594,12594,12595,8,4,-4
12595,12595,12596,4,6,2
12596,12596,12597,6,7,1
12597,12597,12598,7,2,-5
12598,12598,12599,2,7,5
12599,12599,12600,7,9,2
12600,12600,12601,9,7,-2
12601,12601,12602,7,3,-4
12602,12602,12603,3,2,-1
12603,12603,12604,2,5,3
12604,12604,12605,5,0,-5
12605,12605,12606,0,6,6
12606,12606,12607,6,9,3
12607,12607,12608,9,2,-7
12608,12608,12609,2,8,6
12609,12609,12610,8,4,-4
12610,12610,12611,4,5,1
12611,12611,12612,5,4,-1
12612,12612,12613,4,6,2
12613,12613,12614,6,9,3
12614,12614,12615,9,4,-5
12615,12615,12616,4,8,4
12616,12616,12617,8,3,-5
12617,12617,12618,3,4,1
12618,12618,12619,4,8,4
12619,12619,12620,8,2,-6
12620,12620,12621,2,2,0
12621,12621,12622,2,8,6
12622,12622,12623,8,8,0
12623,12623,12624,8,7,-1
12624,12624,12625,7,3,-4
12625,12625,12626,3,5,2
12626,12626,12627,5,8,3
12627,12627,12628,8,7,-1
12628,12628,12629,7,9,2
12629,12629,12630,9,8,-1
12630,12630,12631,8,5,-3
12631,12631,12632,5,1,-4
12632,12632,12633,1,8,7
12633,12633,12634,8,1,-7
12634,12634,12635,1,0,-1
12635,12635,12636,0,6,6
12636,12636,12637,6,5,-1
12637,12637,12638,5,5,0
12638,12638,12639,5,4,-1
12639,12639,12640,4,6,2
12640,12640,12641,6,7,1
12641,12641,12642,7,1,-6
12642,12642,12643,1,1,0
12643,12643,12644,1,4,3
12644,12644,12645,4,3,-1
12645,12645,12646,3,9,6
12646,12646,12647,9,1,-8
12647,12647,12648,1,8,7
12648,12648,12649,8,7,-1
12649,12649,12650,7,5,-2
12650,12650,12651,5,9,4
12651,12651,12652,9,0,-9
12652,12652,12653,0,0,0
12653,12653,12654,0,4,4
12654,12654,12655,4,9,5
12655,12655,12656,9,3,-6
12656,12656,12657,3,1,-2
12657,12657,12658,1,8,7
12658,12658,12659,8,7,-1
12659,12659,12660,7,8,1
12660,12660,12661,8,3,-5
12661,12661,12662,3,0,-3
12662,12662,12663,0,8,8
12663,12663,12664,8,1,-7
12664,12664,12665,1,0,-1
12665,12665,12666,0,0,0
12666,12666,12667,0,3,3
12667,12667,12668,3,7,4
12668,12668,12669,7,9,2
12669,12669,12670,9,0,-9
12670,12670,12671,0,1,1
12671,12671,12672,1,2,1
12672,12672,12673,2,6,4
12673,12673,12674,6,9,3
12674,12674,12675,9,4,-5
12675,12675,12676,4,7,3
12676,12676,12677,7,3,-4
12677,12677,12678,3,7,4
12678,12678,12679,7,2,-5
12679,12679,12680,2,1,-1
12680,12680,12681,1,1,0
12681,12681,12682,1,2,1
12682,12682,12683,2,8,6
12683,12683,12684,8,5,-3
12684,12684,12685,5,6,1
12685,12685,12686,6,0,-6
12686,12686,12687,0,4,4
12687,12687,12688,4,5,1
12688,12688,12689,5,5,0
12689,12689,12690,5,0,-5
12690,12690,12691,0,0,0
12691,12691,12692,0,5,5
12692,12692,12693,5,1,-4
12693,12693,12694,1,5,4
12694,12694,12695,5,5,0
12695,12695,12696,5,9,4
12696,12696,12697,9,5,-4
12697,12697,12698,5,3,-2
12698,12698,12699,3,6,3
12699,12699,12700,6,3,-3
12700,12700,12701,3,5,2
12701,12701,12702,5,3,-2
12702,12702,12703,3,0,-3
12703,12703,12704,0,1,1
12704,12704,12705,1,1,0
12705,12705,12706,1,1,0
12706,12706,12707,1,2,1
12707,12707,12708,2,9,7
12708,12708,12709,9,3,-6
12709,12709,12710,3,8,5
12710,12710,12711,8,4,-4
12711,12711,12712,4,8,4
12712,12712,12713,8,5,-3
12713,12713,12714,5,5,0
12714,12714,12715,5,6,1
12715,12715,12716,6,0,-6
12716,12716,12717,0,7,7
12717,12717,12718,7,2,-5
12718,12718,12719,2,8,6
12719,12719,12720,8,3,-5
12720,12720,12721,3,9,6
12721,12721,12722,9,1,-8
12722,12722,12723,1,0,-1
12723,12723,12724,0,7,7
12724,12724,12725,7,1,-6
12725,12725,12726,1,4,3
12726,12726,12727,4,2,-2
12727,12727,12728,2,6,4
12728,12728,12729,6,3,-3
12729,12729,12730,3,7,4
12730,12730,12731,7,4,-3
12731,12731,12732,4,0,-4
12732,12732,12733,0,5,5
12733,12733,12734,5,1,-4
12734,12734,12735,1,6,5
12735,12735,12736,6,5,-1
12736,12736,12737,5,7,2
12737,12737,12738,7,9,2
12738,12738,12739,9,9,0
12739,12739,12740,9,2,-7
12740,12740,12741,2,0,-2
12741,12741,12742,0,7,7
12742,12742,12743,7,1,-6
12743,12743,12744,1,6,5
12744,12744,12745,6,2,-4
12745,12745,12746,2,1,-1
12746,12746,12747,1,3,2
12747,12747,12748,3,0,-3
12748,12748,12749,0,4,4
12749,12749,12750,4,3,-1
12750,12750,12751,3,7,4
12751,12751,12752,7,2,-5
12752,12752,12753,2,9,7
12753,12753,12754,9,7,-2
12754,12754,12755,7,4,-3
12755,12755,12756,4,5,1
12756,12756,12757,5,7,2
12757,12757,12758,7,6,-1
12758,12758,12759,6,6,0
12759,12759,12760,6,4,-2
12760,12760,12761,4,3,-1
12761,12761,12762,3,6,3
12762,12762,12763,6,4,-2
12763,12763,12764,4,0,-4
12764,12764,12765,0,0,0
12765,12765,12766,0,2,2
12766,12766,12767,2,9,7
12767,12767,12768,9,9,0
12768,12768,12769,9,7,-2
12769,12769,12770,7,5,-2
12770,12770,12771,5,1,-4
12771,12771,12772,1,7,6
12772,12772,12773,7,9,2
12773,12773,12774,9,7,-2
12774,12774,12775,7,3,-4
12775,12775,12776,3,0,-3
12776,12776,12777,0,8,8
12777,12777,12778,8,8,0
12778,12778,12779,8,4,-4
12779,12779,12780,4,3,-1
12780,12780,12781,3,7,4
12781,12781,12782,7,8,1
12782,12782,12783,8,3,-5
12783,12783,12784,3,2,-1
12784,12784,12785,2,0,-2
12785,12785,12786,0,4,4
12786,12786,12787,4,9,5
12787,12787,12788,9,4,-5
12788,12788,12789,4,9,5
12789,12789,12790,9,4,-5
12790,12790,12791,4,1,-3
12791,12791,12792,1,9,8
12792,12792,12793,9,1,-8
12793,12793,12794,1,7,6
12794,12794,12795,7,4,-3
12795,12795,12796,4,0,-4
12796,12796,12797,0,2,2
12797,12797,12798,2,1,-1
12798,12798,12799,1,0,-1
12799,12799,12800,0,5,5
12800,12800,12801,5,6,1
12801,12801,12802,6,2,-4
12802,12802,12803,2,2,0
12803,12803,12804,2,5,3
12804,12804,12805,5,1,-4
12805,12805,12806,1,7,6
12806,12806,12807,7,1,-6
12807,12807,12808,1,2,1
12808,12808,12809,2,1,-1
12809,12809,12810,1,6,5
12810,12810,12811,6,1,-5
12811,12811,12812,1,3,2
12812,12812,12813,3,7,4
12813,12813,12814,7,3,-4
12814,12814,12815,3,2,-1
12815,12815,12816,2,5,3
12816,12816,12817,5,4,-1
12817,12817,12818,4,5,1
12818,12818,12819,5,7,2
12819,12819,12820,7,4,-3
12820,12820,12821,4,5,1
12821,12821,12822,5,2,-3
12822,12822,12823,2,2,0
12823,12823,12824,2,1,-1
12824,12824,12825,1,9,8
12825,12825,12826,9,3,-6
12826,12826,12827,3,4,1
12827,12827,12828,4,3,-1
12828,12828,12829,3,5,2
12829,12829,12830,5,4,-1
12830,12830,12831,4,8,4
12831,12831,12832,8,9,1
12832,12832,12833,9,9,0
12833,12833,12834,9,6,-3
12834,12834,12835,6,7,1
12835,12835,12836,7,3,-4
12836,12836,12837,3,0,-3
12837,12837,12838,0,3,3
12838,12838,12839,3,0,-3
12839,12839,12840,0,9,9
12840,12840,12841,9,7,-2
12841,12841,12842,7,1,-6
12842,12842,12843,1,5,4
12843,12843,12844,5,2,-3
12844,12844,12845,2,1,-1
12845,12845,12846,1,9,8
12846,12846,12847,9,1,-8
12847,12847,12848,1,8,7
12848,12848,12849,8,7,-1
12849,12849,12850,7,7,0
12850,12850,12851,7,6,-1
12851,12851,12852,6,9,3
12852,12852,12853,9,6,-3
12853,12853,12854,6,2,-4
12854,12854,12855,2,6,4
12855,12855,12856,6,5,-1
12856,12856,12857,5,8,3
12857,12857,12858,8,2,-6
12858,12858,12859,2,2,0
12859,12859,12860,2,2,0
12860,12860,12861,2,2,0
12861,12861,12862,2,5,3
12862,12862,12863,5,7,2
12863,12863,12864,7,2,-5
12864,12864,12865,2,7,5
12865,12865,12866,7,6,-1
12866,12866,12867,6,4,-2
12867,12867,12868,4,9,5
12868,12868,12869,9,0,-9
12869,12869,12870,0,4,4
12870,12870,12871,4,2,-2
12871,12871,12872,2,0,-2
12872,12872,12873,0,4,4
12873,12873,12874,4,3,-1
12874,12874,12875,3,2,-1
12875,12875,12876,2,6,4
12876,12876,12877,6,3,-3
12877,12877,12878,3,1,-2
12878,12878,12879,1,3,2
12879,12879,12880,3,0,-3
12880,12880,12881,0,3,3
12881,12881,12882,3,3,0
12882,12882,12883,3,1,-2
12883,12883,12884,1,9,8
12884,12884,12885,9,1,-8
12885,12885,12886,1,8,7
12886,12886,12887,8,6,-2
12887,12887,12888,6,0,-6
12888,12888,12889,0,9,9
12889,12889,12890,9,8,-1
12890,12890,12891,8,5,-3
12891,12891,12892,5,8,3
12892,12892,12893,8,5,-3
12893,12893,12894,5,9,4
12894,12894,12895,9,3,-6
12895,12895,12896,3,7,4
12896,12896,12897,7,0,-7
12897,12897,12898,0,5,5
12898,12898,12899,5,8,3
12899,12899,12900,8,9,1
12900,12900,12901,9,3,-6
12901,12901,12902,3,6,3
12902,12902,12903,6,9,3
12903,12903,12904,9,8,-1
12904,12904,12905,8,6,-2
12905,12905,12906,6,2,-4
12906,12906,12907,2,0,-2
12907,12907,12908,0,7,7
12908,12908,12909,7,1,-6
12909,12909,12910,1,9,8
12910,12910,12911,9,2,-7
12911,12911,12912,2,4,2
12912,12912,12913,4,3,-1
12913,12913,12914,3,9,6
12914,12914,12915,9,4,-5
12915,12915,12916,4,2,-2
12916,12916,12917,2,5,3
12917,12917,12918,5,1,-4
12918,12918,12919,1,6,5
12919,12919,12920,6,3,-3
12920,12920,12921,3,7,4
12921,12921,12922,7,4,-3
12922,12922,12923,4,8,4
12923,12923,12924,8,3,-5
12924,12924,12925,3,9,6
12925,12925,12926,9,0,-9
12926,12926,12927,0,0,0
12927,12927,12928,0,8,8
12928,12928,12929,8,1,-7
12929,12929,12930,1,1,0
12930,12930,12931,1,2,1
12931,12931,12932,2,1,-1
12932,12932,12933,1,3,2
12933,12933,12934,3,8,5
12934,12934,12935,8,4,-4
12935,12935,12936,4,8,4
12936,12936,12937,8,5,-3
12937,12937,12938,5,2,-3
12938,12938,12939,2,6,4
12939,12939,12940,6,5,-1
12940,12940,12941,5,7,2
12941,12941,12942,7,3,-4
12942,12942,12943,3,8,5
12943,12943,12944,8,8,0
12944,12944,12945,8,9,1
12945,12945,12946,9,9,0
12946,12946,12947,9,0,-9
12947,12947,12948,0,4,4
12948,12948,12949,4,1,-3
12949,12949,12950,1,2,1
12950,12950,12951,2,2,0
12951,12951,12952,2,1,-1
12952,12952,12953,1,3,2
12953,12953,12954,3,2,-1
12954,12954,12955,2,4,2
12955,12955,12956,4,7,3
12956,12956,12957,7,5,-2
12957,12957,12958,5,8,3
12958,12958,12959,8,6,-2
12959,12959,12960,6,8,2
12960,12960,12961,8,7,-1
12961,12961,12962,7,5,-2
12962,12962,12963,5,8,3
12963,12963,12964,8,6,-2
12964,12964,12965,6,9,3
12965,12965,12966,9,4,-5
12966,12966,12967,4,3,-1
12967,12967,12968,3,3,0
12968,12968,12969,3,4,1
12969,12969,12970,4,7,3
12970,12970,12971,7,1,-6
12971,12971,12972,1,4,3
12972,12972,12973,4,4,0
12973,12973,12974,4,8,4
12974,12974,12975,8,6,-2
12975,12975,12976,6,4,-2
12976,12976,12977,4,6,2
12977,12977,12978,6,5,-1
12978,12978,12979,5,7,2
12979,12979,12980,7,6,-1
12980,12980,12981,6,3,-3
12981,12981,12982,3,7,4
12982,12982,12983,7,3,-4
12983,12983,12984,3,8,5
12984,12984,12985,8,2,-6
12985,12985,12986,2,5,3
12986,12986,12987,5,1,-4
12987,12987,12988,1,8,7
12988,12988,12989,8,9,1
12989,12989,12990,9,3,-6
12990,12990,12991,3,4,1
12991,12991,12992,4,0,-4
12992,12992,12993,0,7,7
12993,12993,12994,7,7,0
12994,12994,12995,7,3,-4
12995,12995,12996,3,5,2
12996,12996,12997,5,4,-1
12997,12997,12998,4,3,-1
12998,12998,12999,3,9,6
12999,12999,13000,9,7,-2
13000,13000,13001,7,1,-6
13001,13001,13002,1,9,8
13002,13002,13003,9,1,-8
13003,13003,13004,1,8,7
13004,13004,13005,8,0,-8
13005,13005,13006,0,1,1
13006,13006,13007,1,1,0
13007,13007,13008,1,4,3
13008,13008,13009,4,4,0
13009,13009,13010,4,6,2
13010,13010,13011,6,6,0
13011,13011,13012,6,9,3
13012,13012,13013,9,0,-9
13013,13013,13014,0,8,8
13014,13014,13015,8,2,-6
13015,13015,13016,2,8,6
13016,13016,13017,8,8,0
13017,13017,13018,8,8,0
13018,13018,13019,8,2,-6
13019,13019,13020,2,6,4
13020,13020,13021,6,5,-1
13021,13021,13022,5,2,-3
13022,13022,13023,2,2,0
13023,13023,13024,2,7,5
13024,13024,13025,7,1,-6
13025,13025,13026,1,3,2
13026,13026,13027,3,7,4
13027,13027,13028,7,9,2
13028,13028,13029,9,0,-9
13029,13029,13030,0,0,0
13030,13030,13031,0,2,2
13031,13031,13032,2,9,7
13032,13032,13033,9,0,-9
13033,13033,13034,0,9,9
13034,13034,13035,9,6,-3
13035,13035,13036,6,5,-1
13036,13036,13037,5,8,3
13037,13037,13038,8,2,-6
13038,13038,13039,2,2,0
13039,13039,13040,2,5,3
13040,13040,13041,5,9,4
13041,13041,13042,9,7,-2
13042,13042,13043,7,2,-5
13043,13043,13044,2,0,-2
13044,13044,13045,0,3,3
13045,13045,13046,3,6,3
13046,13046,13047,6,6,0
13047,13047,13048,6,7,1
13048,13048,13049,7,9,2
13049,13049,13050,9,9,0
13050,13050,13051,9,8,-1
13051,13051,13052,8,4,-4
13052,13052,13053,4,7,3
13053,13053,13054,7,0,-7
13054,13054,13055,0,8,8
13055,13055,13056,8,7,-1
13056,13056,13057,7,9,2
13057,13057,13058,9,5,-4
13058,13058,13059,5,2,-3
13059,13059,13060,2,5,3
13060,13060,13061,5,2,-3
13061,13061,13062,2,8,6
13062,13062,13063,8,9,1
13063,13063,13064,9,7,-2
13064,13064,13065,7,8,1
13065,13065,13066,8,0,-8
13066,13066,13067,0,6,6
13067,13067,13068,6,4,-2
13068,13068,13069,4,4,0
13069,13069,13070,4,5,1
13070,13070,13071,5,4,-1
13071,13071,13072,4,9,5
13072,13072,13073,9,4,-5
13073,13073,13074,4,0,-4
13074,13074,13075,0,0,0
13075,13075,13076,0,0,0
13076,13076,13077,0,0,0
13077,13077,13078,0,5,5
13078,13078,13079,5,8,3
13079,13079,13080,8,1,-7
13080,13080,13081,1,0,-1
13081,13081,13082,0,2,2
13082,13082,13083,2,8,6
13083,13083,13084,8,6,-2
13084,13084,13085,6,6,0
13085,13085,13086,6,2,-4
13086,13086,13087,2,6,4
13087,13087,13088,6,9,3
13088,13088,13089,9,8,-1
13089,13089,13090,8,1,-7
13090,13090,13091,1,7,6
13091,13091,13092,7,5,-2
13092,13092,13093,5,3,-2
13093,13093,13094,3,5,2
13094,13094,13095,5,8,3
13095,13095,13096,8,9,1
13096,13096,13097,9,0,-9
13097,13097,13098,0,0,0
13098,13098,13099,0,3,3
13099,13099,13100,3,2,-1
13100,13100,13101,2,6,4
13101,13101,13102,6,1,-5
13102,13102,13103,1,8,7
13103,13103,13104,8,4,-4
13104,13104,13105,4,3,-1
13105,13105,13106,3,1,-2
13106,13106,13107,1,1,0
13107,13107,13108,1,9,8
13108,13108,13109,9,3,-6
13109,13109,13110,3,3,0
13110,13110,13111,3,9,6
13111,13111,13112,9,1,-8
13112,13112,13113,1,1,0
13113,13113,13114,1,3,2
13114,13114,13115,3,9,6
13115,13115,13116,9,9,0
13116,13116,13117,9,0,-9
13117,13117,13118,0,8,8
13118,13118,13119,8,7,-1
13119,13119,13120,7,5,-2
13120,13120,13121,5,2,-3
13121,13121,13122,2,8,6
13122,13122,13123,8,7,-1
13123,13123,13124,7,3,-4
13124,13124,13125,3,4,1
13125,13125,13126,4,0,-4
13126,13126,13127,0,3,3
13127,13127,13128,3,4,1
13128,13128,13129,4,1,-3
13129,13129,13130,1,9,8
13130,13130,13131,9,7,-2
13131,13131,13132,7,4,-3
13132,13132,13133,4,6,2
13133,13133,13134,6,3,-3
13134,13134,13135,3,0,-3
13135,13135,13136,0,7,7
13136,13136,13137,7,1,-6
13137,13137,13138,1,2,1
13138,13138,13139,2,2,0
13139,13139,13140,2,1,-1
13140,13140,13141,1,3,2
13141,13141,13142,3,3,0
13142,13142,13143,3,4,1
13143,13143,13144,4,3,-1
13144,13144,13145,3,5,2
13145,13145,13146,5,3,-2
13146,13146,13147,3,6,3
13147,13147,13148,6,2,-4
13148,13148,13149,2,7,5
13149,13149,13150,7,7,0
13150,13150,13151,7,8,1
13151,13151,13152,8,8,0
13152,13152,13153,8,9,1
13153,13153,13154,9,1,-8
13154,13154,13155,1,0,-1
13155,13155,13156,0,2,2
13156,13156,13157,2,1,-1
13157,13157,13158,1,7,6
13158,13158,13159,7,2,-5
13159,13159,13160,2,1,-1
13160,13160,13161,1,3,2
13161,13161,13162,3,7,4
13162,13162,13163,7,4,-3
13163,13163,13164,4,0,-4
13164,13164,13165,0,5,5
13165,13165,13166,5,7,2
13166,13166,13167,7,6,-1
13167,13167,13168,6,1,-5
13168,13168,13169,1,7,6
13169,13169,13170,7,6,-1
13170,13170,13171,6,8,2
13171,13171,13172,8,6,-2
13172,13172,13173,6,9,3
13173,13173,13174,9,7,-2
13174,13174,13175,7,0,-7
13175,13175,13176,0,8,8
13176,13176,13177,8,1,-7
13177,13177,13178,1,9,8
13178,13178,13179,9,2,-7
13179,13179,13180,2,7,5
13180,13180,13181,7,3,-4
13181,13181,13182,3,5,2
13182,13182,13183,5,4,-1
13183,13183,13184,4,0,-4
13184,13184,13185,0,5,5
13185,13185,13186,5,8,3
13186,13186,13187,8,7,-1
13187,13187,13188,7,7,0
13188,13188,13189,7,8,1
13189,13189,13190,8,3,-5
13190,13190,13191,3,9,6
13191,13191,13192,9,7,-2
13192,13192,13193,7,3,-4
13193,13193,13194,3,9,6
13194,13194,13195,9,8,-1
13195,13195,13196,8,0,-8
13196,13196,13197,0,0,0
13197,13197,13198,0,2,2
13198,13198,13199,2,7,5
13199,13199,13200,7,2,-5
13200,13200,13201,2,1,-1
13201,13201,13202,1,3,2
13202,13202,13203,3,0,-3
13203,13203,13204,0,8,8
13204,13204,13205,8,7,-1
13205,13205,13206,7,0,-7
13206,13206,13207,0,6,6
13207,13207,13208,6,3,-3
13208,13208,13209,3,9,6
13209,13209,13210,9,6,-3
13210,13210,13211,6,0,-6
13211,13211,13212,0,3,3
13212,13212,13213,3,1,-2
13213,13213,13214,1,0,-1
13214,13214,13215,0,0,0
13215,13215,13216,0,0,0
13216,13216,13217,0,0,0
13217,13217,13218,0,3,3
13218,13218,13219,3,8,5
13219,13219,13220,8,6,-2
13220,13220,13221,6,3,-3
13221,13221,13222,3,3,0
13222,13222,13223,3,4,1
13223,13223,13224,4,6,2
13224,13224,13225,6,3,-3
13225,13225,13226,3,6,3
13226,13226,13227,6,1,-5
13227,13227,13228,1,3,2
13228,13228,13229,3,5,2
13229,13229,13230,5,0,-5
13230,13230,13231,0,0,0
13231,13231,13232,0,5,5
13232,13232,13233,5,0,-5
13233,13233,13234,0,5,5
13234,13234,13235,5,9,4
13235,13235,13236,9,4,-5
13236,13236,13237,4,5,1
13237,13237,13238,5,0,-5
13238,13238,13239,0,3,3
13239,13239,13240,3,0,-3
13240,13240,13241,0,4,4
13241,13241,13242,4,3,-1
13242,13242,13243,3,7,4
13243,13243,13244,7,7,0
13244,13244,13245,7,6,-1
13245,13245,13246,6,6,0
13246,13246,13247,6,9,3
13247,13247,13248,9,5,-4
13248,13248,13249,5,2,-3
13249,13249,13250,2,3,1
13250,13250,13251,3,4,1
13251,13251,13252,4,4,0
13252,13252,13253,4,5,1
13253,13253,13254,5,1,-4
13254,13254,13255,1,7,6
13255,13255,13256,7,5,-2
13256,13256,13257,5,2,-3
13257,13257,13258,2,8,6
13258,13258,13259,8,1,-7
13259,13259,13260,1,1,0
13260,13260,13261,1,6,5
13261,13261,13262,6,5,-1
13262,13262,13263,5,4,-1
13263,13263,13264,4,5,1
13264,13264,13265,5,9,4
13265,13265,13266,9,1,-8
13266,13266,13267,1,4,3
13267,13267,13268,4,0,-4
13268,13268,13269,0,9,9
13269,13269,13270,9,9,0
13270,13270,13271,9,4,-5
13271,13271,13272,4,1,-3
13272,13272,13273,1,1,0
13273,13273,13274,1,8,7
13274,13274,13275,8,2,-6
13275,13275,13276,2,5,3
13276,13276,13277,5,2,-3
13277,13277,13278,2,9,7
13278,13278,13279,9,5,-4
13279,13279,13280,5,0,-5
13280,13280,13281,0,8,8
13281,13281,13282,8,6,-2
13282,13282,13283,6,1,-5
13283,13283,13284,1,5,4
13284,13284,13285,5,3,-2
13285,13285,13286,3,0,-3
13286,13286,13287,0,2,2
13287,13287,13288,2,3,1
13288,13288,13289,3,9,6
13289,13289,13290,9,6,-3
13290,13290,13291,6,4,-2
13291,13291,13292,4,7,3
13292,13292,13293,7,3,-4
13293,13293,13294,3,3,0
13294,13294,13295,3,2,-1
13295,13295,13296,2,1,-1
13296,13296,13297,1,1,0
13297,13297,13298,1,3,2
13298,13298,13299,3,2,-1
13299,13299,13300,2,5,3
13300,13300,13301,5,8,3
13301,13301,13302,8,4,-4
13302,13302,13303,4,6,2
13303,13303,13304,6,9,3
13304,13304,13305,9,5,-4
13305,13305,13306,5,6,1
13306,13306,13307,6,1,-5
13307,13307,13308,1,9,8
13308,13308,13309,9,6,-3
13309,13309,13310,6,2,-4
13310,13310,13311,2,7,5
13311,13311,13312,7,5,-2
13312,13312,13313,5,2,-3
13313,13313,13314,2,0,-2
13314,13314,13315,0,1,1
13315,13315,13316,1,8,7
13316,13316,13317,8,3,-5
13317,13317,13318,3,6,3
13318,13318,13319,6,7,1
13319,13319,13320,7,8,1
13320,13320,13321,8,5,-3
13321,13321,13322,5,6,1
13322,13322,13323,6,9,3
13323,13323,13324,9,5,-4
13324,13324,13325,5,3,-2
13325,13325,13326,3,9,6
13326,13326,13327,9,8,-1
13327,13327,13328,8,5,-3
13328,13328,13329,5,7,2
13329,13329,13330,7,2,-5
13330,13330,13331,2,5,3
13331,13331,13332,5,3,-2
13332,13332,13333,3,7,4
13333,13333,13334,7,1,-6
13334,13334,13335,1,0,-1
13335,13335,13336,0,5,5
13336,13336,13337,5,7,2
13337,13337,13338,7,1,-6
13338,13338,13339,1,4,3
13339,13339,13340,4,4,0
13340,13340,13341,4,8,4
13341,13341,13342,8,8,0
13342,13342,13343,8,8,0
13343,13343,13344,8,0,-8
13344,13344,13345,0,5,5
13345,13345,13346,5,8,3
13346,13346,13347,8,0,-8
13347,13347,13348,0,5,5
13348,13348,13349,5,6,1
13349,13349,13350,6,4,-2
13350,13350,13351,4,6,2
13351,13351,13352,6,3,-3
13352,13352,13353,3,3,0
13353,13353,13354,3,8,5
13354,13354,13355,8,7,-1
13355,13355,13356,7,9,2
13356,13356,13357,9,6,-3
13357,13357,13358,6,9,3
13358,13358,13359,9,9,0
13359,13359,13360,9,5,-4
13360,13360,13361,5,9,4
13361,13361,13362,9,9,0
13362,13362,13363,9,4,-5
13363,13363,13364,4,6,2
13364,13364,13365,6,8,2
13365,13365,13366,8,0,-8
13366,13366,13367,0,4,4
13367,13367,13368,4,5,1
13368,13368,13369,5,1,-4
13369,13369,13370,1,2,1
13370,13370,13371,2,0,-2
13371,13371,13372,0,1,1
13372,13372,13373,1,6,5
13373,13373,13374,6,2,-4
13374,13374,13375,2,6,4
13375,13375,13376,6,3,-3
13376,13376,13377,3,0,-3
13377,13377,13378,0,8,8
13378,13378,13379,8,1,-7
13379,13379,13380,1,7,6
13380,13380,13381,7,2,-5
13381,13381,13382,2,7,5
13382,13382,13383,7,3,-4
13383,13383,13384,3,2,-1
13384,13384,13385,2,4,2
13385,13385,13386,4,8,4
13386,13386,13387,8,5,-3
13387,13387,13388,5,3,-2
13388,13388,13389,3,6,3
13389,13389,13390,6,1,-5
13390,13390,13391,1,7,6
13391,13391,13392,7,1,-6
13392,13392,13393,1,8,7
13393,13393,13394,8,5,-3
13394,13394,13395,5,9,4
13395,13395,13396,9,8,-1
13396,13396,13397,8,0,-8
13397,13397,13398,0,1,1
13398,13398,13399,1,1,0
13399,13399,13400,1,5,4
13400,13400,13401,5,2,-3
13401,13401,13402,2,8,6
13402,13402,13403,8,3,-5
13403,13403,13404,3,5,2
13404,13404,13405,5,7,2
13405,13405,13406,7,2,-5
13406,13406,13407,2,8,6
13407,13407,13408,8,0,-8
13408,13408,13409,0,9,9
13409,13409,13410,9,7,-2
13410,13410,13411,7,0,-7
13411,13411,13412,0,8,8
13412,13412,13413,8,1,-7
13413,13413,13414,1,9,8
13414,13414,13415,9,2,-7
13415,13415,13416,2,7,5
13416,13416,13417,7,3,-4
13417,13417,13418,3,4,1
13418,13418,13419,4,4,0
13419,13419,13420,4,8,4
13420,13420,13421,8,7,-1
13421,13421,13422,7,8,1
13422,13422,13423,8,8,0
13423,13423,13424,8,8,0
13424,13424,13425,8,9,1
13425,13425,13426,9,4,-5
13426,13426,13427,4,6,2
13427,13427,13428,6,9,3
13428,13428,13429,9,9,0
13429,13429,13430,9,4,-5
13430,13430,13431,4,6,2
13431,13431,13432,6,2,-4
13432,13432,13433,2,1,-1
13433,13433,13434,1,2,1
13434,13434,13435,2,9,7
13435,13435,13436,9,8,-1
13436,13436,13437,8,9,1
13437,13437,13438,9,3,-6
13438,13438,13439,3,9,6
13439,13439,13440,9,8,-1
13440,13440,13441,8,4,-4
13441,13441,13442,4,3,-1
13442,13442,13443,3,4,1
13443,13443,13444,4,6,2
13444,13444,13445,6,3,-3
13445,13445,13446,3,4,1
13446,13446,13447,4,8,4
13447,13447,13448,8,3,-5
13448,13448,13449,3,1,-2
13449,13449,13450,1,0,-1
13450,13450,13451,0,4,4
13451,13451,13452,4,2,-2
13452,13452,13453,2,1,-1
13453,13453,13454,1,0,-1
13454,13454,13455,0,2,2
13455,13455,13456,2,9,7
13456,13456,13457,9,5,-4
13457,13457,13458,5,4,-1
13458,13458,13459,4,0,-4
13459,13459,13460,0,5,5
13460,13460,13461,5,9,4
13461,13461,13462,9,9,0
13462,13462,13463,9,4,-5
13463,13463,13464,4,0,-4
13464,13464,13465,0,9,9
13465,13465,13466,9,5,-4
13466,13466,13467,5,0,-5
13467,13467,13468,0,6,6
13468,13468,13469,6,7,1
13469,13469,13470,7,1,-6
13470,13470,13471,1,4,3
13471,13471,13472,4,9,5
13472,13472,13473,9,4,-5
13473,13473,13474,4,1,-3
13474,13474,13475,1,1,0
13475,13475,13476,1,8,7
13476,13476,13477,8,8,0
13477,13477,13478,8,3,-5
13478,13478,13479,3,7,4
13479,13479,13480,7,9,2
13480,13480,13481,9,6,-3
13481,13481,13482,6,7,1
13482,13482,13483,7,0,-7
13483,13483,13484,0,2,2
13484,13484,13485,2,8,6
13485,13485,13486,8,2,-6
13486,13486,13487,2,1,-1
13487,13487,13488,1,3,2
13488,13488,13489,3,8,5
13489,13489,13490,8,2,-6
13490,13490,13491,2,2,0
13491,13491,13492,2,0,-2
13492,13492,13493,0,6,6
13493,13493,13494,6,6,0
13494,13494,13495,6,2,-4
13495,13495,13496,2,3,1
13496,13496,13497,3,0,-3
13497,13497,13498,0,8,8
13498,13498,13499,8,9,1
13499,13499,13500,9,4,-5
13500,13500,13501,4,1,-3
13501,13501,13502,1,5,4
13502,13502,13503,5,2,-3
13503,13503,13504,2,1,-1
13504,13504,13505,1,5,4
13505,13505,13506,5,2,-3
13506,13506,13507,2,4,2
13507,13507,13508,4,2,-2
13508,13508,13509,2,5,3
13509,13509,13510,5,1,-4
13510,13510,13511,1,6,5
13511,13511,13512,6,7,1
13512,13512,13513,7,7,0
13513,13513,13514,7,1,-6
13514,13514,13515,1,7,6
13515,13515,13516,7,3,-4
13516,13516,13517,3,5,2
13517,13517,13518,5,8,3
13518,13518,13519,8,3,-5
13519,13519,13520,3,4,1
13520,13520,13521,4,0,-4
13521,13521,13522,0,2,2
13522,13522,13523,2,2,0
13523,13523,13524,2,3,1
13524,13524,13525,3,2,-1
13525,13525,13526,2,9,7
13526,13526,13527,9,2,-7
13527,13527,13528,2,0,-2
13528,13528,13529,0,7,7
13529,13529,13530,7,9,2
13530,13530,13531,9,3,-6
13531,13531,13532,3,5,2
13532,13532,13533,5,5,0
13533,13533,13534,5,7,2
13534,13534,13535,7,2,-5
13535,13535,13536,2,6,4
13536,13536,13537,6,1,-5
13537,13537,13538,1,5,4
13538,13538,13539,5,4,-1
13539,13539,13540,4,7,3
13540,13540,13541,7,4,-3
13541,13541,13542,4,1,-3
13542,13542,13543,1,3,2
13543,13543,13544,3,0,-3
13544,13544,13545,0,0,0
13545,13545,13546,0,6,6
13546,13546,13547,6,0,-6
13547,13547,13548,0,4,4
13548,13548,13549,4,8,4
13549,13549,13550,8,2,-6
13550,13550,13551,2,5,3
13551,13551,13552,5,2,-3
13552,13552,13553,2,4,2
13553,13553,13554,4,8,4
13554,13554,13555,8,7,-1
13555,13555,13556,7,1,-6
13556,13556,13557,1,9,8
13557,13557,13558,9,1,-8
13558,13558,13559,1,8,7
13559,13559,13560,8,3,-5
13560,13560,13561,3,7,4
13561,13561,13562,7,8,1
13562,13562,13563,8,9,1
13563,13563,13564,9,4,-5
13564,13564,13565,4,6,2
13565,13565,13566,6,7,1
13566,13566,13567,7,3,-4
13567,13567,13568,3,3,0
13568,13568,13569,3,1,-2
13569,13569,13570,1,7,6
13570,13570,13571,7,7,0
13571,13571,13572,7,9,2
13572,13572,13573,9,9,0
13573,13573,13574,9,1,-8
13574,13574,13575,1,6,5
13575,13575,13576,6,3,-3
13576,13576,13577,3,3,0
13577,13577,13578,3,8,5
13578,13578,13579,8,3,-5
13579,13579,13580,3,5,2
13580,13580,13581,5,1,-4
13581,13581,13582,1,0,-1
13582,13582,13583,0,0,0
13583,13583,13584,0,1,1
13584,13584,13585,1,2,1
13585,13585,13586,2,2,0
13586,13586,13587,2,6,4
13587,13587,13588,6,8,2
13588,13588,13589,8,0,-8
13589,13589,13590,0,1,1
13590,13590,13591,1,5,4
13591,13591,13592,5,8,3
13592,13592,13593,8,6,-2
13593,13593,13594,6,5,-1
13594,13594,13595,5,6,1
13595,13595,13596,6,9,3
13596,13596,13597,9,8,-1
13597,13597,13598,8,6,-2
13598,13598,13599,6,7,1
13599,13599,13600,7,7,0
13600,13600,13601,7,3,-4
13601,13601,13602,3,5,2
13602,13602,13603,5,5,0
13603,13603,13604,5,1,-4
13604,13604,13605,1,8,7
13605,13605,13606,8,2,-6
13606,13606,13607,2,3,1
13607,13607,13608,3,8,5
13608,13608,13609,8,0,-8
13609,13609,13610,0,1,1
13610,13610,13611,1,1,0
13611,13611,13612,1,2,1
13612,13612,13613,2,2,0
13613,13613,13614,2,6,4
13614,13614,13615,6,3,-3
13615,13615,13616,3,9,6
13616,13616,13617,9,1,-8
13617,13617,13618,1,8,7
13618,13618,13619,8,5,-3
13619,13619,13620,5,8,3
13620,13620,13621,8,6,-2
13621,13621,13622,6,6,0
13622,13622,13623,6,0,-6
13623,13623,13624,0,2,2
13624,13624,13625,2,1,-1
13625,13625,13626,1,8,7
13626,13626,13627,8,2,-6
13627,13627,13628,2,3,1
13628,13628,13629,3,3,0
13629,13629,13630,3,1,-2
13630,13630,13631,1,1,0
13631,13631,13632,1,8,7
13632,13632,13633,8,5,-3
13633,13633,13634,5,4,-1
13634,13634,13635,4,6,2
13635,13635,13636,6,1,-5
13636,13636,13637,1,7,6
13637,13637,13638,7,7,0
13638,13638,13639,7,8,1
13639,13639,13640,8,4,-4
13640,13640,13641,4,0,-4
13641,13641,13642,0,5,5
13642,13642,13643,5,1,-4
13643,13643,13644,1,7,6
13644,13644,13645,7,2,-5
13645,13645,13646,2,9,7
13646,13646,13647,9,3,-6
13647,13647,13648,3,1,-2
13648,13648,13649,1,1,0
13649,13649,13650,1,4,3
13650,13650,13651,4,7,3
13651,13651,13652,7,9,2
13652,13652,13653,9,4,-5
13653,13653,13654,4,2,-2
13654,13654,13655,2,8,6
13655,13655,13656,8,3,-5
13656,13656,13657,3,1,-2
13657,13657,13658,1,3,2
13658,13658,13659,3,5,2
13659,13659,13660,5,3,-2
13660,13660,13661,3,6,3
13661,13661,13662,6,7,1
13662,13662,13663,7,5,-2
13663,13663,13664,5,4,-1
13664,13664,13665,4,7,3
13665,13665,13666,7,9,2
13666,13666,13667,9,2,-7
13667,13667,13668,2,9,7
13668,13668,13669,9,8,-1
13669,13669,13670,8,3,-5
13670,13670,13671,3,6,3
13671,13671,13672,6,9,3
13672,13672,13673,9,3,-6
13673,13673,13674,3,1,-2
13674,13674,13675,1,3,2
13675,13675,13676,3,3,0
13676,13676,13677,3,8,5
13677,13677,13678,8,9,1
13678,13678,13679,9,6,-3
13679,13679,13680,6,8,2
13680,13680,13681,8,5,-3
13681,13681,13682,5,8,3
13682,13682,13683,8,4,-4
13683,13683,13684,4,7,3
13684,13684,13685,7,0,-7
13685,13685,13686,0,6,6
13686,13686,13687,6,9,3
13687,13687,13688,9,4,-5
13688,13688,13689,4,1,-3
13689,13689,13690,1,2,1
13690,13690,13691,2,7,5
13691,13691,13692,7,9,2
13692,13692,13693,9,2,-7
13693,13693,13694,2,2,0
13694,13694,13695,2,9,7
13695,13695,13696,9,6,-3
13696,13696,13697,6,1,-5
13697,13697,13698,1,9,8
13698,13698,13699,9,5,-4
13699,13699,13700,5,1,-4
13700,13700,13701,1,1,0
13701,13701,13702,1,6,5
13702,13702,13703,6,3,-3
13703,13703,13704,3,3,0
13704,13704,13705,3,2,-1
13705,13705,13706,2,3,1
13706,13706,13707,3,3,0
13707,13707,13708,3,5,2
13708,13708,13709,5,6,1
13709,13709,13710,6,7,1
13710,13710,13711,7,1,-6
13711,13711,13712,1,6,5
13712,13712,13713,6,3,-3
13713,13713,13714,3,4,1
13714,13714,13715,4,6,2
13715,13715,13716,6,5,-1
13716,13716,13717,5,9,4
13717,13717,13718,9,7,-2
13718,13718,13719,7,0,-7
13719,13719,13720,0,9,9
13720,13720,13721,9,1,-8
13721,13721,13722,1,2,1
13722,13722,13723,2,8,6
13723,13723,13724,8,5,-3
13724,13724,13725,5,1,-4
13725,13725,13726,1,0,-1
13726,13726,13727,0,4,4
13727,13727,13728,4,9,5
13728,13728,13729,9,0,-9
13729,13729,13730,0,0,0
13730,13730,13731,0,6,6
13731,13731,13732,6,5,-1
13732,13732,13733,5,1,-4
13733,13733,13734,1,0,-1
13734,13734,13735,0,2,2
13735,13735,13736,2,3,1
13736,13736,13737,3,6,3
13737,13737,13738,6,0,-6
13738,13738,13739,0,9,9
13739,13739,13740,9,3,-6
13740,13740,13741,3,2,-1
13741,13741,13742,2,9,7
13742,13742,13743,9,2,-7
13743,13743,13744,2,7,5
13744,13744,13745,7,3,-4
13745,13745,13746,3,7,4
13746,13746,13747,7,5,-2
13747,13747,13748,5,1,-4
13748,13748,13749,1,5,4
13749,13749,13750,5,3,-2
13750,13750,13751,3,0,-3
13751,13751,13752,0,9,9
13752,13752,13753,9,7,-2
13753,13753,13754,7,7,0
13754,13754,13755,7,7,0
13755,13755,13756,7,7,0
13756,13756,13757,7,9,2
13757,13757,13758,9,6,-3
13758,13758,13759,6,6,0
13759,13759,13760,6,6,0
13760,13760,13761,6,2,-4
13761,13761,13762,2,2,0
13762,13762,13763,2,9,7
13763,13763,13764,9,0,-9
13764,13764,13765,0,4,4
13765,13765,13766,4,4,0
13766,13766,13767,4,7,3
13767,13767,13768,7,9,2
13768,13768,13769,9,0,-9
13769,13769,13770,0,6,6
13770,13770,13771,6,2,-4
13771,13771,13772,2,6,4
13772,13772,13773,6,3,-3
13773,13773,13774,3,2,-1
13774,13774,13775,2,4,2
13775,13775,13776,4,7,3
13776,13776,13777,7,0,-7
13777,13777,13778,0,3,3
13778,13778,13779,3,0,-3
13779,13779,13780,0,6,6
13780,13780,13781,6,8,2
13781,13781,13782,8,1,-7
13782,13782,13783,1,5,4
13783,13783,13784,5,5,0
13784,13784,13785,5,1,-4
13785,13785,13786,1,7,6
13786,13786,13787,7,3,-4
13787,13787,13788,3,1,-2
13788,13788,13789,1,7,6
13789,13789,13790,7,1,-6
13790,13790,13791,1,9,8
13791,13791,13792,9,8,-1
13792,13792,13793,8,8,0
13793,13793,13794,8,7,-1
13794,13794,13795,7,8,1
13795,13795,13796,8,5,-3
13796,13796,13797,5,9,4
13797,13797,13798,9,0,-9
13798,13798,13799,0,0,0
13799,13799,13800,0,5,5
13800,13800,13801,5,9,4
13801,13801,13802,9,7,-2
13802,13802,13803,7,8,1
13803,13803,13804,8,2,-6
13804,13804,13805,2,9,7
13805,13805,13806,9,9,0
13806,13806,13807,9,0,-9
13807,13807,13808,0,0,0
13808,13808,13809,0,6,6
13809,13809,13810,6,7,1
13810,13810,13811,7,5,-2
13811,13811,13812,5,8,3
13812,13812,13813,8,6,-2
13813,13813,13814,6,7,1
13814,13814,13815,7,7,0
13815,13815,13816,7,0,-7
13816,13816,13817,0,4,4
13817,13817,13818,4,2,-2
13818,13818,13819,2,7,5
13819,13819,13820,7,2,-5
13820,13820,13821,2,5,3
13821,13821,13822,5,0,-5
13822,13822,13823,0,4,4
13823,13823,13824,4,3,-1
13824,13824,13825,3,1,-2
13825,13825,13826,1,0,-1
13826,13826,13827,0,3,3
13827,13827,13828,3,6,3
13828,13828,13829,6,5,-1
13829,13829,13830,5,0,-5
13830,13830,13831,0,3,3
13831,13831,13832,3,6,3
13832,13832,13833,6,0,-6
13833,13833,13834,0,7,7
13834,13834,13835,7,1,-6
13835,13835,13836,1,3,2
13836,13836,13837,3,2,-1
13837,13837,13838,2,6,4
13838,13838,13839,6,3,-3
13839,13839,13840,3,1,-2
13840,13840,13841,1,4,3
13841,13841,13842,4,7,3
13842,13842,13843,7,5,-2
13843,13843,13844,5,2,-3
13844,13844,13845,2,6,4
13845,13845,13846,6,6,0
13846,13846,13847,6,7,1
13847,13847,13848,7,4,-3
13848,13848,13849,4,8,4
13849,13849,13850,8,4,-4
13850,13850,13851,4,9,5
13851,13851,13852,9,4,-5
13852,13852,13853,4,0,-4
13853,13853,13854,0,0,0
13854,13854,13855,0,1,1
13855,13855,13856,1,4,3
13856,13856,13857,4,2,-2
13857,13857,13858,2,6,4
13858,13858,13859,6,3,-3
13859,13859,13860,3,6,3
13860,13860,13861,6,4,-2
13861,13861,13862,4,5,1
13862,13862,13863,5,5,0
13863,13863,13864,5,4,-1
13864,13864,13865,4,6,2
13865,13865,13866,6,8,2
13866,13866,13867,8,7,-1
13867,13867,13868,7,4,-3
13868,13868,13869,4,8,4
13869,13869,13870,8,4,-4
13870,13870,13871,4,9,5
13871,13871,13872,9,0,-9
13872,13872,13873,0,0,0
13873,13873,13874,0,0,0
13874,13874,13875,0,1,1
13875,13875,13876,1,8,7
13876,13876,13877,8,2,-6
13877,13877,13878,2,4,2
13878,13878,13879,4,3,-1
13879,13879,13880,3,0,-3
13880,13880,13881,0,6,6
13881,13881,13882,6,1,-5
13882,13882,13883,1,7,6
13883,13883,13884,7,1,-6
13884,13884,13885,1,8,7
13885,13885,13886,8,5,-3
13886,13886,13887,5,9,4
13887,13887,13888,9,8,-1
13888,13888,13889,8,0,-8
13889,13889,13890,0,7,7
13890,13890,13891,7,9,2
13891,13891,13892,9,1,-8
13892,13892,13893,1,9,8
13893,13893,13894,9,3,-6
13894,13894,13895,3,8,5
13895,13895,13896,8,0,-8
13896,13896,13897,0,9,9
13897,13897,13898,9,9,0
13898,13898,13899,9,8,-1
13899,13899,13900,8,7,-1
13900,13900,13901,7,4,-3
13901,13901,13902,4,4,0
13902,13902,13903,4,1,-3
13903,13903,13904,1,9,8
13904,13904,13905,9,7,-2
13905,13905,13906,7,3,-4
13906,13906,13907,3,7,4
13907,13907,13908,7,4,-3
13908,13908,13909,4,3,-1
13909,13909,13910,3,2,-1
13910,13910,13911,2,0,-2
13911,13911,13912,0,6,6
13912,13912,13913,6,0,-6
13913,13913,13914,0,2,2
13914,13914,13915,2,7,5
13915,13915,13916,7,0,-7
13916,13916,13917,0,8,8
13917,13917,13918,8,0,-8
13918,13918,13919,0,2,2
13919,13919,13920,2,8,6
13920,13920,13921,8,0,-8
13921,13921,13922,0,2,2
13922,13922,13923,2,1,-1
13923,13923,13924,1,8,7
13924,13924,13925,8,2,-6
13925,13925,13926,2,0,-2
13926,13926,13927,0,6,6
13927,13927,13928,6,2,-4
13928,13928,13929,2,3,1
13929,13929,13930,3,2,-1
13930,13930,13931,2,3,1
13931,13931,13932,3,9,6
13932,13932,13933,9,7,-2
13933,13933,13934,7,8,1
13934,13934,13935,8,3,-5
13935,13935,13936,3,9,6
13936,13936,13937,9,3,-6
13937,13937,13938,3,5,2
13938,13938,13939,5,6,1
13939,13939,13940,6,5,-1
13940,13940,13941,5,6,1
13941,13941,13942,6,4,-2
13942,13942,13943,4,4,0
13943,13943,13944,4,8,4
13944,13944,13945,8,9,1
13945,13945,13946,9,5,-4
13946,13946,13947,5,1,-4
13947,13947,13948,1,5,4
13948,13948,13949,5,9,4
13949,13949,13950,9,1,-8
13950,13950,13951,1,8,7
13951,13951,13952,8,2,-6
13952,13952,13953,2,2,0
13953,13953,13954,2,8,6
13954,13954,13955,8,0,-8
13955,13955,13956,0,1,1
13956,13956,13957,1,3,2
13957,13957,13958,3,5,2
13958,13958,13959,5,2,-3
13959,13959,13960,2,8,6
13960,13960,13961,8,1,-7
13961,13961,13962,1,0,-1
13962,13962,13963,0,7,7
13963,13963,13964,7,6,-1
13964,13964,13965,6,3,-3
13965,13965,13966,3,8,5
13966,13966,13967,8,1,-7
13967,13967,13968,1,4,3
13968,13968,13969,4,3,-1
13969,13969,13970,3,6,3
13970,13970,13971,6,9,3
13971,13971,13972,9,2,-7
13972,13972,13973,2,1,-1
13973,13973,13974,1,1,0
13974,13974,13975,1,7,6
13975,13975,13976,7,8,1
13976,13976,13977,8,6,-2
13977,13977,13978,6,7,1
13978,13978,13979,7,8,1
13979,13979,13980,8,3,-5
13980,13980,13981,3,4,1
13981,13981,13982,4,9,5
13982,13982,13983,9,3,-6
13983,13983,13984,3,2,-1
13984,13984,13985,2,1,-1
13985,13985,13986,1,4,3
13986,13986,13987,4,4,0
13987,13987,13988,4,5,1
13988,13988,13989,5,0,-5
13989,13989,13990,0,8,8
13990,13990,13991,8,5,-3
13991,13991,13992,5,1,-4
13992,13992,13993,1,3,2
13993,13993,13994,3,2,-1
13994,13994,13995,2,6,4
13995,13995,13996,6,9,3
13996,13996,13997,9,9,0
13997,13997,13998,9,9,0
13998,13998,13999,9,6,-3
13999,13999,14000,6,1,-5
14000,14000,14001,1,1,0
14001,14001,14002,1,3,2
14002,14002,14003,3,8,5
14003,14003,14004,8,7,-1
14004,14004,14005,7,2,-5
14005,14005,14006,2,5,3
14006,14006,14007,5,2,-3
14007,14007,14008,2,8,6
14008,14008,14009,8,5,-3
14009,14009,14010,5,9,4
14010,14010,14011,9,7,-2
14011,14011,14012,7,0,-7
14012,14012,14013,0,8,8
14013,14013,14014,8,8,0
14014,14014,14015,8,9,1
14015,14015,14016,9,1,-8
14016,14016,14017,1,8,7
14017,14017,14018,8,4,-4
14018,14018,14019,4,0,-4
14019,14019,14020,0,8,8
14020,14020,14021,8,1,-7
14021,14021,14022,1,7,6
14022,14022,14023,7,2,-5
14023,14023,14024,2,2,0
14024,14024,14025,2,3,1
14025,14025,14026,3,3,0
14026,14026,14027,3,4,1
14027,14027,14028,4,3,-1
14028,14028,14029,3,5,2
14029,14029,14030,5,3,-2
14030,14030,14031,3,6,3
14031,14031,14032,6,7,1
14032,14032,14033,7,7,0
14033,14033,14034,7,0,-7
14034,14034,14035,0,8,8
14035,14035,14036,8,4,-4
14036,14036,14037,4,9,5
14037,14037,14038,9,1,-8
14038,14038,14039,1,0,-1
14039,14039,14040,0,2,2
14040,14040,14041,2,1,-1
14041,14041,14042,1,9,8
14042,14042,14043,9,2,-7
14043,14043,14044,2,6,4
14044,14044,14045,6,3,-3
14045,14045,14046,3,7,4
14046,14046,14047,7,4,-3
14047,14047,14048,4,5,1
14048,14048,14049,5,5,0
14049,14049,14050,5,2,-3
14050,14050,14051,2,6,4
14051,14051,14052,6,0,-6
14052,14052,14053,0,7,7
14053,14053,14054,7,5,-2
14054,14054,14055,5,8,3
14055,14055,14056,8,1,-7
14056,14056,14057,1,9,8
14057,14057,14058,9,9,0
14058,14058,14059,9,0,-9
14059,14059,14060,0,1,1
14060,14060,14061,1,1,0
14061,14061,14062,1,8,7
14062,14062,14063,8,2,-6
14063,14063,14064,2,4,2
14064,14064,14065,4,3,-1
14065,14065,14066,3,4,1
14066,14066,14067,4,4,0
14067,14067,14068,4,8,4
14068,14068,14069,8,5,-3
14069,14069,14070,5,1,-4
14070,14070,14071,1,6,5
14071,14071,14072,6,6,0
14072,14072,14073,6,7,1
14073,14073,14074,7,5,-2
14074,14074,14075,5,8,3
14075,14075,14076,8,7,-1
14076,14076,14077,7,9,2
14077,14077,14078,9,5,-4
14078,14078,14079,5,1,-4
14079,14079,14080,1,3,2
14080,14080,14081,3,2,-1
14081,14081,14082,2,9,7
14082,14082,14083,9,6,-3
14083,14083,14084,6,2,-4
14084,14084,14085,2,5,3
14085,14085,14086,5,4,-1
14086,14086,14087,4,3,-1
14087,14087,14088,3,7,4
14088,14088,14089,7,0,-7
14089,14089,14090,0,5,5
14090,14090,14091,5,2,-3
14091,14091,14092,2,0,-2
14092,14092,14093,0,8,8
14093,14093,14094,8,7,-1
14094,14094,14095,7,7,0
14095,14095,14096,7,5,-2
14096,14096,14097,5,0,-5
14097,14097,14098,0,1,1
14098,14098,14099,1,3,2
14099,14099,14100,3,5,2
14100,14100,14101,5,6,1
14101,14101,14102,6,0,-6
14102,14102,14103,0,4,4
14103,14103,14104,4,7,3
14104,14104,14105,7,4,-3
14105,14105,14106,4,5,1
14106,14106,14107,5,3,-2
14107,14107,14108,3,2,-1
14108,14108,14109,2,6,4
14109,14109,14110,6,0,-6
14110,14110,14111,0,7,7
14111,14111,14112,7,2,-5
14112,14112,14113,2,2,0
14113,14113,14114,2,7,5
14114,14114,14115,7,3,-4
14115,14115,14116,3,9,6
14116,14116,14117,9,9,0
14117,14117,14118,9,2,-7
14118,14118,14119,2,1,-1
14119,14119,14120,1,9,8
14120,14120,14121,9,2,-7
14121,14121,14122,2,5,3
14122,14122,14123,5,1,-4
14123,14123,14124,1,2,1
14124,14124,14125,2,2,0
14125,14125,14126,2,1,-1
14126,14126,14127,1,9,8
14127,14127,14128,9,8,-1
14128,14128,14129,8,6,-2
14129,14129,14130,6,2,-4
14130,14130,14131,2,0,-2
14131,14131,14132,0,2,2
14132,14132,14133,2,1,-1
14133,14133,14134,1,4,3
14134,14134,14135,4,3,-1
14135,14135,14136,3,6,3
14136,14136,14137,6,0,-6
14137,14137,14138,0,7,7
14138,14138,14139,7,2,-5
14139,14139,14140,2,8,6
14140,14140,14141,8,7,-1
14141,14141,14142,7,9,2
14142,14142,14143,9,5,-4
14143,14143,14144,5,5,0
14144,14144,14145,5,7,2
14145,14145,14146,7,9,2
14146,14146,14147,9,6,-3
14147,14147,14148,6,0,-6
14148,14148,14149,0,1,1
14149,14149,14150,1,5,4
14150,14150,14151,5,9,4
14151,14151,14152,9,7,-2
14152,14152,14153,7,0,-7
14153,14153,14154,0,1,1
14154,14154,14155,1,6,5
14155,14155,14156,6,4,-2
14156,14156,14157,4,0,-4
14157,14157,14158,0,0,0
14158,14158,14159,0,6,6
14159,14159,14160,6,0,-6
14160,14160,14161,0,0,0
14161,14161,14162,0,8,8
14162,14162,14163,8,2,-6
14163,14163,14164,2,9,7
14164,14164,14165,9,0,-9
14165,14165,14166,0,3,3
14166,14166,14167,3,6,3
14167,14167,14168,6,5,-1
14168,14168,14169,5,1,-4
14169,14169,14170,1,8,7
14170,14170,14171,8,5,-3
14171,14171,14172,5,6,1
14172,14172,14173,6,8,2
14173,14173,14174,8,2,-6
14174,14174,14175,2,4,2
14175,14175,14176,4,4,0
14176,14176,14177,4,3,-1
14177,14177,14178,3,6,3
14178,14178,14179,6,0,-6
14179,14179,14180,0,5,5
14180,14180,14181,5,1,-4
14181,14181,14182,1,9,8
14182,14182,14183,9,5,-4
14183,14183,14184,5,3,-2
14184,14184,14185,3,4,1
14185,14185,14186,4,6,2
14186,14186,14187,6,4,-2
14187,14187,14188,4,4,0
14188,14188,14189,4,8,4
14189,14189,14190,8,6,-2
14190,14190,14191,6,8,2
14191,14191,14192,8,8,0
14192,14192,14193,8,4,-4
14193,14193,14194,4,4,0
14194,14194,14195,4,5,1
14195,14195,14196,5,1,-4
14196,14196,14197,1,7,6
14197,14197,14198,7,4,-3
14198,14198,14199,4,5,1
14199,14199,14200,5,3,-2
14200,14200,14201,3,7,4
14201,14201,14202,7,0,-7
14202,14202,14203,0,8,8
14203,14203,14204,8,5,-3
14204,14204,14205,5,3,-2
14205,14205,14206,3,4,1
14206,14206,14207,4,4,0
14207,14207,14208,4,9,5
14208,14208,14209,9,8,-1
14209,14209,14210,8,3,-5
14210,14210,14211,3,8,5
14211,14211,14212,8,1,-7
14212,14212,14213,1,5,4
14213,14213,14214,5,5,0
14214,14214,14215,5,2,-3
14215,14215,14216,2,9,7
14216,14216,14217,9,9,0
14217,14217,14218,9,5,-4
14218,14218,14219,5,7,2
14219,14219,14220,7,4,-3
14220,14220,14221,4,1,-3
14221,14221,14222,1,9,8
14222,14222,14223,9,3,-6
14223,14223,14224,3,1,-2
14224,14224,14225,1,8,7
14225,14225,14226,8,8,0
14226,14226,14227,8,1,-7
14227,14227,14228,1,1,0
14228,14228,14229,1,0,-1
14229,14229,14230,0,2,2
14230,14230,14231,2,7,5
14231,14231,14232,7,6,-1
14232,14232,14233,6,5,-1
14233,14233,14234,5,1,-4
14234,14234,14235,1,9,8
14235,14235,14236,9,3,-6
14236,14236,14237,3,6,3
14237,14237,14238,6,7,1
14238,14238,14239,7,9,2
14239,14239,14240,9,9,0
14240,14240,14241,9,4,-5
14241,14241,14242,4,7,3
14242,14242,14243,7,7,0
14243,14243,14244,7,2,-5
14244,14244,14245,2,7,5
14245,14245,14246,7,7,0
14246,14246,14247,7,9,2
14247,14247,14248,9,6,-3
14248,14248,14249,6,9,3
14249,14249,14250,9,8,-1
14250,14250,14251,8,5,-3
14251,14251,14252,5,1,-4
14252,14252,14253,1,8,7
14253,14253,14254,8,9,1
14254,14254,14255,9,3,-6
14255,14255,14256,3,6,3
14256,14256,14257,6,4,-2
14257,14257,14258,4,0,-4
14258,14258,14259,0,4,4
14259,14259,14260,4,4,0
14260,14260,14261,4,3,-1
14261,14261,14262,3,3,0
14262,14262,14263,3,8,5
14263,14263,14264,8,2,-6
14264,14264,14265,2,6,4
14265,14265,14266,6,3,-3
14266,14266,14267,3,2,-1
14267,14267,14268,2,1,-1
14268,14268,14269,1,0,-1
14269,14269,14270,0,8,8
14270,14270,14271,8,1,-7
14271,14271,14272,1,4,3
14272,14272,14273,4,2,-2
14273,14273,14274,2,4,2
14274,14274,14275,4,3,-1
14275,14275,14276,3,0,-3
14276,14276,14277,0,7,7
14277,14277,14278,7,0,-7
14278,14278,14279,0,8,8
14279,14279,14280,8,7,-1
14280,14280,14281,7,9,2
14281,14281,14282,9,0,-9
14282,14282,14283,0,3,3
14283,14283,14284,3,7,4
14284,14284,14285,7,4,-3
14285,14285,14286,4,3,-1
14286,14286,14287,3,7,4
14287,14287,14288,7,7,0
14288,14288,14289,7,9,2
14289,14289,14290,9,4,-5
14290,14290,14291,4,0,-4
14291,14291,14292,0,6,6
14292,14292,14293,6,1,-5
14293,14293,14294,1,9,8
14294,14294,14295,9,2,-7
14295,14295,14296,2,4,2
14296,14296,14297,4,3,-1
14297,14297,14298,3,1,-2
14298,14298,14299,1,7,6
14299,14299,14300,7,6,-1
14300,14300,14301,6,8,2
14301,14301,14302,8,2,-6
14302,14302,14303,2,3,1
14303,14303,14304,3,8,5
14304,14304,14305,8,8,0
14305,14305,14306,8,9,1
14306,14306,14307,9,7,-2
14307,14307,14308,7,6,-1
14308,14308,14309,6,1,-5
14309,14309,14310,1,1,0
14310,14310,14311,1,0,-1
14311,14311,14312,0,1,1
14312,14312,14313,1,7,6
14313,14313,14314,7,1,-6
14314,14314,14315,1,6,5
14315,14315,14316,6,5,-1
14316,14316,14317,5,9,4
14317,14317,14318,9,5,-4
14318,14318,14319,5,0,-5
14319,14319,14320,0,3,3
14320,14320,14321,3,1,-2
14321,14321,14322,1,8,7
14322,14322,14323,8,0,-8
14323,14323,14324,0,9,9
14324,14324,14325,9,0,-9
14325,14325,14326,0,4,4
14326,14326,14327,4,1,-3
14327,14327,14328,1,6,5
14328,14328,14329,6,0,-6
14329,14329,14330,0,6,6
14330,14330,14331,6,9,3
14331,14331,14332,9,9,0
14332,14332,14333,9,3,-6
14333,14333,14334,3,0,-3
14334,14334,14335,0,4,4
14335,14335,14336,4,9,5
14336,14336,14337,9,7,-2
14337,14337,14338,7,8,1
14338,14338,14339,8,6,-2
14339,14339,14340,6,2,-4
14340,14340,14341,2,9,7
14341,14341,14342,9,2,-7
14342,14342,14343,2,2,0
14343,14343,14344,2,6,4
14344,14344,14345,6,1,-5
14345,14345,14346,1,1,0
14346,14346,14347,1,6,5
14347,14347,14348,6,7,1
14348,14348,14349,7,4,-3
14349,14349,14350,4,3,-1
14350,14350,14351,3,4,1
14351,14351,14352,4,3,-1
14352,14352,14353,3,1,-2
14353,14353,14354,1,1,0
14354,14354,14355,1,2,1
14355,14355,14356,2,0,-2
14356,14356,14357,0,2,2
14357,14357,14358,2,9,7
14358,14358,14359,9,1,-8
14359,14359,14360,1,7,6
14360,14360,14361,7,3,-4
14361,14361,14362,3,8,5
14362,14362,14363,8,2,-6
14363,14363,14364,2,9,7
14364,14364,14365,9,9,0
14365,14365,14366,9,1,-8
14366,14366,14367,1,3,2
14367,14367,14368,3,5,2
14368,14368,14369,5,2,-3
14369,14369,14370,2,5,3
14370,14370,14371,5,1,-4
14371,14371,14372,1,6,5
14372,14372,14373,6,2,-4
14373,14373,14374,2,6,4
14374,14374,14375,6,1,-5
14375,14375,14376,1,5,4
14376,14376,14377,5,6,1
14377,14377,14378,6,2,-4
14378,14378,14379,2,7,5
14379,14379,14380,7,8,1
14380,14380,14381,8,2,-6
14381,14381,14382,2,8,6
14382,14382,14383,8,3,-5
14383,14383,14384,3,0,-3
14384,14384,14385,0,8,8
14385,14385,14386,8,7,-1
14386,14386,14387,7,7,0
14387,14387,14388,7,3,-4
14388,14388,14389,3,5,2
14389,14389,14390,5,4,-1
14390,14390,14391,4,7,3
14391,14391,14392,7,2,-5
14392,14392,14393,2,0,-2
14393,14393,14394,0,3,3
14394,14394,14395,3,7,4
14395,14395,14396,7,8,1
14396,14396,14397,8,4,-4
14397,14397,14398,4,7,3
14398,14398,14399,7,6,-1
14399,14399,14400,6,6,0
14400,14400,14401,6,3,-3
14401,14401,14402,3,0,-3
14402,14402,14403,0,7,7
14403,14403,14404,7,5,-2
14404,14404,14405,5,6,1
14405,14405,14406,6,8,2
14406,14406,14407,8,9,1
14407,14407,14408,9,1,-8
14408,14408,14409,1,9,8
14409,14409,14410,9,3,-6
14410,14410,14411,3,4,1
14411,14411,14412,4,0,-4
14412,14412,14413,0,8,8
14413,14413,14414,8,1,-7
14414,14414,14415,1,4,3
14415,14415,14416,4,6,2
14416,14416,14417,6,1,-5
14417,14417,14418,1,6,5
14418,14418,14419,6,0,-6
14419,14419,14420,0,3,3
14420,14420,14421,3,6,3
14421,14421,14422,6,2,-4
14422,14422,14423,2,6,4
14423,14423,14424,6,4,-2
14424,14424,14425,4,0,-4
14425,14425,14426,0,4,4
14426,14426,14427,4,1,-3
14427,14427,14428,1,5,4
14428,14428,14429,5,2,-3
14429,14429,14430,2,0,-2
14430,14430,14431,0,3,3
14431,14431,14432,3,4,1
14432,14432,14433,4,4,0
14433,14433,14434,4,9,5
14434,14434,14435,9,5,-4
14435,14435,14436,5,9,4
14436,14436,14437,9,6,-3
14437,14437,14438,6,8,2
14438,14438,14439,8,7,-1
14439,14439,14440,7,4,-3
14440,14440,14441,4,8,4
14441,14441,14442,8,9,1
14442,14442,14443,9,9,0
14443,14443,14444,9,5,-4
14444,14444,14445,5,0,-5
14445,14445,14446,0,2,2
14446,14446,14447,2,3,1
14447,14447,14448,3,7,4
14448,14448,14449,7,4,-3
14449,14449,14450,4,3,-1
14450,14450,14451,3,5,2
14451,14451,14452,5,8,3
14452,14452,14453,8,6,-2
14453,14453,14454,6,3,-3
14454,14454,14455,3,7,4
14455,14455,14456,7,3,-4
14456,14456,14457,3,8,5
14457,14457,14458,8,2,-6
14458,14458,14459,2,9,7
14459,14459,14460,9,7,-2
14460,14460,14461,7,0,-7
14461,14461,14462,0,1,1
14462,14462,14463,1,1,0
14463,14463,14464,1,1,0
14464,14464,14465,1,2,1
14465,14465,14466,2,1,-1
14466,14466,14467,1,3,2
14467,14467,14468,3,2,-1
14468,14468,14469,2,4,2
14469,14469,14470,4,7,3
14470,14470,14471,7,5,-2
14471,14471,14472,5,0,-5
14472,14472,14473,0,6,6
14473,14473,14474,6,8,2
14474,14474,14475,8,7,-1
14475,14475,14476,7,3,-4
14476,14476,14477,3,8,5
14477,14477,14478,8,8,0
14478,14478,14479,8,9,1
14479,14479,14480,9,8,-1
14480,14480,14481,8,0,-8
14481,14481,14482,0,4,4
14482,14482,14483,4,5,1
14483,14483,14484,5,2,-3
14484,14484,14485,2,5,3
14485,14485,14486,5,5,0
14486,14486,14487,5,6,1
14487,14487,14488,6,3,-3
14488,14488,14489,3,5,2
14489,14489,14490,5,2,-3
14490,14490,14491,2,0,-2
14491,14491,14492,0,6,6
14492,14492,14493,6,9,3
14493,14493,14494,9,8,-1
14494,14494,14495,8,8,0
14495,14495,14496,8,4,-4
14496,14496,14497,4,9,5
14497,14497,14498,9,1,-8
14498,14498,14499,1,8,7
14499,14499,14500,8,6,-2
14500,14500,14501,6,4,-2
14501,14501,14502,4,9,5
14502,14502,14503,9,1,-8
14503,14503,14504,1,9,8
14504,14504,14505,9,7,-2
14505,14505,14506,7,7,0
14506,14506,14507,7,5,-2
14507,14507,14508,5,2,-3
14508,14508,14509,2,1,-1
14509,14509,14510,1,2,1
14510,14510,14511,2,0,-2
14511,14511,14512,0,5,5
14512,14512,14513,5,0,-5
14513,14513,14514,0,3,3
14514,14514,14515,3,2,-1
14515,14515,14516,2,1,-1
14516,14516,14517,1,2,1
14517,14517,14518,2,0,-2
14518,14518,14519,0,7,7
14519,14519,14520,7,4,-3
14520,14520,14521,4,1,-3
14521,14521,14522,1,7,6
14522,14522,14523,7,2,-5
14523,14523,14524,2,6,4
14524,14524,14525,6,6,0
14525,14525,14526,6,6,0
14526,14526,14527,6,3,-3
14527,14527,14528,3,4,1
14528,14528,14529,4,3,-1
14529,14529,14530,3,0,-3
14530,14530,14531,0,7,7
14531,14531,14532,7,7,0
14532,14532,14533,7,3,-4
14533,14533,14534,3,5,2
14534,14534,14535,5,3,-2
14535,14535,14536,3,7,4
14536,14536,14537,7,4,-3
14537,14537,14538,4,4,0
14538,14538,14539,4,4,0
14539,14539,14540,4,7,3
14540,14540,14541,7,1,-6
14541,14541,14542,1,4,3
14542,14542,14543,4,5,1
14543,14543,14544,5,5,0
14544,14544,14545,5,0,-5
14545,14545,14546,0,4,4
14546,14546,14547,4,9,5
14547,14547,14548,9,3,-6
14548,14548,14549,3,5,2
14549,14549,14550,5,2,-3
14550,14550,14551,2,2,0
14551,14551,14552,2,3,1
14552,14552,14553,3,8,5
14553,14553,14554,8,9,1
14554,14554,14555,9,2,-7
14555,14555,14556,2,7,5
14556,14556,14557,7,0,-7
14557,14557,14558,0,3,3
14558,14558,14559,3,0,-3
14559,14559,14560,0,1,1
14560,14560,14561,1,1,0
14561,14561,14562,1,5,4
14562,14562,14563,5,7,2
14563,14563,14564,7,0,-7
14564,14564,14565,0,6,6
14565,14565,14566,6,3,-3
14566,14566,14567,3,3,0
14567,14567,14568,3,9,6
14568,14568,14569,9,2,-7
14569,14569,14570,2,6,4
14570,14570,14571,6,1,-5
14571,14571,14572,1,4,3
14572,14572,14573,4,7,3
14573,14573,14574,7,0,-7
14574,14574,14575,0,1,1
14575,14575,14576,1,6,5
14576,14576,14577,6,3,-3
14577,14577,14578,3,4,1
14578,14578,14579,4,9,5
14579,14579,14580,9,9,0
14580,14580,14581,9,7,-2
14581,14581,14582,7,9,2
14582,14582,14583,9,6,-3
14583,14583,14584,6,1,-5
14584,14584,14585,1,1,0
14585,14585,14586,1,7,6
14586,14586,14587,7,4,-3
14587,14587,14588,4,3,-1
14588,14588,14589,3,0,-3
14589,14589,14590,0,7,7
14590,14590,14591,7,5,-2
14591,14591,14592,5,4,-1
14592,14592,14593,4,6,2
14593,14593,14594,6,7,1
14594,14594,14595,7,1,-6
14595,14595,14596,1,2,1
14596,14596,14597,2,7,5
14597,14597,14598,7,7,0
14598,14598,14599,7,5,-2
14599,14599,14600,5,7,2
14600,14600,14601,7,7,0
14601,14601,14602,7,4,-3
14602,14602,14603,4,2,-2
14603,14603,14604,2,6,4
14604,14604,14605,6,7,1
14605,14605,14606,7,1,-6
14606,14606,14607,1,9,8
14607,14607,14608,9,6,-3
14608,14608,14609,6,5,-1
14609,14609,14610,5,6,1
14610,14610,14611,6,8,2
14611,14611,14612,8,1,-7
14612,14612,14613,1,0,-1
14613,14613,14614,0,8,8
14614,14614,14615,8,1,-7
14615,14615,14616,1,4,3
14616,14616,14617,4,2,-2
14617,14617,14618,2,6,4
14618,14618,14619,6,3,-3
14619,14619,14620,3,4,1
14620,14620,14621,4,4,0
14621,14621,14622,4,7,3
14622,14622,14623,7,5,-2
14623,14623,14624,5,3,-2
14624,14624,14625,3,8,5
14625,14625,14626,8,8,0
14626,14626,14627,8,9,1
14627,14627,14628,9,5,-4
14628,14628,14629,5,0,-5
14629,14629,14630,0,5,5
14630,14630,14631,5,1,-4
14631,14631,14632,1,6,5
14632,14632,14633,6,2,-4
14633,14633,14634,2,6,4
14634,14634,14635,6,3,-3
14635,14635,14636,3,3,0
14636,14636,14637,3,4,1
14637,14637,14638,4,8,4
14638,14638,14639,8,5,-3
14639,14639,14640,5,8,3
14640,14640,14641,8,6,-2
14641,14641,14642,6,7,1
14642,14642,14643,7,7,0
14643,14643,14644,7,0,-7
14644,14644,14645,0,8,8
14645,14645,14646,8,2,-6
14646,14646,14647,2,9,7
14647,14647,14648,9,8,-1
14648,14648,14649,8,0,-8
14649,14649,14650,0,4,4
14650,14650,14651,4,1,-3
14651,14651,14652,1,4,3
14652,14652,14653,4,2,-2
14653,14653,14654,2,4,2
14654,14654,14655,4,3,-1
14655,14655,14656,3,1,-2
14656,14656,14657,1,4,3
14657,14657,14658,4,6,2
14658,14658,14659,6,5,-1
14659,14659,14660,5,6,1
14660,14660,14661,6,6,0
14661,14661,14662,6,9,3
14662,14662,14663,9,7,-2
14663,14663,14664,7,8,1
14664,14664,14665,8,8,0
14665,14665,14666,8,6,-2
14666,14666,14667,6,9,3
14667,14667,14668,9,0,-9
14668,14668,14669,0,8,8
14669,14669,14670,8,5,-3
14670,14670,14671,5,6,1
14671,14671,14672,6,5,-1
14672,14672,14673,5,5,0
14673,14673,14674,5,3,-2
14674,14674,14675,3,0,-3
14675,14675,14676,0,6,6
14676,14676,14677,6,6,0
14677,14677,14678,6,8,2
14678,14678,14679,8,8,0
14679,14679,14680,8,9,1
14680,14680,14681,9,9,0
14681,14681,14682,9,1,-8
14682,14682,14683,1,4,3
14683,14683,14684,4,7,3
14684,14684,14685,7,1,-6
14685,14685,14686,1,3,2
14686,14686,14687,3,9,6
14687,14687,14688,9,5,-4
14688,14688,14689,5,5,0
14689,14689,14690,5,8,3
14690,14690,14691,8,3,-5
14691,14691,14692,3,3,0
14692,14692,14693,3,0,-3
14693,14693,14694,0,2,2
14694,14694,14695,2,4,2
14695,14695,14696,4,9,5
14696,14696,14697,9,8,-1
14697,14697,14698,8,1,-7
14698,14698,14699,1,9,8
14699,14699,14700,9,4,-5
14700,14700,14701,4,1,-3
14701,14701,14702,1,2,1
14702,14702,14703,2,4,2
14703,14703,14704,4,3,-1
14704,14704,14705,3,0,-3
14705,14705,14706,0,8,8
14706,14706,14707,8,5,-3
14707,14707,14708,5,6,1
14708,14708,14709,6,5,-1
14709,14709,14710,5,7,2
14710,14710,14711,7,2,-5
14711,14711,14712,2,0,-2
14712,14712,14713,0,5,5
14713,14713,14714,5,5,0
14714,14714,14715,5,4,-1
14715,14715,14716,4,9,5
14716,14716,14717,9,0,-9
14717,14717,14718,0,7,7
14718,14718,14719,7,7,0
14719,14719,14720,7,4,-3
14720,14720,14721,4,6,2
14721,14721,14722,6,0,-6
14722,14722,14723,0,0,0
14723,14723,14724,0,1,1
14724,14724,14725,1,1,0
14725,14725,14726,1,9,8
14726,14726,14727,9,7,-2
14727,14727,14728,7,8,1
14728,14728,14729,8,0,-8
14729,14729,14730,0,8,8
14730,14730,14731,8,6,-2
14731,14731,14732,6,6,0
14732,14732,14733,6,8,2
14733,14733,14734,8,1,-7
14734,14734,14735,1,9,8
14735,14735,14736,9,3,-6
14736,14736,14737,3,5,2
14737,14737,14738,5,3,-2
14738,14738,14739,3,4,1
14739,14739,14740,4,4,0
14740,14740,14741,4,7,3
14741,14741,14742,7,5,-2
14742,14742,14743,5,9,4
14743,14743,14744,9,9,0
14744,14744,14745,9,8,-1
14745,14745,14746,8,0,-8
14746,14746,14747,0,6,6
14747,14747,14748,6,5,-1
14748,14748,14749,5,0,-5
14749,14749,14750,0,7,7
14750,14750,14751,7,8,1
14751,14751,14752,8,0,-8
14752,14752,14753,0,1,1
14753,14753,14754,1,8,7
14754,14754,14755,8,7,-1
14755,14755,14756,7,1,-6
14756,14756,14757,1,7,6
14757,14757,14758,7,1,-6
14758,14758,14759,1,1,0
14759,14759,14760,1,2,1
14760,14760,14761,2,3,1
14761,14761,14762,3,9,6
14762,14762,14763,9,2,-7
14763,14763,14764,2,6,4
14764,14764,14765,6,3,-3
14765,14765,14766,3,8,5
14766,14766,14767,8,1,-7
14767,14767,14768,1,6,5
14768,14768,14769,6,4,-2
14769,14769,14770,4,7,3
14770,14770,14771,7,2,-5
14771,14771,14772,2,8,6
14772,14772,14773,8,0,-8
14773,14773,14774,0,4,4
14774,14774,14775,4,0,-4
14775,14775,14776,0,2,2
14776,14776,14777,2,7,5
14777,14777,14778,7,6,-1
14778,14778,14779,6,8,2
14779,14779,14780,8,9,1
14780,14780,14781,9,4,-5
14781,14781,14782,4,8,4
14782,14782,14783,8,6,-2
14783,14783,14784,6,6,0
14784,14784,14785,6,4,-2
14785,14785,14786,4,3,-1
14786,14786,14787,3,9,6
14787,14787,14788,9,4,-5
14788,14788,14789,4,3,-1
14789,14789,14790,3,9,6
14790,14790,14791,9,8,-1
14791,14791,14792,8,3,-5
14792,14792,14793,3,4,1
14793,14793,14794,4,1,-3
14794,14794,14795,1,7,6
14795,14795,14796,7,9,2
14796,14796,14797,9,2,-7
14797,14797,14798,2,2,0
14798,14798,14799,2,5,3
14799,14799,14800,5,2,-3
14800,14800,14801,2,6,4
14801,14801,14802,6,7,1
14802,14802,14803,7,3,-4
14803,14803,14804,3,6,3
14804,14804,14805,6,6,0
14805,14805,14806,6,5,-1
14806,14806,14807,5,2,-3
14807,14807,14808,2,8,6
14808,14808,14809,8,2,-6
14809,14809,14810,2,3,1
14810,14810,14811,3,4,1
14811,14811,14812,4,1,-3
14812,14812,14813,1,6,5
14813,14813,14814,6,7,1
14814,14814,14815,7,9,2
14815,14815,14816,9,9,0
14816,14816,14817,9,0,-9
14817,14817,14818,0,9,9
14818,14818,14819,9,2,-7
14819,14819,14820,2,0,-2
14820,14820,14821,0,1,1
14821,14821,14822,1,9,8
14822,14822,14823,9,3,-6
14823,14823,14824,3,7,4
14824,14824,14825,7,3,-4
14825,14825,14826,3,8,5
14826,14826,14827,8,9,1
14827,14827,14828,9,5,-4
14828,14828,14829,5,7,2
14829,14829,14830,7,8,1
14830,14830,14831,8,8,0
14831,14831,14832,8,7,-1
14832,14832,14833,7,7,0
14833,14833,14834,7,1,-6
14834,14834,14835,1,2,1
14835,14835,14836,2,2,0
14836,14836,14837,2,2,0
14837,14837,14838,2,2,0
14838,14838,14839,2,5,3
14839,14839,14840,5,0,-5
14840,14840,14841,0,7,7
14841,14841,14842,7,9,2
14842,14842,14843,9,9,0
14843,14843,14844,9,9,0
14844,14844,14845,9,8,-1
14845,14845,14846,8,1,-7
14846,14846,14847,1,2,1
14847,14847,14848,2,6,4
14848,14848,14849,6,1,-5
14849,14849,14850,1,7,6
14850,14850,14851,7,3,-4
14851,14851,14852,3,2,-1
14852,14852,14853,2,1,-1
14853,14853,14854,1,5,4
14854,14854,14855,5,3,-2
14855,14855,14856,3,3,0
14856,14856,14857,3,0,-3
14857,14857,14858,0,1,1
14858,14858,14859,1,1,0
14859,14859,14860,1,1,0
14860,14860,14861,1,2,1
14861,14861,14862,2,5,3
14862,14862,14863,5,3,-2
14863,14863,14864,3,3,0
14864,14864,14865,3,4,1
14865,14865,14866,4,7,3
14866,14866,14867,7,5,-2
14867,14867,14868,5,2,-3
14868,14868,14869,2,6,4
14869,14869,14870,6,1,-5
14870,14870,14871,1,7,6
14871,14871,14872,7,8,1
14872,14872,14873,8,8,0
14873,14873,14874,8,1,-7
14874,14874,14875,1,9,8
14875,14875,14876,9,2,-7
14876,14876,14877,2,0,-2
14877,14877,14878,0,3,3
14878,14878,14879,3,1,-2
14879,14879,14880,1,3,2
14880,14880,14881,3,2,-1
14881,14881,14882,2,4,2
14882,14882,14883,4,3,-1
14883,14883,14884,3,9,6
14884,14884,14885,9,4,-5
14885,14885,14886,4,9,5
14886,14886,14887,9,5,-4
14887,14887,14888,5,9,4
14888,14888,14889,9,6,-3
14889,14889,14890,6,0,-6
14890,14890,14891,0,7,7
14891,14891,14892,7,1,-6
14892,14892,14893,1,8,7
14893,14893,14894,8,5,-3
14894,14894,14895,5,9,4
14895,14895,14896,9,8,-1
14896,14896,14897,8,0,-8
14897,14897,14898,0,7,7
14898,14898,14899,7,1,-6
14899,14899,14900,1,1,0
14900,14900,14901,1,2,1
14901,14901,14902,2,8,6
14902,14902,14903,8,3,-5
14903,14903,14904,3,4,1
14904,14904,14905,4,4,0
14905,14905,14906,4,1,-3
14906,14906,14907,1,5,4
14907,14907,14908,5,8,3
14908,14908,14909,8,6,-2
14909,14909,14910,6,6,0
14910,14910,14911,6,7,1
14911,14911,14912,7,6,-1
14912,14912,14913,6,8,2
14913,14913,14914,8,2,-6
14914,14914,14915,2,9,7
14915,14915,14916,9,3,-6
14916,14916,14917,3,5,2
14917,14917,14918,5,5,0
14918,14918,14919,5,0,-5
14919,14919,14920,0,7,7
14920,14920,14921,7,6,-1
14921,14921,14922,6,9,3
14922,14922,14923,9,8,-1
14923,14923,14924,8,1,-7
14924,14924,14925,1,9,8
14925,14925,14926,9,7,-2
14926,14926,14927,7,4,-3
14927,14927,14928,4,9,5
14928,14928,14929,9,1,-8
14929,14929,14930,1,7,6
14930,14930,14931,7,9,2
14931,14931,14932,9,2,-7
14932,14932,14933,2,5,3
14933,14933,14934,5,9,4
14934,14934,14935,9,3,-6
14935,14935,14936,3,1,-2
14936,14936,14937,1,0,-1
14937,14937,14938,0,2,2
14938,14938,14939,2,4,2
14939,14939,14940,4,6,2
14940,14940,14941,6,8,2
14941,14941,14942,8,1,-7
14942,14942,14943,1,9,8
14943,14943,14944,9,0,-9
14944,14944,14945,0,1,1
14945,14945,14946,1,5,4
14946,14946,14947,5,4,-1
14947,14947,14948,4,1,-3
14948,14948,14949,1,0,-1
14949,14949,14950,0,9,9
14950,14950,14951,9,5,-4
14951,14951,14952,5,6,1
14952,14952,14953,6,1,-5
14953,14953,14954,1,7,6
14954,14954,14955,7,5,-2
14955,14955,14956,5,9,4
14956,14956,14957,9,4,-5
14957,14957,14958,4,1,-3
14958,14958,14959,1,0,-1
14959,14959,14960,0,6,6
14960,14960,14961,6,7,1
14961,14961,14962,7,2,-5
14962,14962,14963,2,6,4
14963,14963,14964,6,1,-5
14964,14964,14965,1,0,-1
14965,14965,14966,0,4,4
14966,14966,14967,4,1,-3
14967,14967,14968,1,8,7
14968,14968,14969,8,7,-1
14969,14969,14970,7,5,-2
14970,14970,14971,5,0,-5
14971,14971,14972,0,4,4
14972,14972,14973,4,6,2
14973,14973,14974,6,9,3
14974,14974,14975,9,8,-1
14975,14975,14976,8,4,-4
14976,14976,14977,4,9,5
14977,14977,14978,9,2,-7
14978,14978,14979,2,5,3
14979,14979,14980,5,1,-4
14980,14980,14981,1,4,3
14981,14981,14982,4,9,5
14982,14982,14983,9,7,-2
14983,14983,14984,7,9,2
14984,14984,14985,9,9,0
14985,14985,14986,9,1,-8
14986,14986,14987,1,8,7
14987,14987,14988,8,9,1
14988,14988,14989,9,6,-3
14989,14989,14990,6,4,-2
14990,14990,14991,4,0,-4
14991,14991,14992,0,1,1
14992,14992,14993,1,8,7
14993,14993,14994,8,5,-3
14994,14994,14995,5,1,-4
14995,14995,14996,1,2,1
14996,14996,14997,2,7,5
14997,14997,14998,7,1,-6
14998,14998,14999,1,7,6
14999,14999,15000,7,5,-2
15000,15000,15001,5,1,-4
15001,15001,15002,1,1,0
15002,15002,15003,1,3,2
15003,15003,15004,3,6,3
15004,15004,15005,6,2,-4
15005,15005,15006,2,6,4
15006,15006,15007,6,3,-3
15007,15007,15008,3,3,0
15008,15008,15009,3,1,-2
15009,15009,15010,1,3,2
15010,15010,15011,3,4,1
15011,15011,15012,4,5,1
15012,15012,15013,5,2,-3
15013,15013,15014,2,3,1
15014,15014,15015,3,0,-3
15015,15015,15016,0,2,2
15016,15016,15017,2,0,-2
15017,15017,15018,0,9,9
15018,15018,15019,9,7,-2
15019,15019,15020,7,1,-6
15020,15020,15021,1,8,7
15021,15021,15022,8,3,-5
15022,15022,15023,3,4,1
15023,15023,15024,4,5,1
15024,15024,15025,5,6,1
15025,15025,15026,6,1,-5
15026,15026,15027,1,4,3
15027,15027,15028,4,0,-4
15028,15028,15029,0,9,9
15029,15029,15030,9,2,-7
15030,15030,15031,2,3,1
15031,15031,15032,3,6,3
15032,15032,15033,6,8,2
15033,15033,15034,8,1,-7
15034,15034,15035,1,4,3
15035,15035,15036,4,6,2
15036,15036,15037,6,7,1
15037,15037,15038,7,4,-3
15038,15038,15039,4,2,-2
15039,15039,15040,2,2,0
15040,15040,15041,2,5,3
15041,15041,15042,5,0,-5
15042,15042,15043,0,6,6
15043,15043,15044,6,1,-5
15044,15044,15045,1,3,2
15045,15045,15046,3,0,-3
15046,15046,15047,0,6,6
15047,15047,15048,6,1,-5
15048,15048,15049,1,9,8
15049,15049,15050,9,8,-1
15050,15050,15051,8,6,-2
15051,15051,15052,6,3,-3
15052,15052,15053,3,3,0
15053,15053,15054,3,5,2
15054,15054,15055,5,2,-3
15055,15055,15056,2,8,6
15056,15056,15057,8,2,-6
15057,15057,15058,2,4,2
15058,15058,15059,4,4,0
15059,15059,15060,4,0,-4
15060,15060,15061,0,6,6
15061,15061,15062,6,7,1
15062,15062,15063,7,9,2
15063,15063,15064,9,0,-9
15064,15064,15065,0,0,0
15065,15065,15066,0,5,5
15066,15066,15067,5,2,-3
15067,15067,15068,2,1,-1
15068,15068,15069,1,5,4
15069,15069,15070,5,5,0
15070,15070,15071,5,5,0
15071,15071,15072,5,9,4
15072,15072,15073,9,1,-8
15073,15073,15074,1,7,6
15074,15074,15075,7,3,-4
15075,15075,15076,3,3,0
15076,15076,15077,3,3,0
15077,15077,15078,3,4,1
15078,15078,15079,4,9,5
15079,15079,15080,9,3,-6
15080,15080,15081,3,7,4
15081,15081,15082,7,1,-6
15082,15082,15083,1,2,1
15083,15083,15084,2,6,4
15084,15084,15085,6,5,-1
15085,15085,15086,5,7,2
15086,15086,15087,7,7,0
15087,15087,15088,7,6,-1
15088,15088,15089,6,9,3
15089,15089,15090,9,3,-6
15090,15090,15091,3,8,5
15091,15091,15092,8,4,-4
15092,15092,15093,4,2,-2
15093,15093,15094,2,2,0
15094,15094,15095,2,1,-1
15095,15095,15096,1,8,7
15096,15096,15097,8,3,-5
15097,15097,15098,3,7,4
15098,15098,15099,7,1,-6
15099,15099,15100,1,4,3
15100,15100,15101,4,3,-1
15101,15101,15102,3,8,5
15102,15102,15103,8,0,-8
15103,15103,15104,0,8,8
15104,15104,15105,8,1,-7
15105,15105,15106,1,7,6
15106,15106,15107,7,2,-5
15107,15107,15108,2,0,-2
15108,15108,15109,0,3,3
15109,15109,15110,3,5,2
15110,15110,15111,5,4,-1
15111,15111,15112,4,9,5
15112,15112,15113,9,7,-2
15113,15113,15114,7,6,-1
15114,15114,15115,6,8,2
15115,15115,15116,8,5,-3
15116,15116,15117,5,9,4
15117,15117,15118,9,5,-4
15118,15118,15119,5,0,-5
15119,15119,15120,0,0,0
15120,15120,15121,0,1,1
15121,15121,15122,1,7,6
15122,15122,15123,7,2,-5
15123,15123,15124,2,9,7
15124,15124,15125,9,3,-6
15125,15125,15126,3,5,2
15126,15126,15127,5,7,2
15127,15127,15128,7,9,2
15128,15128,15129,9,8,-1
15129,15129,15130,8,0,-8
15130,15130,15131,0,9,9
15131,15131,15132,9,2,-7
15132,15132,15133,2,0,-2
15133,15133,15134,0,6,6
15134,15134,15135,6,1,-5
15135,15135,15136,1,5,4
15136,15136,15137,5,2,-3
15137,15137,15138,2,1,-1
15138,15138,15139,1,3,2
15139,15139,15140,3,5,2
15140,15140,15141,5,4,-1
15141,15141,15142,4,0,-4
15142,15142,15143,0,5,5
15143,15143,15144,5,5,0
15144,15144,15145,5,6,1
15145,15145,15146,6,9,3
15146,15146,15147,9,7,-2
15147,15147,15148,7,1,-6
15148,15148,15149,1,8,7
15149,15149,15150,8,0,-8
15150,15150,15151,0,9,9
15151,15151,15152,9,1,-8
15152,15152,15153,1,2,1
15153,15153,15154,2,1,-1
15154,15154,15155,1,5,4
15155,15155,15156,5,0,-5
15156,15156,15157,0,1,1
15157,15157,15158,1,8,7
15158,15158,15159,8,6,-2
15159,15159,15160,6,0,-6
15160,15160,15161,0,4,4
15161,15161,15162,4,9,5
15162,15162,15163,9,3,-6
15163,15163,15164,3,1,-2
15164,15164,15165,1,9,8
15165,15165,15166,9,6,-3
15166,15166,15167,6,9,3
15167,15167,15168,9,7,-2
15168,15168,15169,7,0,-7
15169,15169,15170,0,9,9
15170,15170,15171,9,9,0
15171,15171,15172,9,7,-2
15172,15172,15173,7,7,0
15173,15173,15174,7,3,-4
15174,15174,15175,3,1,-2
15175,15175,15176,1,3,2
15176,15176,15177,3,6,3
15177,15177,15178,6,5,-1
15178,15178,15179,5,4,-1
15179,15179,15180,4,4,0
15180,15180,15181,4,3,-1
15181,15181,15182,3,1,-2
15182,15182,15183,1,6,5
15183,15183,15184,6,4,-2
15184,15184,15185,4,2,-2
15185,15185,15186,2,3,1
15186,15186,15187,3,2,-1
15187,15187,15188,2,6,4
15188,15188,15189,6,0,-6
15189,15189,15190,0,6,6
15190,15190,15191,6,0,-6
15191,15191,15192,0,7,7
15192,15192,15193,7,5,-2
15193,15193,15194,5,9,4
15194,15194,15195,9,9,0
15195,15195,15196,9,6,-3
15196,15196,15197,6,5,-1
15197,15197,15198,5,0,-5
15198,15198,15199,0,7,7
15199,15199,15200,7,7,0
15200,15200,15201,7,3,-4
15201,15201,15202,3,7,4
15202,15202,15203,7,2,-5
15203,15203,15204,2,7,5
15204,15204,15205,7,2,-5
15205,15205,15206,2,5,3
15206,15206,15207,5,4,-1
15207,15207,15208,4,0,-4
15208,15208,15209,0,7,7
15209,15209,15210,7,3,-4
15210,15210,15211,3,6,3
15211,15211,15212,6,9,3
15212,15212,15213,9,7,-2
15213,15213,15214,7,4,-3
15214,15214,15215,4,7,3
15215,15215,15216,7,3,-4
15216,15216,15217,3,2,-1
15217,15217,15218,2,4,2
15218,15218,15219,4,8,4
15219,15219,15220,8,6,-2
15220,15220,15221,6,8,2
15221,15221,15222,8,9,1
15222,15222,15223,9,2,-7
15223,15223,15224,2,1,-1
15224,15224,15225,1,8,7
15225,15225,15226,8,3,-5
15226,15226,15227,3,3,0
15227,15227,15228,3,2,-1
15228,15228,15229,2,7,5
15229,15229,15230,7,7,0
15230,15230,15231,7,1,-6
15231,15231,15232,1,5,4
15232,15232,15233,5,3,-2
15233,15233,15234,3,6,3
15234,15234,15235,6,9,3
15235,15235,15236,9,8,-1
15236,15236,15237,8,0,-8
15237,15237,15238,0,5,5
15238,15238,15239,5,9,4
15239,15239,15240,9,1,-8
15240,15240,15241,1,1,0
15241,15241,15242,1,0,-1
15242,15242,15243,0,7,7
15243,15243,15244,7,9,2
15244,15244,15245,9,3,-6
15245,15245,15246,3,3,0
15246,15246,15247,3,8,5
15247,15247,15248,8,8,0
15248,15248,15249,8,0,-8
15249,15249,15250,0,3,3
15250,15250,15251,3,3,0
15251,15251,15252,3,1,-2
15252,15252,15253,1,9,8
15253,15253,15254,9,7,-2
15254,15254,15255,7,1,-6
15255,15255,15256,1,7,6
15256,15256,15257,7,6,-1
15257,15257,15258,6,8,2
15258,15258,15259,8,4,-4
15259,15259,15260,4,7,3
15260,15260,15261,7,3,-4
15261,15261,15262,3,2,-1
15262,15262,15263,2,2,0
15263,15263,15264,2,1,-1
15264,15264,15265,1,1,0
15265,15265,15266,1,1,0
15266,15266,15267,1,8,7
15267,15267,15268,8,9,1
15268,15268,15269,9,6,-3
15269,15269,15270,6,2,-4
15270,15270,15271,2,1,-1
15271,15271,15272,1,2,1
15272,15272,15273,2,5,3
15273,15273,15274,5,4,-1
15274,15274,15275,4,0,-4
15275,15275,15276,0,7,7
15276,15276,15277,7,1,-6
15277,15277,15278,1,2,1
15278,15278,15279,2,2,0
15279,15279,15280,2,6,4
15280,15280,15281,6,3,-3
15281,15281,15282,3,8,5
15282,15282,15283,8,4,-4
15283,15283,15284,4,5,1
15284,15284,15285,5,5,0
15285,15285,15286,5,8,3
15286,15286,15287,8,6,-2
15287,15287,15288,6,0,-6
15288,15288,15289,0,8,8
15289,15289,15290,8,1,-7
15290,15290,15291,1,0,-1
15291,15291,15292,0,3,3
15292,15292,15293,3,1,-2
15293,15293,15294,1,4,3
15294,15294,15295,4,2,-2
15295,15295,15296,2,2,0
15296,15296,15297,2,3,1
15297,15297,15298,3,4,1
15298,15298,15299,4,4,0
15299,15299,15300,4,1,-3
15300,15300,15301,1,5,4
15301,15301,15302,5,9,4
15302,15302,15303,9,6,-3
15303,15303,15304,6,5,-1
15304,15304,15305,5,7,2
15305,15305,15306,7,5,-2
15306,15306,15307,5,8,3
15307,15307,15308,8,1,-7
15308,15308,15309,1,9,8
15309,15309,15310,9,4,-5
15310,15310,15311,4,0,-4
15311,15311,15312,0,9,9
15312,15312,15313,9,4,-5
15313,15313,15314,4,6,2
15314,15314,15315,6,5,-1
15315,15315,15316,5,1,-4
15316,15316,15317,1,6,5
15317,15317,15318,6,0,-6
15318,15318,15319,0,7,7
15319,15319,15320,7,6,-1
15320,15320,15321,6,8,2
15321,15321,15322,8,3,-5
15322,15322,15323,3,9,6
15323,15323,15324,9,6,-3
15324,15324,15325,6,0,-6
15325,15325,15326,0,9,9
15326,15326,15327,9,7,-2
15327,15327,15328,7,2,-5
15328,15328,15329,2,0,-2
15329,15329,15330,0,0,0
15330,15330,15331,0,7,7
15331,15331,15332,7,3,-4
15332,15332,15333,3,8,5
15333,15333,15334,8,6,-2
15334,15334,15335,6,3,-3
15335,15335,15336,3,3,0
15336,15336,15337,3,5,2
15337,15337,15338,5,6,1
15338,15338,15339,6,3,-3
15339,15339,15340,3,7,4
15340,15340,15341,7,8,1
15341,15341,15342,8,3,-5
15342,15342,15343,3,8,5
15343,15343,15344,8,0,-8
15344,15344,15345,0,1,1
15345,15345,15346,1,3,2
15346,15346,15347,3,4,1
15347,15347,15348,4,6,2
15348,15348,15349,6,9,3
15349,15349,15350,9,3,-6
15350,15350,15351,3,6,3
15351,15351,15352,6,4,-2
15352,15352,15353,4,1,-3
15353,15353,15354,1,9,8
15354,15354,15355,9,8,-1
15355,15355,15356,8,1,-7
15356,15356,15357,1,9,8
15357,15357,15358,9,5,-4
15358,15358,15359,5,4,-1
15359,15359,15360,4,9,5
15360,15360,15361,9,1,-8
15361,15361,15362,1,5,4
15362,15362,15363,5,2,-3
15363,15363,15364,2,8,6
15364,15364,15365,8,5,-3
15365,15365,15366,5,8,3
15366,15366,15367,8,9,1
15367,15367,15368,9,2,-7
15368,15368,15369,2,9,7
15369,15369,15370,9,6,-3
15370,15370,15371,6,5,-1
15371,15371,15372,5,3,-2
15372,15372,15373,3,4,1
15373,15373,15374,4,5,1
15374,15374,15375,5,3,-2
15375,15375,15376,3,4,1
15376,15376,15377,4,3,-1
15377,15377,15378,3,5,2
15378,15378,15379,5,3,-2
15379,15379,15380,3,1,-2
15380,15380,15381,1,9,8
15381,15381,15382,9,0,-9
15382,15382,15383,0,0,0
15383,15383,15384,0,6,6
15384,15384,15385,6,1,-5
15385,15385,15386,1,6,5
15386,15386,15387,6,9,3
15387,15387,15388,9,3,-6
15388,15388,15389,3,1,-2
15389,15389,15390,1,5,4
15390,15390,15391,5,2,-3
15391,15391,15392,2,1,-1
15392,15392,15393,1,7,6
15393,15393,15394,7,4,-3
15394,15394,15395,4,9,5
15395,15395,15396,9,1,-8
15396,15396,15397,1,1,0
15397,15397,15398,1,5,4
15398,15398,15399,5,0,-5
15399,15399,15400,0,4,4
15400,15400,15401,4,6,2
15401,15401,15402,6,5,-1
15402,15402,15403,5,2,-3
15403,15403,15404,2,6,4
15404,15404,15405,6,4,-2
15405,15405,15406,4,8,4
15406,15406,15407,8,0,-8
15407,15407,15408,0,8,8
15408,15408,15409,8,3,-5
15409,15409,15410,3,7,4
15410,15410,15411,7,8,1
15411,15411,15412,8,3,-5
15412,15412,15413,3,9,6
15413,15413,15414,9,9,0
15414,15414,15415,9,5,-4
15415,15415,15416,5,4,-1
15416,15416,15417,4,6,2
15417,15417,15418,6,2,-4
15418,15418,15419,2,6,4
15419,15419,15420,6,4,-2
15420,15420,15421,4,5,1
15421,15421,15422,5,7,2
15422,15422,15423,7,1,-6
15423,15423,15424,1,8,7
15424,15424,15425,8,7,-1
15425,15425,15426,7,4,-3
15426,15426,15427,4,1,-3
15427,15427,15428,1,1,0
15428,15428,15429,1,4,3
15429,15429,15430,4,8,4
15430,15430,15431,8,6,-2
15431,15431,15432,6,4,-2
15432,15432,15433,4,9,5
15433,15433,15434,9,2,-7
15434,15434,15435,2,1,-1
15435,15435,15436,1,8,7
15436,15436,15437,8,3,-5
15437,15437,15438,3,1,-2
15438,15438,15439,1,1,0
15439,15439,15440,1,2,1
15440,15440,15441,2,6,4
15441,15441,15442,6,0,-6
15442,15442,15443,0,3,3
15443,15443,15444,3,5,2
15444,15444,15445,5,0,-5
15445,15445,15446,0,9,9
15446,15446,15447,9,6,-3
15447,15447,15448,6,6,0
15448,15448,15449,6,7,1
15449,15449,15450,7,6,-1
15450,15450,15451,6,1,-5
15451,15451,15452,1,7,6
15452,15452,15453,7,3,-4
15453,15453,15454,3,0,-3
15454,15454,15455,0,8,8
15455,15455,15456,8,4,-4
15456,15456,15457,4,2,-2
15457,15457,15458,2,8,6
15458,15458,15459,8,6,-2
15459,15459,15460,6,7,1
15460,15460,15461,7,2,-5
15461,15461,15462,2,5,3
15462,15462,15463,5,6,1
15463,15463,15464,6,5,-1
15464,15464,15465,5,7,2
15465,15465,15466,7,2,-5
15466,15466,15467,2,8,6
15467,15467,15468,8,7,-1
15468,15468,15469,7,7,0
15469,15469,15470,7,2,-5
15470,15470,15471,2,0,-2
15471,15471,15472,0,3,3
15472,15472,15473,3,1,-2
15473,15473,15474,1,3,2
15474,15474,15475,3,2,-1
15475,15475,15476,2,2,0
15476,15476,15477,2,3,1
15477,15477,15478,3,6,3
15478,15478,15479,6,4,-2
15479,15479,15480,4,0,-4
15480,15480,15481,0,5,5
15481,15481,15482,5,3,-2
15482,15482,15483,3,6,3
15483,15483,15484,6,6,0
15484,15484,15485,6,7,1
15485,15485,15486,7,3,-4
15486,15486,15487,3,8,5
15487,15487,15488,8,5,-3
15488,15488,15489,5,9,4
15489,15489,15490,9,7,-2
15490,15490,15491,7,0,-7
15491,15491,15492,0,0,0
15492,15492,15493,0,1,1
15493,15493,15494,1,7,6
15494,15494,15495,7,2,-5
15495,15495,15496,2,3,1
15496,15496,15497,3,3,0
15497,15497,15498,3,9,6
15498,15498,15499,9,7,-2
15499,15499,15500,7,6,-1
15500,15500,15501,6,8,2
15501,15501,15502,8,8,0
15502,15502,15503,8,9,1
15503,15503,15504,9,0,-9
15504,15504,15505,0,0,0
15505,15505,15506,0,2,2
15506,15506,15507,2,1,-1
15507,15507,15508,1,0,-1
15508,15508,15509,0,2,2
15509,15509,15510,2,2,0
15510,15510,15511,2,3,1
15511,15511,15512,3,9,6
15512,15512,15513,9,7,-2
15513,15513,15514,7,4,-3
15514,15514,15515,4,8,4
15515,15515,15516,8,0,-8
15516,15516,15517,0,9,9
15517,15517,15518,9,7,-2
15518,15518,15519,7,3,-4
15519,15519,15520,3,0,-3
15520,15520,15521,0,4,4
15521,15521,15522,4,8,4
15522,15522,15523,8,1,-7
15523,15523,15524,1,0,-1
15524,15524,15525,0,4,4
15525,15525,15526,4,6,2
15526,15526,15527,6,6,0
15527,15527,15528,6,5,-1
15528,15528,15529,5,6,1
15529,15529,15530,6,0,-6
15530,15530,15531,0,7,7
15531,15531,15532,7,8,1
15532,15532,15533,8,3,-5
15533,15533,15534,3,3,0
15534,15534,15535,3,3,0
15535,15535,15536,3,1,-2
15536,15536,15537,1,2,1
15537,15537,15538,2,5,3
15538,15538,15539,5,1,-4
15539,15539,15540,1,3,2
15540,15540,15541,3,9,6
15541,15541,15542,9,0,-9
15542,15542,15543,0,4,4
15543,15543,15544,4,3,-1
15544,15544,15545,3,7,4
15545,15545,15546,7,8,1
15546,15546,15547,8,3,-5
15547,15547,15548,3,1,-2
15548,15548,15549,1,5,4
15549,15549,15550,5,1,-4
15550,15550,15551,1,4,3
15551,15551,15552,4,5,1
15552,15552,15553,5,9,4
15553,15553,15554,9,7,-2
15554,15554,15555,7,1,-6
15555,15555,15556,1,4,3
15556,15556,15557,4,1,-3
15557,15557,15558,1,5,4
15558,15558,15559,5,0,-5
15559,15559,15560,0,9,9
15560,15560,15561,9,1,-8
15561,15561,15562,1,9,8
15562,15562,15563,9,4,-5
15563,15563,15564,4,0,-4
15564,15564,15565,0,6,6
15565,15565,15566,6,0,-6
15566,15566,15567,0,0,0
15567,15567,15568,0,4,4
15568,15568,15569,4,2,-2
15569,15569,15570,2,7,5
15570,15570,15571,7,5,-2
15571,15571,15572,5,3,-2
15572,15572,15573,3,2,-1
15573,15573,15574,2,1,-1
15574,15574,15575,1,1,0
15575,15575,15576,1,4,3
15576,15576,15577,4,7,3
15577,15577,15578,7,1,-6
15578,15578,15579,1,5,4
15579,15579,15580,5,0,-5
15580,15580,15581,0,0,0
15581,15581,15582,0,0,0
15582,15582,15583,0,0,0
15583,15583,15584,0,9,9
15584,15584,15585,9,2,-7
15585,15585,15586,2,7,5
15586,15586,15587,7,3,-4
15587,15587,15588,3,2,-1
15588,15588,15589,2,7,5
15589,15589,15590,7,0,-7
15590,15590,15591,0,6,6
15591,15591,15592,6,9,3
15592,15592,15593,9,9,0
15593,15593,15594,9,5,-4
15594,15594,15595,5,8,3
15595,15595,15596,8,2,-6
15596,15596,15597,2,7,5
15597,15597,15598,7,8,1
15598,15598,15599,8,8,0
15599,15599,15600,8,0,-8
15600,15600,15601,0,9,9
15601,15601,15602,9,9,0
15602,15602,15603,9,2,-7
15603,15603,15604,2,4,2
15604,15604,15605,4,2,-2
15605,15605,15606,2,3,1
15606,15606,15607,3,9,6
15607,15607,15608,9,1,-8
15608,15608,15609,1,9,8
15609,15609,15610,9,8,-1
15610,15610,15611,8,5,-3
15611,15611,15612,5,1,-4
15612,15612,15613,1,4,3
15613,15613,15614,4,2,-2
15614,15614,15615,2,4,2
15615,15615,15616,4,8,4
15616,15616,15617,8,4,-4
15617,15617,15618,4,2,-2
15618,15618,15619,2,0,-2
15619,15619,15620,0,6,6
15620,15620,15621,6,0,-6
15621,15621,15622,0,4,4
15622,15622,15623,4,8,4
15623,15623,15624,8,8,0
15624,15624,15625,8,6,-2
15625,15625,15626,6,8,2
15626,15626,15627,8,6,-2
15627,15627,15628,6,0,-6
15628,15628,15629,0,8,8
15629,15629,15630,8,3,-5
15630,15630,15631,3,5,2
15631,15631,15632,5,1,-4
15632,15632,15633,1,1,0
15633,15633,15634,1,6,5
15634,15634,15635,6,7,1
15635,15635,15636,7,8,1
15636,15636,15637,8,0,-8
15637,15637,15638,0,6,6
15638,15638,15639,6,3,-3
15639,15639,15640,3,8,5
15640,15640,15641,8,6,-2
15641,15641,15642,6,2,-4
15642,15642,15643,2,7,5
15643,15643,15644,7,9,2
15644,15644,15645,9,8,-1
15645,15645,15646,8,7,-1
15646,15646,15647,7,3,-4
15647,15647,15648,3,0,-3
15648,15648,15649,0,1,1
15649,15649,15650,1,2,1
15650,15650,15651,2,3,1
15651,15651,15652,3,6,3
15652,15652,15653,6,9,3
15653,15653,15654,9,9,0
15654,15654,15655,9,5,-4
15655,15655,15656,5,3,-2
15656,15656,15657,3,9,6
15657,15657,15658,9,9,0
15658,15658,15659,9,9,0
15659,15659,15660,9,2,-7
15660,15660,15661,2,5,3
15661,15661,15662,5,0,-5
15662,15662,15663,0,0,0
15663,15663,15664,0,8,8
15664,15664,15665,8,4,-4
15665,15665,15666,4,9,5
15666,15666,15667,9,3,-6
15667,15667,15668,3,4,1
15668,15668,15669,4,1,-3
15669,15669,15670,1,9,8
15670,15670,15671,9,7,-2
15671,15671,15672,7,6,-1
15672,15672,15673,6,6,0
15673,15673,15674,6,6,0
15674,15674,15675,6,0,-6
15675,15675,15676,0,5,5
15676,15676,15677,5,1,-4
15677,15677,15678,1,8,7
15678,15678,15679,8,2,-6
15679,15679,15680,2,2,0
15680,15680,15681,2,3,1
15681,15681,15682,3,4,1
15682,15682,15683,4,4,0
15683,15683,15684,4,1,-3
15684,15684,15685,1,5,4
15685,15685,15686,5,4,-1
15686,15686,15687,4,6,2
15687,15687,15688,6,2,-4
15688,15688,15689,2,7,5
15689,15689,15690,7,7,0
15690,15690,15691,7,8,1
15691,15691,15692,8,0,-8
15692,15692,15693,0,9,9
15693,15693,15694,9,0,-9
15694,15694,15695,0,0,0
15695,15695,15696,0,1,1
15696,15696,15697,1,1,0
15697,15697,15698,1,5,4
15698,15698,15699,5,2,-3
15699,15699,15700,2,0,-2
15700,15700,15701,0,3,3
15701,15701,15702,3,5,2
15702,15702,15703,5,4,-1
15703,15703,15704,4,0,-4
15704,15704,15705,0,7,7
15705,15705,15706,7,6,-1
15706,15706,15707,6,8,2
15707,15707,15708,8,6,-2
15708,15708,15709,6,9,3
15709,15709,15710,9,1,-8
15710,15710,15711,1,0,-1
15711,15711,15712,0,2,2
15712,15712,15713,2,1,-1
15713,15713,15714,1,6,5
15714,15714,15715,6,2,-4
15715,15715,15716,2,1,-1
15716,15716,15717,1,3,2
15717,15717,15718,3,7,4
15718,15718,15719,7,4,-3
15719,15719,15720,4,5,1
15720,15720,15721,5,7,2
15721,15721,15722,7,1,-6
15722,15722,15723,1,8,7
15723,15723,15724,8,8,0
15724,15724,15725,8,9,1
15725,15725,15726,9,5,-4
15726,15726,15727,5,6,1
15727,15727,15728,6,9,3
15728,15728,15729,9,4,-5
15729,15729,15730,4,1,-3
15730,15730,15731,1,2,1
15731,15731,15732,2,5,3
15732,15732,15733,5,6,1
15733,15733,15734,6,0,-6
15734,15734,15735,0,4,4
15735,15735,15736,4,2,-2
15736,15736,15737,2,7,5
15737,15737,15738,7,8,1
15738,15738,15739,8,8,0
15739,15739,15740,8,7,-1
15740,15740,15741,7,9,2
15741,15741,15742,9,5,-4
15742,15742,15743,5,3,-2
15743,15743,15744,3,6,3
15744,15744,15745,6,9,3
15745,15745,15746,9,9,0
15746,15746,15747,9,3,-6
15747,15747,15748,3,2,-1
15748,15748,15749,2,8,6
15749,15749,15750,8,7,-1
15750,15750,15751,7,2,-5
15751,15751,15752,2,4,2
15752,15752,15753,4,0,-4
15753,15753,15754,0,7,7
15754,15754,15755,7,9,2
15755,15755,15756,9,6,-3
15756,15756,15757,6,8,2
15757,15757,15758,8,1,-7
15758,15758,15759,1,0,-1
15759,15759,15760,0,3,3
15760,15760,15761,3,0,-3
15761,15761,15762,0,3,3
15762,15762,15763,3,1,-2
15763,15763,15764,1,3,2
15764,15764,15765,3,0,-3
15765,15765,15766,0,8,8
15766,15766,15767,8,5,-3
15767,15767,15768,5,5,0
15768,15768,15769,5,3,-2
15769,15769,15770,3,0,-3
15770,15770,15771,0,5,5
15771,15771,15772,5,8,3
15772,15772,15773,8,3,-5
15773,15773,15774,3,3,0
15774,15774,15775,3,8,5
15775,15775,15776,8,1,-7
15776,15776,15777,1,0,-1
15777,15777,15778,0,5,5
15778,15778,15779,5,0,-5
15779,15779,15780,0,6,6
15780,15780,15781,6,5,-1
15781,15781,15782,5,8,3
15782,15782,15783,8,4,-4
15783,15783,15784,4,4,0
15784,15784,15785,4,3,-1
15785,15785,15786,3,1,-2
15786,15786,15787,1,4,3
15787,15787,15788,4,6,2
15788,15788,15789,6,1,-5
15789,15789,15790,1,1,0
15790,15790,15791,1,5,4
15791,15791,15792,5,7,2
15792,15792,15793,7,3,-4
15793,15793,15794,3,5,2
15794,15794,15795,5,0,-5
15795,15795,15796,0,2,2
15796,15796,15797,2,6,4
15797,15797,15798,6,0,-6
15798,15798,15799,0,2,2
15799,15799,15800,2,5,3
15800,15800,15801,5,7,2
15801,15801,15802,7,2,-5
15802,15802,15803,2,1,-1
15803,15803,15804,1,5,4
15804,15804,15805,5,1,-4
15805,15805,15806,1,6,5
15806,15806,15807,6,8,2
15807,15807,15808,8,7,-1
15808,15808,15809,7,1,-6
15809,15809,15810,1,5,4
15810,15810,15811,5,7,2
15811,15811,15812,7,5,-2
15812,15812,15813,5,1,-4
15813,15813,15814,1,0,-1
15814,15814,15815,0,3,3
15815,15815,15816,3,3,0
15816,15816,15817,3,8,5
15817,15817,15818,8,7,-1
15818,15818,15819,7,5,-2
15819,15819,15820,5,8,3
15820,15820,15821,8,4,-4
15821,15821,15822,4,4,0
15822,15822,15823,4,2,-2
15823,15823,15824,2,7,5
15824,15824,15825,7,0,-7
15825,15825,15826,0,6,6
15826,15826,15827,6,9,3
15827,15827,15828,9,0,-9
15828,15828,15829,0,2,2
15829,15829,15830,2,5,3
15830,15830,15831,5,6,1
15831,15831,15832,6,9,3
15832,15832,15833,9,7,-2
15833,15833,15834,7,5,-2
15834,15834,15835,5,1,-4
15835,15835,15836,1,2,1
15836,15836,15837,2,9,7
15837,15837,15838,9,1,-8
15838,15838,15839,1,6,5
15839,15839,15840,6,4,-2
15840,15840,15841,4,4,0
15841,15841,15842,4,3,-1
15842,15842,15843,3,6,3
15843,15843,15844,6,9,3
15844,15844,15845,9,2,-7
15845,15845,15846,2,2,0
15846,15846,15847,2,3,1
15847,15847,15848,3,3,0
15848,15848,15849,3,7,4
15849,15849,15850,7,3,-4
15850,15850,15851,3,1,-2
15851,15851,15852,1,4,3
15852,15852,15853,4,2,-2
15853,15853,15854,2,0,-2
15854,15854,15855,0,5,5
15855,15855,15856,5,7,2
15856,15856,15857,7,3,-4
15857,15857,15858,3,9,6
15858,15858,15859,9,7,-2
15859,15859,15860,7,9,2
15860,15860,15861,9,8,-1
15861,15861,15862,8,6,-2
15862,15862,15863,6,0,-6
15863,15863,15864,0,0,0
15864,15864,15865,0,1,1
15865,15865,15866,1,4,3
15866,15866,15867,4,2,-2
15867,15867,15868,2,0,-2
15868,15868,15869,0,3,3
15869,15869,15870,3,6,3
15870,15870,15871,6,4,-2
15871,15871,15872,4,3,-1
15872,15872,15873,3,5,2
15873,15873,15874,5,5,0
15874,15874,15875,5,6,1
15875,15875,15876,6,4,-2
15876,15876,15877,4,7,3
15877,15877,15878,7,1,-6
15878,15878,15879,1,8,7
15879,15879,15880,8,5,-3
15880,15880,15881,5,9,4
15881,15881,15882,9,0,-9
15882,15882,15883,0,0,0
15883,15883,15884,0,5,5
15884,15884,15885,5,1,-4
15885,15885,15886,1,5,4
15886,15886,15887,5,2,-3
15887,15887,15888,2,1,-1
15888,15888,15889,1,3,2
15889,15889,15890,3,0,-3
15890,15890,15891,0,4,4
15891,15891,15892,4,5,1
15892,15892,15893,5,5,0
15893,15893,15894,5,9,4
15894,15894,15895,9,7,-2
15895,15895,15896,7,6,-1
15896,15896,15897,6,8,2
15897,15897,15898,8,1,-7
15898,15898,15899,1,9,8
15899,15899,15900,9,7,-2
15900,15900,15901,7,0,-7
15901,15901,15902,0,2,2
15902,15902,15903,2,1,-1
15903,15903,15904,1,0,-1
15904,15904,15905,0,2,2
15905,15905,15906,2,7,5
15906,15906,15907,7,3,-4
15907,15907,15908,3,6,3
15908,15908,15909,6,7,1
15909,15909,15910,7,0,-7
15910,15910,15911,0,8,8
15911,15911,15912,8,9,1
15912,15912,15913,9,9,0
15913,15913,15914,9,6,-3
15914,15914,15915,6,5,-1
15915,15915,15916,5,4,-1
15916,15916,15917,4,2,-2
15917,15917,15918,2,5,3
15918,15918,15919,5,8,3
15919,15919,15920,8,1,-7
15920,15920,15921,1,1,0
15921,15921,15922,1,7,6
15922,15922,15923,7,7,0
15923,15923,15924,7,6,-1
15924,15924,15925,6,2,-4
15925,15925,15926,2,0,-2
15926,15926,15927,0,4,4
15927,15927,15928,4,0,-4
15928,15928,15929,0,1,1
15929,15929,15930,1,3,2
15930,15930,15931,3,4,1
15931,15931,15932,4,7,3
15932,15932,15933,7,1,-6
15933,15933,15934,1,0,-1
15934,15934,15935,0,8,8
15935,15935,15936,8,3,-5
15936,15936,15937,3,3,0
15937,15937,15938,3,3,0
15938,15938,15939,3,7,4
15939,15939,15940,7,1,-6
15940,15940,15941,1,8,7
15941,15941,15942,8,4,-4
15942,15942,15943,4,4,0
15943,15943,15944,4,9,5
15944,15944,15945,9,3,-6
15945,15945,15946,3,0,-3
15946,15946,15947,0,3,3
15947,15947,15948,3,2,-1
15948,15948,15949,2,5,3
15949,15949,15950,5,8,3
15950,15950,15951,8,6,-2
15951,15951,15952,6,7,1
15952,15952,15953,7,7,0
15953,15953,15954,7,7,0
15954,15954,15955,7,0,-7
15955,15955,15956,0,8,8
15956,15956,15957,8,6,-2
15957,15957,15958,6,2,-4
15958,15958,15959,2,1,-1
15959,15959,15960,1,6,5
15960,15960,15961,6,6,0
15961,15961,15962,6,1,-5
15962,15962,15963,1,8,7
15963,15963,15964,8,1,-7
15964,15964,15965,1,0,-1
15965,15965,15966,0,2,2
15966,15966,15967,2,1,-1
15967,15967,15968,1,3,2
15968,15968,15969,3,5,2
15969,15969,15970,5,9,4
15970,15970,15971,9,0,-9
15971,15971,15972,0,9,9
15972,15972,15973,9,8,-1
15973,15973,15974,8,1,-7
15974,15974,15975,1,5,4
15975,15975,15976,5,7,2
15976,15976,15977,7,1,-6
15977,15977,15978,1,6,5
15978,15978,15979,6,8,2
15979,15979,15980,8,3,-5
15980,15980,15981,3,4,1
15981,15981,15982,4,2,-2
15982,15982,15983,2,7,5
15983,15983,15984,7,5,-2
15984,15984,15985,5,6,1
15985,15985,15986,6,3,-3
15986,15986,15987,3,9,6
15987,15987,15988,9,8,-1
15988,15988,15989,8,1,-7
15989,15989,15990,1,3,2
15990,15990,15991,3,9,6
15991,15991,15992,9,0,-9
15992,15992,15993,0,0,0
15993,15993,15994,0,2,2
15994,15994,15995,2,6,4
15995,15995,15996,6,5,-1
15996,15996,15997,5,7,2
15997,15997,15998,7,7,0
15998,15998,15999,7,1,-6
15999,15999,16000,1,8,7
16000,16000,16001,8,2,-6
16001,16001,16002,2,6,4
16002,16002,16003,6,3,-3
16003,16003,16004,3,7,4
16004,16004,16005,7,9,2
16005,16005,16006,9,9,0
16006,16006,16007,9,2,-7
16007,16007,16008,2,9,7
16008,16008,16009,9,4,-5
16009,16009,16010,4,5,1
16010,16010,16011,5,5,0
16011,16011,16012,5,1,-4
16012,16012,16013,1,3,2
16013,16013,16014,3,1,-2
16014,16014,16015,1,7,6
16015,16015,16016,7,7,0
16016,16016,16017,7,5,-2
16017,16017,16018,5,2,-3
16018,16018,16019,2,3,1
16019,16019,16020,3,9,6
16020,16020,16021,9,1,-8
16021,16021,16022,1,8,7
16022,16022,16023,8,8,0
16023,16023,16024,8,2,-6
16024,16024,16025,2,2,0
16025,16025,16026,2,8,6
16026,16026,16027,8,2,-6
16027,16027,16028,2,5,3
16028,16028,16029,5,3,-2
16029,16029,16030,3,2,-1
16030,16030,16031,2,0,-2
16031,16031,16032,0,6,6
16032,16032,16033,6,2,-4
16033,16033,16034,2,9,7
16034,16034,16035,9,9,0
16035,16035,16036,9,8,-1
16036,16036,16037,8,4,-4
16037,16037,16038,4,5,1
16038,16038,16039,5,9,4
16039,16039,16040,9,8,-1
16040,16040,16041,8,7,-1
16041,16041,16042,7,8,1
16042,16042,16043,8,0,-8
16043,16043,16044,0,8,8
16044,16044,16045,8,0,-8
16045,16045,16046,0,2,2
16046,16046,16047,2,2,0
16047,16047,16048,2,4,2
16048,16048,16049,4,7,3
16049,16049,16050,7,1,-6
16050,16050,16051,1,4,3
16051,16051,16052,4,7,3
16052,16052,16053,7,9,2
16053,16053,16054,9,6,-3
16054,16054,16055,6,9,3
16055,16055,16056,9,6,-3
16056,16056,16057,6,2,-4
16057,16057,16058,2,2,0
16058,16058,16059,2,8,6
16059,16059,16060,8,2,-6
16060,16060,16061,2,1,-1
16061,16061,16062,1,1,0
16062,16062,16063,1,5,4
16063,16063,16064,5,6,1
16064,16064,16065,6,6,0
16065,16065,16066,6,8,2
16066,16066,16067,8,9,1
16067,16067,16068,9,4,-5
16068,16068,16069,4,8,4
16069,16069,16070,8,6,-2
16070,16070,16071,6,3,-3
16071,16071,16072,3,5,2
16072,16072,16073,5,8,3
16073,16073,16074,8,3,-5
16074,16074,16075,3,3,0
16075,16075,16076,3,1,-2
16076,16076,16077,1,6,5
16077,16077,16078,6,3,-3
16078,16078,16079,3,7,4
16079,16079,16080,7,1,-6
16080,16080,16081,1,0,-1
16081,16081,16082,0,9,9
16082,16082,16083,9,0,-9
16083,16083,16084,0,5,5
16084,16084,16085,5,0,-5
16085,16085,16086,0,1,1
16086,16086,16087,1,1,0
16087,16087,16088,1,6,5
16088,16088,16089,6,2,-4
16089,16089,16090,2,9,7
16090,16090,16091,9,3,-6
16091,16091,16092,3,5,2
16092,16092,16093,5,4,-1
16093,16093,16094,4,4,0
16094,16094,16095,4,5,1
16095,16095,16096,5,3,-2
16096,16096,16097,3,6,3
16097,16097,16098,6,4,-2
16098,16098,16099,4,7,3
16099,16099,16100,7,7,0
16100,16100,16101,7,8,1
16101,16101,16102,8,6,-2
16102,16102,16103,6,9,3
16103,16103,16104,9,2,-7
16104,16104,16105,2,0,-2
16105,16105,16106,0,9,9
16106,16106,16107,9,1,-8
16107,16107,16108,1,2,1
16108,16108,16109,2,2,0
16109,16109,16110,2,1,-1
16110,16110,16111,1,3,2
16111,16111,16112,3,5,2
16112,16112,16113,5,7,2
16113,16113,16114,7,8,1
16114,16114,16115,8,8,0
16115,16115,16116,8,5,-3
16116,16116,16117,5,9,4
16117,16117,16118,9,6,-3
16118,16118,16119,6,0,-6
16119,16119,16120,0,5,5
16120,16120,16121,5,1,-4
16121,16121,16122,1,0,-1
16122,16122,16123,0,2,2
16123,16123,16124,2,2,0
16124,16124,16125,2,3,1
16125,16125,16126,3,5,2
16126,16126,16127,5,4,-1
16127,16127,16128,4,8,4
16128,16128,16129,8,5,-3
16129,16129,16130,5,1,-4
16130,16130,16131,1,6,5
16131,16131,16132,6,9,3
16132,16132,16133,9,7,-2
16133,16133,16134,7,3,-4
16134,16134,16135,3,8,5
16135,16135,16136,8,0,-8
16136,16136,16137,0,9,9
16137,16137,16138,9,7,-2
16138,16138,16139,7,0,-7
16139,16139,16140,0,2,2
16140,16140,16141,2,8,6
16141,16141,16142,8,2,-6
16142,16142,16143,2,7,5
16143,16143,16144,7,0,-7
16144,16144,16145,0,8,8
16145,16145,16146,8,2,-6
16146,16146,16147,2,9,7
16147,16147,16148,9,1,-8
16148,16148,16149,1,9,8
16149,16149,16150,9,7,-2
16150,16150,16151,7,0,-7
16151,16151,16152,0,9,9
16152,16152,16153,9,1,-8
16153,16153,16154,1,8,7
16154,16154,16155,8,4,-4
16155,16155,16156,4,3,-1
16156,16156,16157,3,5,2
16157,16157,16158,5,8,3
16158,16158,16159,8,1,-7
16159,16159,16160,1,6,5
16160,16160,16161,6,6,0
16161,16161,16162,6,7,1
16162,16162,16163,7,0,-7
16163,16163,16164,0,5,5
16164,16164,16165,5,5,0
16165,16165,16166,5,2,-3
16166,16166,16167,2,6,4
16167,16167,16168,6,4,-2
16168,16168,16169,4,7,3
16169,16169,16170,7,9,2
16170,16170,16171,9,3,-6
16171,16171,16172,3,8,5
16172,16172,16173,8,9,1
16173,16173,16174,9,5,-4
16174,16174,16175,5,9,4
16175,16175,16176,9,2,-7
16176,16176,16177,2,3,1
16177,16177,16178,3,0,-3
16178,16178,16179,0,8,8
16179,16179,16180,8,4,-4
16180,16180,16181,4,1,-3
16181,16181,16182,1,8,7
16182,16182,16183,8,2,-6
16183,16183,16184,2,8,6
16184,16184,16185,8,9,1
16185,16185,16186,9,7,-2
16186,16186,16187,7,6,-1
16187,16187,16188,6,6,0
16188,16188,16189,6,7,1
16189,16189,16190,7,3,-4
16190,16190,16191,3,3,0
16191,16191,16192,3,0,-3
16192,16192,16193,0,3,3
16193,16193,16194,3,7,4
16194,16194,16195,7,4,-3
16195,16195,16196,4,2,-2
16196,16196,16197,2,7,5
16197,16197,16198,7,2,-5
16198,16198,16199,2,7,5
16199,16199,16200,7,2,-5
16200,16200,16201,2,9,7
16201,16201,16202,9,0,-9
16202,16202,16203,0,1,1
16203,16203,16204,1,1,0
16204,16204,16205,1,7,6
16205,16205,16206,7,4,-3
16206,16206,16207,4,6,2
16207,16207,16208,6,3,-3
16208,16208,16209,3,2,-1
16209,16209,16210,2,5,3
16210,16210,16211,5,1,-4
16211,16211,16212,1,7,6
16212,16212,16213,7,5,-2
16213,16213,16214,5,4,-1
16214,16214,16215,4,5,1
16215,16215,16216,5,4,-1
16216,16216,16217,4,0,-4
16217,16217,16218,0,1,1
16218,16218,16219,1,5,4
16219,16219,16220,5,3,-2
16220,16220,16221,3,0,-3
16221,16221,16222,0,1,1
16222,16222,16223,1,8,7
16223,16223,16224,8,1,-7
16224,16224,16225,1,4,3
16225,16225,16226,4,7,3
16226,16226,16227,7,0,-7
16227,16227,16228,0,1,1
16228,16228,16229,1,3,2
16229,16229,16230,3,8,5
16230,16230,16231,8,8,0
16231,16231,16232,8,8,0
16232,16232,16233,8,1,-7
16233,16233,16234,1,1,0
16234,16234,16235,1,2,1
16235,16235,16236,2,1,-1
16236,16236,16237,1,2,1
16237,16237,16238,2,0,-2
16238,16238,16239,0,3,3
16239,16239,16240,3,7,4
16240,16240,16241,7,1,-6
16241,16241,16242,1,5,4
16242,16242,16243,5,3,-2
16243,16243,16244,3,0,-3
16244,16244,16245,0,6,6
16245,16245,16246,6,8,2
16246,16246,16247,8,7,-1
16247,16247,16248,7,7,0
16248,16248,16249,7,3,-4
16249,16249,16250,3,9,6
16250,16250,16251,9,4,-5
16251,16251,16252,4,8,4
16252,16252,16253,8,9,1
16253,16253,16254,9,1,-8
16254,16254,16255,1,6,5
16255,16255,16256,6,9,3
16256,16256,16257,9,5,-4
16257,16257,16258,5,6,1
16258,16258,16259,6,1,-5
16259,16259,16260,1,3,2
16260,16260,16261,3,9,6
16261,16261,16262,9,1,-8
16262,16262,16263,1,8,7
16263,16263,16264,8,7,-1
16264,16264,16265,7,1,-6
16265,16265,16266,1,8,7
16266,16266,16267,8,1,-7
16267,16267,16268,1,5,4
16268,16268,16269,5,2,-3
16269,16269,16270,2,9,7
16270,16270,16271,9,7,-2
16271,16271,16272,7,7,0
16272,16272,16273,7,6,-1
16273,16273,16274,6,8,2
16274,16274,16275,8,8,0
16275,16275,16276,8,5,-3
16276,16276,16277,5,8,3
16277,16277,16278,8,1,-7
16278,16278,16279,1,4,3
16279,16279,16280,4,9,5
16280,16280,16281,9,2,-7
16281,16281,16282,2,8,6
16282,16282,16283,8,2,-6
16283,16283,16284,2,8,6
16284,16284,16285,8,0,-8
16285,16285,16286,0,0,0
16286,16286,16287,0,1,1
16287,16287,16288,1,7,6
16288,16288,16289,7,2,-5
16289,16289,16290,2,4,2
16290,16290,16291,4,3,-1
16291,16291,16292,3,1,-2
16292,16292,16293,1,4,3
16293,16293,16294,4,2,-2
16294,16294,16295,2,5,3
16295,16295,16296,5,3,-2
16296,16296,16297,3,6,3
16297,16297,16298,6,2,-4
16298,16298,16299,2,7,5
16299,16299,16300,7,1,-6
16300,16300,16301,1,8,7
16301,16301,16302,8,4,-4
16302,16302,16303,4,9,5
16303,16303,16304,9,7,-2
16304,16304,16305,7,0,-7
16305,16305,16306,0,0,0
16306,16306,16307,0,1,1
16307,16307,16308,1,1,0
16308,16308,16309,1,2,1
16309,16309,16310,2,5,3
16310,16310,16311,5,3,-2
16311,16311,16312,3,4,1
16312,16312,16313,4,4,0
16313,16313,16314,4,4,0
16314,16314,16315,4,5,1
16315,16315,16316,5,7,2
16316,16316,16317,7,6,-1
16317,16317,16318,6,0,-6
16318,16318,16319,0,7,7
16319,16319,16320,7,2,-5
16320,16320,16321,2,8,6
16321,16321,16322,8,8,0
16322,16322,16323,8,0,-8
16323,16323,16324,0,7,7
16324,16324,16325,7,1,-6
16325,16325,16326,1,0,-1
16326,16326,16327,0,2,2
16327,16327,16328,2,2,0
16328,16328,16329,2,3,1
16329,16329,16330,3,9,6
16330,16330,16331,9,4,-5
16331,16331,16332,4,6,2
16332,16332,16333,6,5,-1
16333,16333,16334,5,1,-4
16334,16334,16335,1,6,5
16335,16335,16336,6,3,-3
16336,16336,16337,3,7,4
16337,16337,16338,7,4,-3
16338,16338,16339,4,8,4
16339,16339,16340,8,8,0
16340,16340,16341,8,9,1
16341,16341,16342,9,9,0
16342,16342,16343,9,7,-2
16343,16343,16344,7,3,-4
16344,16344,16345,3,1,-2
16345,16345,16346,1,6,5
16346,16346,16347,6,5,-1
16347,16347,16348,5,1,-4
16348,16348,16349,1,6,5
16349,16349,16350,6,9,3
16350,16350,16351,9,2,-7
16351,16351,16352,2,0,-2
16352,16352,16353,0,5,5
16353,16353,16354,5,0,-5
16354,16354,16355,0,0,0
16355,16355,16356,0,5,5
16356,16356,16357,5,5,0
16357,16357,16358,5,5,0
16358,16358,16359,5,4,-1
16359,16359,16360,4,9,5
16360,16360,16361,9,2,-7
16361,16361,16362,2,1,-1
16362,16362,16363,1,0,-1
16363,16363,16364,0,5,5
16364,16364,16365,5,8,3
16365,16365,16366,8,3,-5
16366,16366,16367,3,1,-2
16367,16367,16368,1,1,0
16368,16368,16369,1,7,6
16369,16369,16370,7,3,-4
16370,16370,16371,3,1,-2
16371,16371,16372,1,3,2
16372,16372,16373,3,8,5
16373,16373,16374,8,5,-3
16374,16374,16375,5,3,-2
16375,16375,16376,3,1,-2
16376,16376,16377,1,8,7
16377,16377,16378,8,6,-2
16378,16378,16379,6,7,1
16379,16379,16380,7,5,-2
16380,16380,16381,5,1,-4
16381,16381,16382,1,8,7
16382,16382,16383,8,7,-1
16383,16383,16384,7,5,-2
16384,16384,16385,5,1,-4
16385,16385,16386,1,3,2
16386,16386,16387,3,4,1
16387,16387,16388,4,9,5
16388,16388,16389,9,4,-5
16389,16389,16390,4,2,-2
16390,16390,16391,2,4,2
16391,16391,16392,4,1,-3
16392,16392,16393,1,5,4
16393,16393,16394,5,7,2
16394,16394,16395,7,7,0
16395,16395,16396,7,0,-7
16396,16396,16397,0,4,4
16397,16397,16398,4,8,4
16398,16398,16399,8,4,-4
16399,16399,16400,4,5,1
16400,16400,16401,5,7,2
16401,16401,16402,7,0,-7
16402,16402,16403,0,2,2
16403,16403,16404,2,2,0
16404,16404,16405,2,5,3
16405,16405,16406,5,5,0
16406,16406,16407,5,3,-2
16407,16407,16408,3,2,-1
16408,16408,16409,2,9,7
16409,16409,16410,9,6,-3
16410,16410,16411,6,3,-3
16411,16411,16412,3,0,-3
16412,16412,16413,0,9,9
16413,16413,16414,9,3,-6
16414,16414,16415,3,0,-3
16415,16415,16416,0,8,8
16416,16416,16417,8,8,0
16417,16417,16418,8,1,-7
16418,16418,16419,1,7,6
16419,16419,16420,7,7,0
16420,16420,16421,7,9,2
16421,16421,16422,9,9,0
16422,16422,16423,9,0,-9
16423,16423,16424,0,5,5
16424,16424,16425,5,6,1
16425,16425,16426,6,5,-1
16426,16426,16427,5,3,-2
16427,16427,16428,3,0,-3
16428,16428,16429,0,0,0
16429,16429,16430,0,6,6
16430,16430,16431,6,4,-2
16431,16431,16432,4,8,4
16432,16432,16433,8,6,-2
16433,16433,16434,6,4,-2
16434,16434,16435,4,3,-1
16435,16435,16436,3,6,3
16436,16436,16437,6,7,1
16437,16437,16438,7,4,-3
16438,16438,16439,4,0,-4
16439,16439,16440,0,8,8
16440,16440,16441,8,1,-7
16441,16441,16442,1,5,4
16442,16442,16443,5,4,-1
16443,16443,16444,4,9,5
16444,16444,16445,9,8,-1
16445,16445,16446,8,5,-3
16446,16446,16447,5,1,-4
16447,16447,16448,1,4,3
16448,16448,16449,4,2,-2
16449,16449,16450,2,4,2
16450,16450,16451,4,9,5
16451,16451,16452,9,6,-3
16452,16452,16453,6,3,-3
16453,16453,16454,3,7,4
16454,16454,16455,7,1,-6
16455,16455,16456,1,2,1
16456,16456,16457,2,8,6
16457,16457,16458,8,1,-7
16458,16458,16459,1,4,3
16459,16459,16460,4,0,-4
16460,16460,16461,0,2,2
16461,16461,16462,2,3,1
16462,16462,16463,3,9,6
16463,16463,16464,9,4,-5
16464,16464,16465,4,8,4
16465,16465,16466,8,4,-4
16466,16466,16467,4,8,4
16467,16467,16468,8,1,-7
16468,16468,16469,1,6,5
16469,16469,16470,6,9,3
16470,16470,16471,9,5,-4
16471,16471,16472,5,2,-3
16472,16472,16473,2,2,0
16473,16473,16474,2,0,-2
16474,16474,16475,0,1,1
16475,16475,16476,1,9,8
16476,16476,16477,9,9,0
16477,16477,16478,9,7,-2
16478,16478,16479,7,2,-5
16479,16479,16480,2,9,7
16480,16480,16481,9,9,0
16481,16481,16482,9,2,-7
16482,16482,16483,2,1,-1
16483,16483,16484,1,0,-1
16484,16484,16485,0,0,0
16485,16485,16486,0,8,8
16486,16486,16487,8,5,-3
16487,16487,16488,5,9,4
16488,16488,16489,9,3,-6
16489,16489,16490,3,5,2
16490,16490,16491,5,3,-2
16491,16491,16492,3,3,0
16492,16492,16493,3,6,3
16493,16493,16494,6,5,-1
16494,16494,16495,5,1,-4
16495,16495,16496,1,7,6
16496,16496,16497,7,2,-5
16497,16497,16498,2,0,-2
16498,16498,16499,0,5,5
16499,16499,16500,5,8,3
16500,16500,16501,8,0,-8
16501,16501,16502,0,3,3
16502,16502,16503,3,3,0
16503,16503,16504,3,3,0
16504,16504,16505,3,7,4
16505,16505,16506,7,6,-1
16506,16506,16507,6,6,0
16507,16507,16508,6,1,-5
16508,16508,16509,1,1,0
16509,16509,16510,1,3,2
16510,16510,16511,3,5,2
16511,16511,16512,5,3,-2
16512,16512,16513,3,5,2
16513,16513,16514,5,7,2
16514,16514,16515,7,9,2
16515,16515,16516,9,0,-9
16516,16516,16517,0,8,8
16517,16517,16518,8,0,-8
16518,16518,16519,0,0,0
16519,16519,16520,0,0,0
16520,16520,16521,0,9,9
16521,16521,16522,9,9,0
16522,16522,16523,9,0,-9
16523,16523,16524,0,7,7
16524,16524,16525,7,1,-6
16525,16525,16526,1,4,3
16526,16526,16527,4,2,-2
16527,16527,16528,2,7,5
16528,16528,16529,7,3,-4
16529,16529,16530,3,3,0
16530,16530,16531,3,4,1
16531,16531,16532,4,2,-2
16532,16532,16533,2,5,3
16533,16533,16534,5,6,1
16534,16534,16535,6,6,0
16535,16535,16536,6,1,-5
16536,16536,16537,1,7,6
16537,16537,16538,7,6,-1
16538,16538,16539,6,8,2
16539,16539,16540,8,0,-8
16540,16540,16541,0,9,9
16541,16541,16542,9,4,-5
16542,16542,16543,4,0,-4
16543,16543,16544,0,2,2
16544,16544,16545,2,1,-1
16545,16545,16546,1,1,0
16546,16546,16547,1,2,1
16547,16547,16548,2,7,5
16548,16548,16549,7,3,-4
16549,16549,16550,3,6,3
16550,16550,16551,6,4,-2
16551,16551,16552,4,8,4
16552,16552,16553,8,5,-3
16553,16553,16554,5,8,3
16554,16554,16555,8,6,-2
16555,16555,16556,6,3,-3
16556,16556,16557,3,7,4
16557,16557,16558,7,5,-2
16558,16558,16559,5,8,3
16559,16559,16560,8,6,-2
16560,16560,16561,6,9,3
16561,16561,16562,9,1,-8
16562,16562,16563,1,0,-1
16563,16563,16564,0,3,3
16564,16564,16565,3,1,-2
16565,16565,16566,1,4,3
16566,16566,16567,4,2,-2
16567,16567,16568,2,9,7
16568,16568,16569,9,3,-6
16569,16569,16570,3,9,6
16570,16570,16571,9,4,-5
16571,16571,16572,4,4,0
16572,16572,16573,4,5,1
16573,16573,16574,5,5,0
16574,16574,16575,5,6,1
16575,16575,16576,6,2,-4
16576,16576,16577,2,7,5
16577,16577,16578,7,4,-3
16578,16578,16579,4,8,4
16579,16579,16580,8,9,1
16580,16580,16581,9,9,0
16581,16581,16582,9,5,-4
16582,16582,16583,5,6,1
16583,16583,16584,6,3,-3
16584,16584,16585,3,0,-3
16585,16585,16586,0,5,5
16586,16586,16587,5,3,-2
16587,16587,16588,3,9,6
16588,16588,16589,9,4,-5
16589,16589,16590,4,6,2
16590,16590,16591,6,1,-5
16591,16591,16592,1,5,4
16592,16592,16593,5,4,-1
16593,16593,16594,4,7,3
16594,16594,16595,7,0,-7
16595,16595,16596,0,7,7
16596,16596,16597,7,8,1
16597,16597,16598,8,0,-8
16598,16598,16599,0,6,6
16599,16599,16600,6,4,-2
16600,16600,16601,4,4,0
16601,16601,16602,4,9,5
16602,16602,16603,9,5,-4
16603,16603,16604,5,6,1
16604,16604,16605,6,4,-2
16605,16605,16606,4,0,-4
16606,16606,16607,0,0,0
16607,16607,16608,0,1,1
16608,16608,16609,1,7,6
16609,16609,16610,7,1,-6
16610,16610,16611,1,8,7
16611,16611,16612,8,4,-4
16612,16612,16613,4,7,3
16613,16613,16614,7,1,-6
16614,16614,16615,1,7,6
16615,16615,16616,7,6,-1
16616,16616,16617,6,9,3
16617,16617,16618,9,0,-9
16618,16618,16619,0,0,0
16619,16619,16620,0,3,3
16620,16620,16621,3,9,6
16621,16621,16622,9,9,0
16622,16622,16623,9,7,-2
16623,16623,16624,7,8,1
16624,16624,16625,8,4,-4
16625,16625,16626,4,3,-1
16626,16626,16627,3,2,-1
16627,16627,16628,2,9,7
16628,16628,16629,9,5,-4
16629,16629,16630,5,7,2
16630,16630,16631,7,8,1
16631,16631,16632,8,6,-2
16632,16632,16633,6,5,-1
16633,16633,16634,5,0,-5
16634,16634,16635,0,9,9
16635,16635,16636,9,1,-8
16636,16636,16637,1,8,7
16637,16637,16638,8,2,-6
16638,16638,16639,2,8,6
16639,16639,16640,8,0,-8
16640,16640,16641,0,7,7
16641,16641,16642,7,0,-7
16642,16642,16643,0,1,1
16643,16643,16644,1,7,6
16644,16644,16645,7,3,-4
16645,16645,16646,3,5,2
16646,16646,16647,5,5,0
16647,16647,16648,5,6,1
16648,16648,16649,6,3,-3
16649,16649,16650,3,2,-1
16650,16650,16651,2,1,-1
16651,16651,16652,1,4,3
16652,16652,16653,4,6,2
16653,16653,16654,6,2,-4
16654,16654,16655,2,5,3
16655,16655,16656,5,1,-4
16656,16656,16657,1,3,2
16657,16657,16658,3,8,5
16658,16658,16659,8,8,0
16659,16659,16660,8,1,-7
16660,16660,16661,1,7,6
16661,16661,16662,7,2,-5
16662,16662,16663,2,3,1
16663,16663,16664,3,2,-1
16664,16664,16665,2,1,-1
16665,16665,16666,1,6,5
16666,16666,16667,6,6,0
16667,16667,16668,6,6,0
16668,16668,16669,6,8,2
16669,16669,16670,8,1,-7
16670,16670,16671,1,5,4
16671,16671,16672,5,7,2
16672,16672,16673,7,9,2
16673,16673,16674,9,1,-8
16674,16674,16675,1,2,1
16675,16675,16676,2,3,1
16676,16676,16677,3,2,-1
16677,16677,16678,2,3,1
16678,16678,16679,3,0,-3
16679,16679,16680,0,4,4
16680,16680,16681,4,9,5
16681,16681,16682,9,5,-4
16682,16682,16683,5,2,-3
16683,16683,16684,2,6,4
16684,16684,16685,6,4,-2
16685,16685,16686,4,1,-3
16686,16686,16687,1,7,6
16687,16687,16688,7,8,1
16688,16688,16689,8,3,-5
16689,16689,16690,3,2,-1
16690,16690,16691,2,1,-1
16691,16691,16692,1,5,4
16692,16692,16693,5,3,-2
16693,16693,16694,3,1,-2
16694,16694,16695,1,6,5
16695,16695,16696,6,7,1
16696,16696,16697,7,2,-5
16697,16697,16698,2,5,3
16698,16698,16699,5,1,-4
16699,16699,16700,1,7,6
16700,16700,16701,7,2,-5
16701,16701,16702,2,9,7
16702,16702,16703,9,6,-3
16703,16703,16704,6,9,3
16704,16704,16705,9,0,-9
16705,16705,16706,0,4,4
16706,16706,16707,4,2,-2
16707,16707,16708,2,3,1
16708,16708,16709,3,2,-1
16709,16709,16710,2,7,5
16710,16710,16711,7,7,0
16711,16711,16712,7,7,0
16712,16712,16713,7,1,-6
16713,16713,16714,1,1,0
16714,16714,16715,1,3,2
16715,16715,16716,3,2,-1
16716,16716,16717,2,7,5
16717,16717,16718,7,1,-6
16718,16718,16719,1,4,3
16719,16719,16720,4,1,-3
16720,16720,16721,1,7,6
16721,16721,16722,7,1,-6
16722,16722,16723,1,4,3
16723,16723,16724,4,8,4
16724,16724,16725,8,8,0
16725,16725,16726,8,6,-2
16726,16726,16727,6,9,3
16727,16727,16728,9,6,-3
16728,16728,16729,6,2,-4
16729,16729,16730,2,8,6
16730,16730,16731,8,9,1
16731,16731,16732,9,3,-6
16732,16732,16733,3,5,2
16733,16733,16734,5,9,4
16734,16734,16735,9,1,-8
16735,16735,16736,1,6,5
16736,16736,16737,6,5,-1
16737,16737,16738,5,4,-1
16738,16738,16739,4,6,2
16739,16739,16740,6,9,3
16740,16740,16741,9,8,-1
16741,16741,16742,8,1,-7
16742,16742,16743,1,3,2
16743,16743,16744,3,2,-1
16744,16744,16745,2,5,3
16745,16745,16746,5,6,1
16746,16746,16747,6,6,0
16747,16747,16748,6,3,-3
16748,16748,16749,3,0,-3
16749,16749,16750,0,8,8
16750,16750,16751,8,9,1
16751,16751,16752,9,8,-1
16752,16752,16753,8,9,1
16753,16753,16754,9,2,-7
16754,16754,16755,2,3,1
16755,16755,16756,3,7,4
16756,16756,16757,7,1,-6
16757,16757,16758,1,0,-1
16758,16758,16759,0,1,1
16759,16759,16760,1,2,1
16760,16760,16761,2,0,-2
16761,16761,16762,0,8,8
16762,16762,16763,8,3,-5
16763,16763,16764,3,3,0
16764,16764,16765,3,4,1
16765,16765,16766,4,6,2
16766,16766,16767,6,5,-1
16767,16767,16768,5,6,1
16768,16768,16769,6,6,0
16769,16769,16770,6,9,3
16770,16770,16771,9,7,-2
16771,16771,16772,7,2,-5
16772,16772,16773,2,8,6
16773,16773,16774,8,3,-5
16774,16774,16775,3,9,6
16775,16775,16776,9,9,0
16776,16776,16777,9,0,-9
16777,16777,16778,0,9,9
16778,16778,16779,9,1,-8
16779,16779,16780,1,5,4
16780,16780,16781,5,2,-3
16781,16781,16782,2,6,4
16782,16782,16783,6,3,-3
16783,16783,16784,3,5,2
16784,16784,16785,5,8,3
16785,16785,16786,8,6,-2
16786,16786,16787,6,0,-6
16787,16787,16788,0,6,6
16788,16788,16789,6,1,-5
16789,16789,16790,1,8,7
16790,16790,16791,8,2,-6
16791,16791,16792,2,6,4
16792,16792,16793,6,3,-3
16793,16793,16794,3,2,-1
16794,16794,16795,2,7,5
16795,16795,16796,7,6,-1
16796,16796,16797,6,8,2
16797,16797,16798,8,8,0
16798,16798,16799,8,9,1
16799,16799,16800,9,7,-2
16800,16800,16801,7,9,2
16801,16801,16802,9,4,-5
16802,16802,16803,4,0,-4
16803,16803,16804,0,9,9
16804,16804,16805,9,1,-8
16805,16805,16806,1,9,8
16806,16806,16807,9,4,-5
16807,16807,16808,4,9,5
16808,16808,16809,9,7,-2
16809,16809,16810,7,2,-5
16810,16810,16811,2,3,1
16811,16811,16812,3,2,-1
16812,16812,16813,2,2,0
16813,16813,16814,2,9,7
16814,16814,16815,9,9,0
16815,16815,16816,9,9,0
16816,16816,16817,9,0,-9
16817,16817,16818,0,4,4
16818,16818,16819,4,5,1
16819,16819,16820,5,8,3
16820,16820,16821,8,6,-2
16821,16821,16822,6,6,0
16822,16822,16823,6,7,1
16823,16823,16824,7,8,1
16824,16824,16825,8,3,-5
16825,16825,16826,3,8,5
16826,16826,16827,8,9,1
16827,16827,16828,9,8,-1
16828,16828,16829,8,9,1
16829,16829,16830,9,6,-3
16830,16830,16831,6,3,-3
16831,16831,16832,3,5,2
16832,16832,16833,5,8,3
16833,16833,16834,8,5,-3
16834,16834,16835,5,1,-4
16835,16835,16836,1,7,6
16836,16836,16837,7,2,-5
16837,16837,16838,2,1,-1
16838,16838,16839,1,9,8
16839,16839,16840,9,7,-2
16840,16840,16841,7,6,-1
16841,16841,16842,6,7,1
16842,16842,16843,7,7,0
16843,16843,16844,7,5,-2
16844,16844,16845,5,5,0
16845,16845,16846,5,9,4
16846,16846,16847,9,6,-3
16847,16847,16848,6,7,1
16848,16848,16849,7,3,-4
16849,16849,16850,3,4,1
16850,16850,16851,4,4,0
16851,16851,16852,4,7,3
16852,16852,16853,7,9,2
16853,16853,16854,9,9,0
16854,16854,16855,9,1,-8
16855,16855,16856,1,4,3
16856,16856,16857,4,2,-2
16857,16857,16858,2,2,0
16858,16858,16859,2,9,7
16859,16859,16860,9,8,-1
16860,16860,16861,8,3,-5
16861,16861,16862,3,5,2
16862,16862,16863,5,4,-1
16863,16863,16864,4,8,4
16864,16864,16865,8,4,-4
16865,16865,16866,4,0,-4
16866,16866,16867,0,3,3
16867,16867,16868,3,0,-3
16868,16868,16869,0,1,1
16869,16869,16870,1,8,7
16870,16870,16871,8,7,-1
16871,16871,16872,7,1,-6
16872,16872,16873,1,3,2
16873,16873,16874,3,4,1
16874,16874,16875,4,4,0
16875,16875,16876,4,1,-3
16876,16876,16877,1,9,8
16877,16877,16878,9,9,0
16878,16878,16879,9,6,-3
16879,16879,16880,6,8,2
16880,16880,16881,8,9,1
16881,16881,16882,9,7,-2
16882,16882,16883,7,8,1
16883,16883,16884,8,9,1
16884,16884,16885,9,1,-8
16885,16885,16886,1,4,3
16886,16886,16887,4,1,-3
16887,16887,16888,1,0,-1
16888,16888,16889,0,6,6
16889,16889,16890,6,6,0
16890,16890,16891,6,6,0
16891,16891,16892,6,3,-3
16892,16892,16893,3,8,5
16893,16893,16894,8,6,-2
16894,16894,16895,6,2,-4
16895,16895,16896,2,6,4
16896,16896,16897,6,8,2
16897,16897,16898,8,6,-2
16898,16898,16899,6,4,-2
16899,16899,16900,4,3,-1
16900,16900,16901,3,8,5
16901,16901,16902,8,2,-6
16902,16902,16903,2,0,-2
16903,16903,16904,0,1,1
16904,16904,16905,1,0,-1
16905,16905,16906,0,1,1
16906,16906,16907,1,1,0
16907,16907,16908,1,5,4
16908,16908,16909,5,2,-3
16909,16909,16910,2,5,3
16910,16910,16911,5,3,-2
16911,16911,16912,3,4,1
16912,16912,16913,4,4,0
16913,16913,16914,4,1,-3
16914,16914,16915,1,7,6
16915,16915,16916,7,2,-5
16916,16916,16917,2,8,6
16917,16917,16918,8,9,1
16918,16918,16919,9,9,0
16919,16919,16920,9,8,-1
16920,16920,16921,8,0,-8
16921,16921,16922,0,3,3
16922,16922,16923,3,1,-2
16923,16923,16924,1,3,2
16924,16924,16925,3,2,-1
16925,16925,16926,2,5,3
16926,16926,16927,5,3,-2
16927,16927,16928,3,0,-3
16928,16928,16929,0,4,4
16929,16929,16930,4,1,-3
16930,16930,16931,1,5,4
16931,16931,16932,5,1,-4
16932,16932,16933,1,6,5
16933,16933,16934,6,9,3
16934,16934,16935,9,7,-2
16935,16935,16936,7,6,-1
16936,16936,16937,6,8,2
16937,16937,16938,8,1,-7
16938,16938,16939,1,9,8
16939,16939,16940,9,3,-6
16940,16940,16941,3,0,-3
16941,16941,16942,0,4,4
16942,16942,16943,4,1,-3
16943,16943,16944,1,1,0
16944,16944,16945,1,3,2
16945,16945,16946,3,1,-2
16946,16946,16947,1,4,3
16947,16947,16948,4,2,-2
16948,16948,16949,2,7,5
16949,16949,16950,7,1,-6
16950,16950,16951,1,8,7
16951,16951,16952,8,2,-6
16952,16952,16953,2,9,7
16953,16953,16954,9,3,-6
16954,16954,16955,3,8,5
16955,16955,16956,8,5,-3
16956,16956,16957,5,6,1
16957,16957,16958,6,2,-4
16958,16958,16959,2,5,3
16959,16959,16960,5,1,-4
16960,16960,16961,1,0,-1
16961,16961,16962,0,7,7
16962,16962,16963,7,6,-1
16963,16963,16964,6,8,2
16964,16964,16965,8,8,0
16965,16965,16966,8,7,-1
16966,16966,16967,7,9,2
16967,16967,16968,9,9,0
16968,16968,16969,9,4,-5
16969,16969,16970,4,7,3
16970,16970,16971,7,1,-6
16971,16971,16972,1,8,7
16972,16972,16973,8,9,1
16973,16973,16974,9,8,-1
16974,16974,16975,8,0,-8
16975,16975,16976,0,6,6
16976,16976,16977,6,4,-2
16977,16977,16978,4,7,3
16978,16978,16979,7,8,1
16979,16979,16980,8,5,-3
16980,16980,16981,5,9,4
16981,16981,16982,9,4,-5
16982,16982,16983,4,1,-3
16983,16983,16984,1,7,6
16984,16984,16985,7,4,-3
16985,16985,16986,4,7,3
16986,16986,16987,7,0,-7
16987,16987,16988,0,1,1
16988,16988,16989,1,2,1
16989,16989,16990,2,7,5
16990,16990,16991,7,1,-6
16991,16991,16992,1,9,8
16992,16992,16993,9,5,-4
16993,16993,16994,5,8,3
16994,16994,16995,8,4,-4
16995,16995,16996,4,4,0
16996,16996,16997,4,0,-4
16997,16997,16998,0,6,6
16998,16998,16999,6,7,1
16999,16999,17000,7,3,-4
17000,17000,17001,3,6,3
17001,17001,17002,6,9,3
17002,17002,17003,9,0,-9
17003,17003,17004,0,6,6
17004,17004,17005,6,1,-5
17005,17005,17006,1,5,4
17006,17006,17007,5,7,2
17007,17007,17008,7,6,-1
17008,17008,17009,6,0,-6
17009,17009,17010,0,3,3
17010,17010,17011,3,6,3
17011,17011,17012,6,1,-5
17012,17012,17013,1,8,7
17013,17013,17014,8,6,-2
17014,17014,17015,6,4,-2
17015,17015,17016,4,5,1
17016,17016,17017,5,7,2
17017,17017,17018,7,4,-3
17018,17018,17019,4,9,5
17019,17019,17020,9,4,-5
17020,17020,17021,4,8,4
17021,17021,17022,8,1,-7
17022,17022,17023,1,6,5
17023,17023,17024,6,5,-1
17024,17024,17025,5,0,-5
17025,17025,17026,0,3,3
17026,17026,17027,3,8,5
17027,17027,17028,8,1,-7
17028,17028,17029,1,1,0
17029,17029,17030,1,1,0
17030,17030,17031,1,7,6
17031,17031,17032,7,1,-6
17032,17032,17033,1,7,6
17033,17033,17034,7,6,-1
17034,17034,17035,6,1,-5
17035,17035,17036,1,8,7
17036,17036,17037,8,3,-5
17037,17037,17038,3,3,0
17038,17038,17039,3,2,-1
17039,17039,17040,2,3,1
17040,17040,17041,3,3,0
17041,17041,17042,3,1,-2
17042,17042,17043,1,1,0
17043,17043,17044,1,7,6
17044,17044,17045,7,4,-3
17045,17045,17046,4,2,-2
17046,17046,17047,2,2,0
17047,17047,17048,2,0,-2
17048,17048,17049,0,0,0
17049,17049,17050,0,0,0
17050,17050,17051,0,0,0
17051,17051,17052,0,2,2
17052,17052,17053,2,7,5
17053,17053,17054,7,7,0
17054,17054,17055,7,8,1
17055,17055,17056,8,8,0
17056,17056,17057,8,4,-4
17057,17057,17058,4,1,-3
17058,17058,17059,1,6,5
17059,17059,17060,6,8,2
17060,17060,17061,8,9,1
17061,17061,17062,9,3,-6
17062,17062,17063,3,3,0
17063,17063,17064,3,0,-3
17064,17064,17065,0,8,8
17065,17065,17066,8,6,-2
17066,17066,17067,6,4,-2
17067,17067,17068,4,7,3
17068,17068,17069,7,7,0
17069,17069,17070,7,2,-5
17070,17070,17071,2,2,0
17071,17071,17072,2,1,-1
17072,17072,17073,1,5,4
17073,17073,17074,5,4,-1
17074,17074,17075,4,6,2
17075,17075,17076,6,4,-2
17076,17076,17077,4,3,-1
17077,17077,17078,3,2,-1
17078,17078,17079,2,6,4
17079,17079,17080,6,2,-4
17080,17080,17081,2,9,7
17081,17081,17082,9,3,-6
17082,17082,17083,3,6,3
17083,17083,17084,6,8,2
17084,17084,17085,8,3,-5
17085,17085,17086,3,7,4
17086,17086,17087,7,2,-5
17087,17087,17088,2,3,1
17088,17088,17089,3,2,-1
17089,17089,17090,2,1,-1
17090,17090,17091,1,4,3
17091,17091,17092,4,9,5
17092,17092,17093,9,6,-3
17093,17093,17094,6,5,-1
17094,17094,17095,5,0,-5
17095,17095,17096,0,8,8
17096,17096,17097,8,5,-3
17097,17097,17098,5,6,1
17098,17098,17099,6,5,-1
17099,17099,17100,5,3,-2
17100,17100,17101,3,1,-2
17101,17101,17102,1,4,3
17102,17102,17103,4,3,-1
17103,17103,17104,3,3,0
17104,17104,17105,3,3,0
17105,17105,17106,3,0,-3
17106,17106,17107,0,9,9
17107,17107,17108,9,0,-9
17108,17108,17109,0,7,7
17109,17109,17110,7,2,-5
17110,17110,17111,2,8,6
17111,17111,17112,8,8,0
17112,17112,17113,8,7,-1
17113,17113,17114,7,7,0
17114,17114,17115,7,2,-5
17115,17115,17116,2,3,1
17116,17116,17117,3,7,4
17117,17117,17118,7,5,-2
17118,17118,17119,5,9,4
17119,17119,17120,9,6,-3
17120,17120,17121,6,8,2
17121,17121,17122,8,0,-8
17122,17122,17123,0,2,2
17123,17123,17124,2,0,-2
17124,17124,17125,0,1,1
17125,17125,17126,1,6,5
17126,17126,17127,6,3,-3
17127,17127,17128,3,8,5
17128,17128,17129,8,1,-7
17129,17129,17130,1,1,0
17130,17130,17131,1,3,2
17131,17131,17132,3,5,2
17132,17132,17133,5,0,-5
17133,17133,17134,0,0,0
17134,17134,17135,0,1,1
17135,17135,17136,1,7,6
17136,17136,17137,7,2,-5
17137,17137,17138,2,5,3
17138,17138,17139,5,3,-2
17139,17139,17140,3,7,4
17140,17140,17141,7,4,-3
17141,17141,17142,4,9,5
17142,17142,17143,9,7,-2
17143,17143,17144,7,7,0
17144,17144,17145,7,8,1
17145,17145,17146,8,3,-5
17146,17146,17147,3,9,6
17147,17147,17148,9,3,-6
17148,17148,17149,3,0,-3
17149,17149,17150,0,6,6
17150,17150,17151,6,1,-5
17151,17151,17152,1,9,8
17152,17152,17153,9,2,-7
17153,17153,17154,2,3,1
17154,17154,17155,3,3,0
17155,17155,17156,3,5,2
17156,17156,17157,5,4,-1
17157,17157,17158,4,4,0
17158,17158,17159,4,5,1
17159,17159,17160,5,8,3
17160,17160,17161,8,6,-2
17161,17161,17162,6,8,2
17162,17162,17163,8,7,-1
17163,17163,17164,7,6,-1
17164,17164,17165,6,8,2
17165,17165,17166,8,9,1
17166,17166,17167,9,9,0
17167,17167,17168,9,6,-3
17168,17168,17169,6,0,-6
17169,17169,17170,0,8,8
17170,17170,17171,8,1,-7
17171,17171,17172,1,5,4
17172,17172,17173,5,2,-3
17173,17173,17174,2,6,4
17174,17174,17175,6,3,-3
17175,17175,17176,3,6,3
17176,17176,17177,6,7,1
17177,17177,17178,7,8,1
17178,17178,17179,8,8,0
17179,17179,17180,8,1,-7
17180,17180,17181,1,9,8
17181,17181,17182,9,4,-5
17182,17182,17183,4,7,3
17183,17183,17184,7,1,-6
17184,17184,17185,1,7,6
17185,17185,17186,7,9,2
17186,17186,17187,9,0,-9
17187,17187,17188,0,2,2
17188,17188,17189,2,3,1
17189,17189,17190,3,9,6
17190,17190,17191,9,1,-8
17191,17191,17192,1,3,2
17192,17192,17193,3,8,5
17193,17193,17194,8,8,0
17194,17194,17195,8,9,1
17195,17195,17196,9,8,-1
17196,17196,17197,8,8,0
17197,17197,17198,8,4,-4
17198,17198,17199,4,6,2
17199,17199,17200,6,0,-6
17200,17200,17201,0,5,5
17201,17201,17202,5,2,-3
17202,17202,17203,2,4,2
17203,17203,17204,4,6,2
17204,17204,17205,6,7,1
17205,17205,17206,7,7,0
17206,17206,17207,7,3,-4
17207,17207,17208,3,3,0
17208,17208,17209,3,1,-2
17209,17209,17210,1,0,-1
17210,17210,17211,0,9,9
17211,17211,17212,9,2,-7
17212,17212,17213,2,1,-1
17213,17213,17214,1,0,-1
17214,17214,17215,0,4,4
17215,17215,17216,4,2,-2
17216,17216,17217,2,5,3
17217,17217,17218,5,4,-1
17218,17218,17219,4,5,1
17219,17219,17220,5,2,-3
17220,17220,17221,2,6,4
17221,17221,17222,6,8,2
17222,17222,17223,8,0,-8
17223,17223,17224,0,5,5
17224,17224,17225,5,1,-4
17225,17225,17226,1,9,8
17226,17226,17227,9,3,-6
17227,17227,17228,3,7,4
17228,17228,17229,7,6,-1
17229,17229,17230,6,2,-4
17230,17230,17231,2,4,2
17231,17231,17232,4,1,-3
17232,17232,17233,1,8,7
17233,17233,17234,8,9,1
17234,17234,17235,9,9,0
17235,17235,17236,9,0,-9
17236,17236,17237,0,8,8
17237,17237,17238,8,4,-4
17238,17238,17239,4,5,1
17239,17239,17240,5,1,-4
17240,17240,17241,1,2,1
17241,17241,17242,2,3,1
17242,17242,17243,3,1,-2
17243,17243,17244,1,8,7
17244,17244,17245,8,0,-8
17245,17245,17246,0,2,2
17246,17246,17247,2,5,3
17247,17247,17248,5,7,2
17248,17248,17249,7,6,-1
17249,17249,17250,6,4,-2
17250,17250,17251,4,6,2
17251,17251,17252,6,6,0
17252,17252,17253,6,3,-3
17253,17253,17254,3,1,-2
17254,17254,17255,1,3,2
17255,17255,17256,3,4,1
17256,17256,17257,4,3,-1
17257,17257,17258,3,3,0
17258,17258,17259,3,1,-2
17259,17259,17260,1,1,0
17260,17260,17261,1,7,6
17261,17261,17262,7,1,-6
17262,17262,17263,1,2,1
17263,17263,17264,2,5,3
17264,17264,17265,5,2,-3
17265,17265,17266,2,2,0
17266,17266,17267,2,7,5
17267,17267,17268,7,4,-3
17268,17268,17269,4,2,-2
17269,17269,17270,2,8,6
17270,17270,17271,8,3,-5
17271,17271,17272,3,2,-1
17272,17272,17273,2,6,4
17273,17273,17274,6,3,-3
17274,17274,17275,3,8,5
17275,17275,17276,8,4,-4
17276,17276,17277,4,5,1
17277,17277,17278,5,7,2
17278,17278,17279,7,1,-6
17279,17279,17280,1,3,2
17280,17280,17281,3,4,1
17281,17281,17282,4,7,3
17282,17282,17283,7,9,2
17283,17283,17284,9,6,-3
17284,17284,17285,6,0,-6
17285,17285,17286,0,1,1
17286,17286,17287,1,6,5
17287,17287,17288,6,3,-3
17288,17288,17289,3,8,5
17289,17289,17290,8,8,0
17290,17290,17291,8,8,0
17291,17291,17292,8,3,-5
17292,17292,17293,3,0,-3
17293,17293,17294,0,5,5
17294,17294,17295,5,3,-2
17295,17295,17296,3,9,6
17296,17296,17297,9,9,0
17297,17297,17298,9,5,-4
17298,17298,17299,5,4,-1
17299,17299,17300,4,4,0
17300,17300,17301,4,3,-1
17301,17301,17302,3,8,5
17302,17302,17303,8,7,-1
17303,17303,17304,7,0,-7
17304,17304,17305,0,1,1
17305,17305,17306,1,7,6
17306,17306,17307,7,7,0
17307,17307,17308,7,3,-4
17308,17308,17309,3,6,3
17309,17309,17310,6,9,3
17310,17310,17311,9,9,0
17311,17311,17312,9,5,-4
17312,17312,17313,5,4,-1
17313,17313,17314,4,0,-4
17314,17314,17315,0,2,2
17315,17315,17316,2,7,5
17316,17316,17317,7,9,2
17317,17317,17318,9,3,-6
17318,17318,17319,3,9,6
17319,17319,17320,9,3,-6
17320,17320,17321,3,4,1
17321,17321,17322,4,0,-4
17322,17322,17323,0,9,9
17323,17323,17324,9,3,-6
17324,17324,17325,3,4,1
17325,17325,17326,4,6,2
17326,17326,17327,6,0,-6
17327,17327,17328,0,3,3
17328,17328,17329,3,7,4
17329,17329,17330,7,3,-4
17330,17330,17331,3,1,-2
17331,17331,17332,1,6,5
17332,17332,17333,6,3,-3
17333,17333,17334,3,0,-3
17334,17334,17335,0,0,0
17335,17335,17336,0,2,2
17336,17336,17337,2,1,-1
17337,17337,17338,1,5,4
17338,17338,17339,5,2,-3
17339,17339,17340,2,7,5
17340,17340,17341,7,3,-4
17341,17341,17342,3,9,6
17342,17342,17343,9,7,-2
17343,17343,17344,7,6,-1
17344,17344,17345,6,8,2
17345,17345,17346,8,9,1
17346,17346,17347,9,9,0
17347,17347,17348,9,8,-1
17348,17348,17349,8,0,-8
17349,17349,17350,0,7,7
17350,17350,17351,7,1,-6
17351,17351,17352,1,3,2
17352,17352,17353,3,2,-1
17353,17353,17354,2,3,1
17354,17354,17355,3,3,0
17355,17355,17356,3,7,4
17356,17356,17357,7,4,-3
17357,17357,17358,4,8,4
17358,17358,17359,8,7,-1
17359,17359,17360,7,0,-7
17360,17360,17361,0,8,8
17361,17361,17362,8,8,0
17362,17362,17363,8,9,1
17363,17363,17364,9,8,-1
17364,17364,17365,8,0,-8
17365,17365,17366,0,5,5
17366,17366,17367,5,1,-4
17367,17367,17368,1,7,6
17368,17368,17369,7,2,-5
17369,17369,17370,2,7,5
17370,17370,17371,7,3,-4
17371,17371,17372,3,2,-1
17372,17372,17373,2,7,5
17373,17373,17374,7,2,-5
17374,17374,17375,2,8,6
17375,17375,17376,8,0,-8
17376,17376,17377,0,9,9
17377,17377,17378,9,1,-8
17378,17378,17379,1,0,-1
17379,17379,17380,0,7,7
17380,17380,17381,7,0,-7
17381,17381,17382,0,6,6
17382,17382,17383,6,7,1
17383,17383,17384,7,9,2
17384,17384,17385,9,5,-4
17385,17385,17386,5,3,-2
17386,17386,17387,3,5,2
17387,17387,17388,5,7,2
17388,17388,17389,7,3,-4
17389,17389,17390,3,4,1
17390,17390,17391,4,7,3
17391,17391,17392,7,0,-7
17392,17392,17393,0,8,8
17393,17393,17394,8,1,-7
17394,17394,17395,1,6,5
17395,17395,17396,6,6,0
17396,17396,17397,6,6,0
17397,17397,17398,6,9,3
17398,17398,17399,9,4,-5
17399,17399,17400,4,5,1
17400,17400,17401,5,6,1
17401,17401,17402,6,1,-5
17402,17402,17403,1,3,2
17403,17403,17404,3,3,0
17404,17404,17405,3,8,5
17405,17405,17406,8,4,-4
17406,17406,17407,4,8,4
17407,17407,17408,8,6,-2
17408,17408,17409,6,3,-3
17409,17409,17410,3,9,6
17410,17410,17411,9,0,-9
17411,17411,17412,0,4,4
17412,17412,17413,4,1,-3
17413,17413,17414,1,5,4
17414,17414,17415,5,4,-1
17415,17415,17416,4,6,2
17416,17416,17417,6,4,-2
17417,17417,17418,4,1,-3
17418,17418,17419,1,7,6
17419,17419,17420,7,7,0
17420,17420,17421,7,3,-4
17421,17421,17422,3,1,-2
17422,17422,17423,1,1,0
17423,17423,17424,1,7,6
17424,17424,17425,7,1,-6
17425,17425,17426,1,6,5
17426,17426,17427,6,9,3
17427,17427,17428,9,4,-5
17428,17428,17429,4,1,-3
17429,17429,17430,1,1,0
17430,17430,17431,1,2,1
17431,17431,17432,2,2,0
17432,17432,17433,2,1,-1
17433,17433,17434,1,2,1
17434,17434,17435,2,3,1
17435,17435,17436,3,5,2
17436,17436,17437,5,9,4
17437,17437,17438,9,1,-8
17438,17438,17439,1,2,1
17439,17439,17440,2,7,5
17440,17440,17441,7,7,0
17441,17441,17442,7,3,-4
17442,17442,17443,3,7,4
17443,17443,17444,7,4,-3
17444,17444,17445,4,9,5
17445,17445,17446,9,5,-4
17446,17446,17447,5,9,4
17447,17447,17448,9,2,-7
17448,17448,17449,2,0,-2
17449,17449,17450,0,4,4
17450,17450,17451,4,4,0
17451,17451,17452,4,0,-4
17452,17452,17453,0,5,5
17453,17453,17454,5,0,-5
17454,17454,17455,0,9,9
17455,17455,17456,9,8,-1
17456,17456,17457,8,1,-7
17457,17457,17458,1,0,-1
17458,17458,17459,0,1,1
17459,17459,17460,1,3,2
17460,17460,17461,3,5,2
17461,17461,17462,5,0,-5
17462,17462,17463,0,9,9
17463,17463,17464,9,2,-7
17464,17464,17465,2,1,-1
17465,17465,17466,1,0,-1
17466,17466,17467,0,3,3
17467,17467,17468,3,5,2
17468,17468,17469,5,4,-1
17469,17469,17470,4,3,-1
17470,17470,17471,3,3,0
17471,17471,17472,3,1,-2
17472,17472,17473,1,1,0
17473,17473,17474,1,4,3
17474,17474,17475,4,9,5
17475,17475,17476,9,0,-9
17476,17476,17477,0,1,1
17477,17477,17478,1,4,3
17478,17478,17479,4,0,-4
17479,17479,17480,0,2,2
17480,17480,17481,2,7,5
17481,17481,17482,7,2,-5
17482,17482,17483,2,7,5
17483,17483,17484,7,6,-1
17484,17484,17485,6,0,-6
17485,17485,17486,0,7,7
17486,17486,17487,7,1,-6
17487,17487,17488,1,1,0
17488,17488,17489,1,2,1
17489,17489,17490,2,7,5
17490,17490,17491,7,3,-4
17491,17491,17492,3,4,1
17492,17492,17493,4,4,0
17493,17493,17494,4,5,1
17494,17494,17495,5,5,0
17495,17495,17496,5,3,-2
17496,17496,17497,3,7,4
17497,17497,17498,7,4,-3
17498,17498,17499,4,8,4
17499,17499,17500,8,2,-6
17500,17500,17501,2,9,7
17501,17501,17502,9,5,-4
17502,17502,17503,5,0,-5
17503,17503,17504,0,5,5
17504,17504,17505,5,1,-4
17505,17505,17506,1,8,7
17506,17506,17507,8,2,-6
17507,17507,17508,2,0,-2
17508,17508,17509,0,3,3
17509,17509,17510,3,6,3
17510,17510,17511,6,4,-2
17511,17511,17512,4,8,4
17512,17512,17513,8,7,-1
17513,17513,17514,7,5,-2
17514,17514,17515,5,8,3
17515,17515,17516,8,2,-6
17516,17516,17517,2,9,7
17517,17517,17518,9,0,-9
17518,17518,17519,0,0,0
17519,17519,17520,0,2,2
17520,17520,17521,2,3,1
17521,17521,17522,3,5,2
17522,17522,17523,5,4,-1
17523,17523,17524,4,6,2
17524,17524,17525,6,7,1
17525,17525,17526,7,3,-4
17526,17526,17527,3,8,5
17527,17527,17528,8,6,-2
17528,17528,17529,6,9,3
17529,17529,17530,9,8,-1
17530,17530,17531,8,9,1
17531,17531,17532,9,7,-2
17532,17532,17533,7,7,0
17533,17533,17534,7,0,-7
17534,17534,17535,0,0,0
17535,17535,17536,0,4,4
17536,17536,17537,4,9,5
17537,17537,17538,9,1,-8
17538,17538,17539,1,0,-1
17539,17539,17540,0,1,1
17540,17540,17541,1,1,0
17541,17541,17542,1,6,5
17542,17542,17543,6,5,-1
17543,17543,17544,5,5,0
17544,17544,17545,5,8,3
17545,17545,17546,8,6,-2
17546,17546,17547,6,8,2
17547,17547,17548,8,2,-6
17548,17548,17549,2,0,-2
17549,17549,17550,0,9,9
17550,17550,17551,9,9,0
17551,17551,17552,9,4,-5
17552,17552,17553,4,3,-1
17553,17553,17554,3,1,-2
17554,17554,17555,1,2,1
17555,17555,17556,2,6,4
17556,17556,17557,6,7,1
17557,17557,17558,7,5,-2
17558,17558,17559,5,8,3
17559,17559,17560,8,1,-7
17560,17560,17561,1,4,3
17561,17561,17562,4,9,5
17562,17562,17563,9,6,-3
17563,17563,17564,6,8,2
17564,17564,17565,8,4,-4
17565,17565,17566,4,2,-2
17566,17566,17567,2,5,3
17567,17567,17568,5,4,-1
17568,17568,17569,4,3,-1
17569,17569,17570,3,9,6
17570,17570,17571,9,9,0
17571,17571,17572,9,5,-4
17572,17572,17573,5,4,-1
17573,17573,17574,4,3,-1
17574,17574,17575,3,3,0
17575,17575,17576,3,4,1
17576,17576,17577,4,4,0
17577,17577,17578,4,5,1
17578,17578,17579,5,2,-3
17579,17579,17580,2,3,1
17580,17580,17581,3,0,-3
17581,17581,17582,0,3,3
17582,17582,17583,3,5,2
17583,17583,17584,5,5,0
17584,17584,17585,5,0,-5
17585,17585,17586,0,1,1
17586,17586,17587,1,1,0
17587,17587,17588,1,3,2
17588,17588,17589,3,6,3
17589,17589,17590,6,4,-2
17590,17590,17591,4,9,5
17591,17591,17592,9,4,-5
17592,17592,17593,4,3,-1
17593,17593,17594,3,8,5
17594,17594,17595,8,2,-6
17595,17595,17596,2,8,6
17596,17596,17597,8,9,1
17597,17597,17598,9,5,-4
17598,17598,17599,5,1,-4
17599,17599,17600,1,2,1
17600,17600,17601,2,6,4
17601,17601,17602,6,8,2
17602,17602,17603,8,0,-8
17603,17603,17604,0,4,4
17604,17604,17605,4,1,-3
17605,17605,17606,1,0,-1
17606,17606,17607,0,1,1
17607,17607,17608,1,5,4
17608,17608,17609,5,8,3
17609,17609,17610,8,5,-3
17610,17610,17611,5,0,-5
17611,17611,17612,0,9,9
17612,17612,17613,9,4,-5
17613,17613,17614,4,8,4
17614,17614,17615,8,7,-1
17615,17615,17616,7,6,-1
17616,17616,17617,6,7,1
17617,17617,17618,7,1,-6
17618,17618,17619,1,6,5
17619,17619,17620,6,0,-6
17620,17620,17621,0,3,3
17621,17621,17622,3,9,6
17622,17622,17623,9,6,-3
17623,17623,17624,6,3,-3
17624,17624,17625,3,0,-3
17625,17625,17626,0,6,6
17626,17626,17627,6,1,-5
17627,17627,17628,1,8,7
17628,17628,17629,8,3,-5
17629,17629,17630,3,7,4
17630,17630,17631,7,5,-2
17631,17631,17632,5,3,-2
17632,17632,17633,3,4,1
17633,17633,17634,4,3,-1
17634,17634,17635,3,2,-1
17635,17635,17636,2,6,4
17636,17636,17637,6,1,-5
17637,17637,17638,1,1,0
17638,17638,17639,1,1,0
17639,17639,17640,1,4,3
17640,17640,17641,4,8,4
17641,17641,17642,8,5,-3
17642,17642,17643,5,3,-2
17643,17643,17644,3,9,6
17644,17644,17645,9,5,-4
17645,17645,17646,5,3,-2
17646,17646,17647,3,6,3
17647,17647,17648,6,0,-6
17648,17648,17649,0,7,7
17649,17649,17650,7,1,-6
17650,17650,17651,1,5,4
17651,17651,17652,5,6,1
17652,17652,17653,6,2,-4
17653,17653,17654,2,8,6
17654,17654,17655,8,0,-8
17655,17655,17656,0,9,9
17656,17656,17657,9,6,-3
17657,17657,17658,6,8,2
17658,17658,17659,8,7,-1
17659,17659,17660,7,2,-5
17660,17660,17661,2,1,-1
17661,17661,17662,1,1,0
17662,17662,17663,1,2,1
17663,17663,17664,2,1,-1
17664,17664,17665,1,5,4
17665,17665,17666,5,9,4
17666,17666,17667,9,8,-1
17667,17667,17668,8,8,0
17668,17668,17669,8,1,-7
17669,17669,17670,1,6,5
17670,17670,17671,6,9,3
17671,17671,17672,9,8,-1
17672,17672,17673,8,3,-5
17673,17673,17674,3,9,6
17674,17674,17675,9,8,-1
17675,17675,17676,8,3,-5
17676,17676,17677,3,2,-1
17677,17677,17678,2,4,2
17678,17678,17679,4,8,4
17679,17679,17680,8,5,-3
17680,17680,17681,5,8,3
17681,17681,17682,8,9,1
17682,17682,17683,9,7,-2
17683,17683,17684,7,2,-5
17684,17684,17685,2,1,-1
17685,17685,17686,1,6,5
17686,17686,17687,6,7,1
17687,17687,17688,7,8,1
17688,17688,17689,8,9,1
17689,17689,17690,9,4,-5
17690,17690,17691,4,2,-2
17691,17691,17692,2,9,7
17692,17692,17693,9,0,-9
17693,17693,17694,0,4,4
17694,17694,17695,4,1,-3
17695,17695,17696,1,7,6
17696,17696,17697,7,2,-5
17697,17697,17698,2,9,7
17698,17698,17699,9,3,-6
17699,17699,17700,3,8,5
17700,17700,17701,8,4,-4
17701,17701,17702,4,9,5
17702,17702,17703,9,7,-2
17703,17703,17704,7,1,-6
17704,17704,17705,1,8,7
17705,17705,17706,8,1,-7
17706,17706,17707,1,9,8
17707,17707,17708,9,9,0
17708,17708,17709,9,0,-9
17709,17709,17710,0,3,3
17710,17710,17711,3,1,-2
17711,17711,17712,1,3,2
17712,17712,17713,3,2,-1
17713,17713,17714,2,7,5
17714,17714,17715,7,3,-4
17715,17715,17716,3,5,2
17716,17716,17717,5,4,-1
17717,17717,17718,4,7,3
17718,17718,17719,7,7,0
17719,17719,17720,7,9,2
17720,17720,17721,9,8,-1
17721,17721,17722,8,5,-3
17722,17722,17723,5,9,4
17723,17723,17724,9,7,-2
17724,17724,17725,7,0,-7
17725,17725,17726,0,0,0
17726,17726,17727,0,1,1
17727,17727,17728,1,6,5
17728,17728,17729,6,2,-4
17729,17729,17730,2,4,2
17730,17730,17731,4,3,-1
17731,17731,17732,3,5,2
17732,17732,17733,5,4,-1
17733,17733,17734,4,3,-1
17734,17734,17735,3,7,4
17735,17735,17736,7,4,-3
17736,17736,17737,4,9,5
17737,17737,17738,9,0,-9
17738,17738,17739,0,5,5
17739,17739,17740,5,4,-1
17740,17740,17741,4,0,-4
17741,17741,17742,0,5,5
17742,17742,17743,5,8,3
17743,17743,17744,8,4,-4
17744,17744,17745,4,3,-1
17745,17745,17746,3,4,1
17746,17746,17747,4,5,1
17747,17747,17748,5,1,-4
17748,17748,17749,1,4,3
17749,17749,17750,4,1,-3
17750,17750,17751,1,8,7
17751,17751,17752,8,3,-5
17752,17752,17753,3,3,0
17753,17753,17754,3,3,0
17754,17754,17755,3,0,-3
17755,17755,17756,0,8,8
17756,17756,17757,8,2,-6
17757,17757,17758,2,9,7
17758,17758,17759,9,1,-8
17759,17759,17760,1,8,7
17760,17760,17761,8,0,-8
17761,17761,17762,0,7,7
17762,17762,17763,7,2,-5
17763,17763,17764,2,6,4
17764,17764,17765,6,8,2
17765,17765,17766,8,3,-5
17766,17766,17767,3,4,1
17767,17767,17768,4,8,4
17768,17768,17769,8,4,-4
17769,17769,17770,4,0,-4
17770,17770,17771,0,1,1
17771,17771,17772,1,7,6
17772,17772,17773,7,6,-1
17773,17773,17774,6,4,-2
17774,17774,17775,4,1,-3
17775,17775,17776,1,7,6
17776,17776,17777,7,3,-4
17777,17777,17778,3,3,0
17778,17778,17779,3,0,-3
17779,17779,17780,0,5,5
17780,17780,17781,5,3,-2
17781,17781,17782,3,1,-2
17782,17782,17783,1,6,5
17783,17783,17784,6,8,2
17784,17784,17785,8,9,1
17785,17785,17786,9,2,-7
17786,17786,17787,2,3,1
17787,17787,17788,3,6,3
17788,17788,17789,6,7,1
17789,17789,17790,7,3,-4
17790,17790,17791,3,4,1
17791,17791,17792,4,9,5
17792,17792,17793,9,9,0
17793,17793,17794,9,5,-4
17794,17794,17795,5,7,2
17795,17795,17796,7,6,-1
17796,17796,17797,6,0,-6
17797,17797,17798,0,7,7
17798,17798,17799,7,9,2
17799,17799,17800,9,7,-2
17800,17800,17801,7,4,-3
17801,17801,17802,4,1,-3
17802,17802,17803,1,8,7
17803,17803,17804,8,8,0
17804,17804,17805,8,2,-6
17805,17805,17806,2,1,-1
17806,17806,17807,1,7,6
17807,17807,17808,7,8,1
17808,17808,17809,8,7,-1
17809,17809,17810,7,3,-4
17810,17810,17811,3,5,2
17811,17811,17812,5,1,-4
17812,17812,17813,1,7,6
17813,17813,17814,7,6,-1
17814,17814,17815,6,1,-5
17815,17815,17816,1,7,6
17816,17816,17817,7,9,2
17817,17817,17818,9,8,-1
17818,17818,17819,8,5,-3
17819,17819,17820,5,3,-2
17820,17820,17821,3,2,-1
17821,17821,17822,2,4,2
17822,17822,17823,4,4,0
17823,17823,17824,4,9,5
17824,17824,17825,9,8,-1
17825,17825,17826,8,9,1
17826,17826,17827,9,9,0
17827,17827,17828,9,0,-9
17828,17828,17829,0,6,6
17829,17829,17830,6,7,1
17830,17830,17831,7,9,2
17831,17831,17832,9,3,-6
17832,17832,17833,3,7,4
17833,17833,17834,7,1,-6
17834,17834,17835,1,6,5
17835,17835,17836,6,2,-4
17836,17836,17837,2,4,2
17837,17837,17838,4,0,-4
17838,17838,17839,0,1,1
17839,17839,17840,1,2,1
17840,17840,17841,2,2,0
17841,17841,17842,2,4,2
17842,17842,17843,4,6,2
17843,17843,17844,6,4,-2
17844,17844,17845,4,1,-3
17845,17845,17846,1,1,0
17846,17846,17847,1,1,0
17847,17847,17848,1,9,8
17848,17848,17849,9,7,-2
17849,17849,17850,7,4,-3
17850,17850,17851,4,2,-2
17851,17851,17852,2,6,4
17852,17852,17853,6,3,-3
17853,17853,17854,3,1,-2
17854,17854,17855,1,6,5
17855,17855,17856,6,1,-5
17856,17856,17857,1,4,3
17857,17857,17858,4,9,5
17858,17858,17859,9,8,-1
17859,17859,17860,8,9,1
17860,17860,17861,9,9,0
17861,17861,17862,9,4,-5
17862,17862,17863,4,6,2
17863,17863,17864,6,3,-3
17864,17864,17865,3,4,1
17865,17865,17866,4,7,3
17866,17866,17867,7,6,-1
17867,17867,17868,6,4,-2
17868,17868,17869,4,5,1
17869,17869,17870,5,4,-1
17870,17870,17871,4,0,-4
17871,17871,17872,0,1,1
17872,17872,17873,1,2,1
17873,17873,17874,2,6,4
17874,17874,17875,6,1,-5
17875,17875,17876,1,6,5
17876,17876,17877,6,0,-6
17877,17877,17878,0,8,8
17878,17878,17879,8,5,-3
17879,17879,17880,5,2,-3
17880,17880,17881,2,0,-2
17881,17881,17882,0,7,7
17882,17882,17883,7,1,-6
17883,17883,17884,1,2,1
17884,17884,17885,2,1,-1
17885,17885,17886,1,5,4
17886,17886,17887,5,7,2
17887,17887,17888,7,1,-6
17888,17888,17889,1,8,7
17889,17889,17890,8,5,-3
17890,17890,17891,5,4,-1
17891,17891,17892,4,2,-2
17892,17892,17893,2,3,1
17893,17893,17894,3,8,5
17894,17894,17895,8,2,-6
17895,17895,17896,2,4,2
17896,17896,17897,4,7,3
17897,17897,17898,7,4,-3
17898,17898,17899,4,9,5
17899,17899,17900,9,1,-8
17900,17900,17901,1,3,2
17901,17901,17902,3,9,6
17902,17902,17903,9,9,0
17903,17903,17904,9,3,-6
17904,17904,17905,3,0,-3
17905,17905,17906,0,3,3
17906,17906,17907,3,1,-2
17907,17907,17908,1,3,2
17908,17908,17909,3,2,-1
17909,17909,17910,2,6,4
17910,17910,17911,6,3,-3
17911,17911,17912,3,2,-1
17912,17912,17913,2,4,2
17913,17913,17914,4,5,1
17914,17914,17915,5,5,0
17915,17915,17916,5,4,-1
17916,17916,17917,4,7,3
17917,17917,17918,7,7,0
17918,17918,17919,7,8,1
17919,17919,17920,8,5,-3
17920,17920,17921,5,9,4
17921,17921,17922,9,4,-5
17922,17922,17923,4,0,-4
17923,17923,17924,0,8,8
17924,17924,17925,8,1,-7
17925,17925,17926,1,4,3
17926,17926,17927,4,2,-2
17927,17927,17928,2,1,-1
17928,17928,17929,1,3,2
17929,17929,17930,3,0,-3
17930,17930,17931,0,4,4
17931,17931,17932,4,0,-4
17932,17932,17933,0,6,6
17933,17933,17934,6,4,-2
17934,17934,17935,4,7,3
17935,17935,17936,7,9,2
17936,17936,17937,9,8,-1
17937,17937,17938,8,1,-7
17938,17938,17939,1,9,8
17939,17939,17940,9,4,-5
17940,17940,17941,4,0,-4
17941,17941,17942,0,1,1
17942,17942,17943,1,1,0
17943,17943,17944,1,4,3
17944,17944,17945,4,2,-2
17945,17945,17946,2,7,5
17946,17946,17947,7,3,-4
17947,17947,17948,3,8,5
17948,17948,17949,8,4,-4
17949,17949,17950,4,8,4
17950,17950,17951,8,5,-3
17951,17951,17952,5,8,3
17952,17952,17953,8,6,-2
17953,17953,17954,6,4,-2
17954,17954,17955,4,7,3
17955,17955,17956,7,0,-7
17956,17956,17957,0,8,8
17957,17957,17958,8,9,1
17958,17958,17959,9,9,0
17959,17959,17960,9,1,-8
17960,17960,17961,1,7,6
17961,17961,17962,7,7,0
17962,17962,17963,7,7,0
17963,17963,17964,7,1,-6
17964,17964,17965,1,1,0
17965,17965,17966,1,3,2
17966,17966,17967,3,3,0
17967,17967,17968,3,0,-3
17968,17968,17969,0,7,7
17969,17969,17970,7,4,-3
17970,17970,17971,4,5,1
17971,17971,17972,5,9,4
17972,17972,17973,9,2,-7
17973,17973,17974,2,7,5
17974,17974,17975,7,8,1
17975,17975,17976,8,4,-4
17976,17976,17977,4,0,-4
17977,17977,17978,0,9,9
17978,17978,17979,9,7,-2
17979,17979,17980,7,6,-1
17980,17980,17981,6,5,-1
17981,17981,17982,5,6,1
17982,17982,17983,6,9,3
17983,17983,17984,9,1,-8
17984,17984,17985,1,6,5
17985,17985,17986,6,1,-5
17986,17986,17987,1,0,-1
17987,17987,17988,0,3,3
17988,17988,17989,3,9,6
17989,17989,17990,9,8,-1
17990,17990,17991,8,4,-4
17991,17991,17992,4,2,-2
17992,17992,17993,2,3,1
17993,17993,17994,3,9,6
17994,17994,17995,9,2,-7
17995,17995,17996,2,6,4
17996,17996,17997,6,3,-3
17997,17997,17998,3,6,3
17998,17998,17999,6,8,2
17999,17999,18000,8,4,-4
18000,18000,18001,4,3,-1
18001,18001,18002,3,7,4
18002,18002,18003,7,2,-5
18003,18003,18004,2,3,1
18004,18004,18005,3,5,2
18005,18005,18006,5,7,2
18006,18006,18007,7,3,-4
18007,18007,18008,3,4,1
18008,18008,18009,4,9,5
18009,18009,18010,9,2,-7
18010,18010,18011,2,4,2
18011,18011,18012,4,8,4
18012,18012,18013,8,1,-7
18013,18013,18014,1,8,7
18014,18014,18015,8,9,1
18015,18015,18016,9,1,-8
18016,18016,18017,1,2,1
18017,18017,18018,2,5,3
18018,18018,18019,5,1,-4
18019,18019,18020,1,7,6
18020,18020,18021,7,9,2
18021,18021,18022,9,0,-9
18022,18022,18023,0,6,6
18023,18023,18024,6,9,3
18024,18024,18025,9,7,-2
18025,18025,18026,7,4,-3
18026,18026,18027,4,9,5
18027,18027,18028,9,0,-9
18028,18028,18029,0,0,0
18029,18029,18030,0,3,3
18030,18030,18031,3,4,1
18031,18031,18032,4,6,2
18032,18032,18033,6,6,0
18033,18033,18034,6,6,0
18034,18034,18035,6,1,-5
18035,18035,18036,1,2,1
18036,18036,18037,2,7,5
18037,18037,18038,7,2,-5
18038,18038,18039,2,3,1
18039,18039,18040,3,2,-1
18040,18040,18041,2,8,6
18041,18041,18042,8,0,-8
18042,18042,18043,0,9,9
18043,18043,18044,9,3,-6
18044,18044,18045,3,6,3
18045,18045,18046,6,7,1
18046,18046,18047,7,8,1
18047,18047,18048,8,7,-1
18048,18048,18049,7,3,-4
18049,18049,18050,3,1,-2
18050,18050,18051,1,9,8
18051,18051,18052,9,6,-3
18052,18052,18053,6,1,-5
18053,18053,18054,1,4,3
18054,18054,18055,4,0,-4
18055,18055,18056,0,4,4
18056,18056,18057,4,9,5
18057,18057,18058,9,6,-3
18058,18058,18059,6,3,-3
18059,18059,18060,3,9,6
18060,18060,18061,9,3,-6
18061,18061,18062,3,4,1
18062,18062,18063,4,6,2
18063,18063,18064,6,0,-6
18064,18064,18065,0,2,2
18065,18065,18066,2,7,5
18066,18066,18067,7,5,-2
18067,18067,18068,5,6,1
18068,18068,18069,6,3,-3
18069,18069,18070,3,1,-2
18070,18070,18071,1,4,3
18071,18071,18072,4,1,-3
18072,18072,18073,1,0,-1
18073,18073,18074,0,1,1
18074,18074,18075,1,1,0
18075,18075,18076,1,6,5
18076,18076,18077,6,2,-4
18077,18077,18078,2,8,6
18078,18078,18079,8,3,-5
18079,18079,18080,3,5,2
18080,18080,18081,5,4,-1
18081,18081,18082,4,9,5
18082,18082,18083,9,5,-4
18083,18083,18084,5,2,-3
18084,18084,18085,2,6,4
18085,18085,18086,6,7,1
18086,18086,18087,7,7,0
18087,18087,18088,7,4,-3
18088,18088,18089,4,8,4
18089,18089,18090,8,5,-3
18090,18090,18091,5,9,4
18091,18091,18092,9,4,-5
18092,18092,18093,4,0,-4
18093,18093,18094,0,6,6
18094,18094,18095,6,1,-5
18095,18095,18096,1,6,5
18096,18096,18097,6,2,-4
18097,18097,18098,2,4,2
18098,18098,18099,4,3,-1
18099,18099,18100,3,7,4
18100,18100,18101,7,4,-3
18101,18101,18102,4,0,-4
18102,18102,18103,0,5,5
18103,18103,18104,5,8,3
18104,18104,18105,8,6,-2
18105,18105,18106,6,9,3
18106,18106,18107,9,7,-2
18107,18107,18108,7,3,-4
18108,18108,18109,3,8,5
18109,18109,18110,8,2,-6
18110,18110,18111,2,9,7
18111,18111,18112,9,0,-9
18112,18112,18113,0,0,0
18113,18113,18114,0,8,8
18114,18114,18115,8,1,-7
18115,18115,18116,1,1,0
18116,18116,18117,1,2,1
18117,18117,18118,2,9,7
18118,18118,18119,9,3,-6
18119,18119,18120,3,3,0
18120,18120,18121,3,4,1
18121,18121,18122,4,7,3
18122,18122,18123,7,5,-2
18123,18123,18124,5,0,-5
18124,18124,18125,0,6,6
18125,18125,18126,6,8,2
18126,18126,18127,8,7,-1
18127,18127,18128,7,6,-1
18128,18128,18129,6,8,2
18129,18129,18130,8,8,0
18130,18130,18131,8,9,1
18131,18131,18132,9,0,-9
18132,18132,18133,0,4,4
18133,18133,18134,4,6,2
18134,18134,18135,6,2,-4
18135,18135,18136,2,4,2
18136,18136,18137,4,0,-4
18137,18137,18138,0,9,9
18138,18138,18139,9,2,-7
18139,18139,18140,2,6,4
18140,18140,18141,6,5,-1
18141,18141,18142,5,7,2
18142,18142,18143,7,9,2
18143,18143,18144,9,6,-3
18144,18144,18145,6,4,-2
18145,18145,18146,4,9,5
18146,18146,18147,9,2,-7
18147,18147,18148,2,1,-1
18148,18148,18149,1,6,5
18149,18149,18150,6,8,2
18150,18150,18151,8,5,-3
18151,18151,18152,5,7,2
18152,18152,18153,7,9,2
18153,18153,18154,9,6,-3
18154,18154,18155,6,3,-3
18155,18155,18156,3,8,5
18156,18156,18157,8,5,-3
18157,18157,18158,5,2,-3
18158,18158,18159,2,0,-2
18159,18159,18160,0,7,7
18160,18160,18161,7,7,0
18161,18161,18162,7,5,-2
18162,18162,18163,5,1,-4
18163,18163,18164,1,2,1
18164,18164,18165,2,1,-1
18165,18165,18166,1,9,8
18166,18166,18167,9,5,-4
18167,18167,18168,5,6,1
18168,18168,18169,6,3,-3
18169,18169,18170,3,7,4
18170,18170,18171,7,0,-7
18171,18171,18172,0,5,5
18172,18172,18173,5,7,2
18173,18173,18174,7,1,-6
18174,18174,18175,1,9,8
18175,18175,18176,9,1,-8
18176,18176,18177,1,6,5
18177,18177,18178,6,0,-6
18178,18178,18179,0,1,1
18179,18179,18180,1,4,3
18180,18180,18181,4,6,2
18181,18181,18182,6,1,-5
18182,18182,18183,1,7,6
18183,18183,18184,7,4,-3
18184,18184,18185,4,4,0
18185,18185,18186,4,5,1
18186,18186,18187,5,9,4
18187,18187,18188,9,1,-8
18188,18188,18189,1,5,4
18189,18189,18190,5,4,-1
18190,18190,18191,4,7,3
18191,18191,18192,7,2,-5
18192,18192,18193,2,9,7
18193,18193,18194,9,6,-3
18194,18194,18195,6,8,2
18195,18195,18196,8,1,-7
18196,18196,18197,1,5,4
18197,18197,18198,5,2,-3
18198,18198,18199,2,6,4
18199,18199,18200,6,4,-2
18200,18200,18201,4,2,-2
18201,18201,18202,2,4,2
18202,18202,18203,4,4,0
18203,18203,18204,4,7,3
18204,18204,18205,7,8,1
18205,18205,18206,8,2,-6
18206,18206,18207,2,1,-1
18207,18207,18208,1,0,-1
18208,18208,18209,0,5,5
18209,18209,18210,5,2,-3
18210,18210,18211,2,9,7
18211,18211,18212,9,0,-9
18212,18212,18213,0,2,2
18213,18213,18214,2,8,6
18214,18214,18215,8,2,-6
18215,18215,18216,2,2,0
18216,18216,18217,2,8,6
18217,18217,18218,8,3,-5
18218,18218,18219,3,0,-3
18219,18219,18220,0,6,6
18220,18220,18221,6,6,0
18221,18221,18222,6,0,-6
18222,18222,18223,0,4,4
18223,18223,18224,4,2,-2
18224,18224,18225,2,3,1
18225,18225,18226,3,1,-2
18226,18226,18227,1,3,2
18227,18227,18228,3,9,6
18228,18228,18229,9,1,-8
18229,18229,18230,1,2,1
18230,18230,18231,2,2,0
18231,18231,18232,2,0,-2
18232,18232,18233,0,4,4
18233,18233,18234,4,5,1
18234,18234,18235,5,1,-4
18235,18235,18236,1,2,1
18236,18236,18237,2,5,3
18237,18237,18238,5,6,1
18238,18238,18239,6,8,2
18239,18239,18240,8,3,-5
18240,18240,18241,3,9,6
18241,18241,18242,9,8,-1
18242,18242,18243,8,3,-5
18243,18243,18244,3,3,0
18244,18244,18245,3,4,1
18245,18245,18246,4,4,0
18246,18246,18247,4,0,-4
18247,18247,18248,0,5,5
18248,18248,18249,5,3,-2
18249,18249,18250,3,6,3
18250,18250,18251,6,9,3
18251,18251,18252,9,3,-6
18252,18252,18253,3,0,-3
18253,18253,18254,0,5,5
18254,18254,18255,5,2,-3
18255,18255,18256,2,1,-1
18256,18256,18257,1,7,6
18257,18257,18258,7,1,-6
18258,18258,18259,1,1,0
18259,18259,18260,1,2,1
18260,18260,18261,2,1,-1
18261,18261,18262,1,6,5
18262,18262,18263,6,0,-6
18263,18263,18264,0,2,2
18264,18264,18265,2,7,5
18265,18265,18266,7,1,-6
18266,18266,18267,1,6,5
18267,18267,18268,6,3,-3
18268,18268,18269,3,7,4
18269,18269,18270,7,1,-6
18270,18270,18271,1,6,5
18271,18271,18272,6,8,2
18272,18272,18273,8,0,-8
18273,18273,18274,0,3,3
18274,18274,18275,3,6,3
18275,18275,18276,6,5,-1
18276,18276,18277,5,9,4
18277,18277,18278,9,0,-9
18278,18278,18279,0,4,4
18279,18279,18280,4,3,-1
18280,18280,18281,3,8,5
18281,18281,18282,8,1,-7
18282,18282,18283,1,4,3
18283,18283,18284,4,0,-4
18284,18284,18285,0,3,3
18285,18285,18286,3,1,-2
18286,18286,18287,1,3,2
18287,18287,18288,3,8,5
18288,18288,18289,8,7,-1
18289,18289,18290,7,2,-5
18290,18290,18291,2,8,6
18291,18291,18292,8,6,-2
18292,18292,18293,6,1,-5
18293,18293,18294,1,4,3
18294,18294,18295,4,0,-4
18295,18295,18296,0,9,9
18296,18296,18297,9,4,-5
18297,18297,18298,4,5,1
18298,18298,18299,5,3,-2
18299,18299,18300,3,2,-1
18300,18300,18301,2,0,-2
18301,18301,18302,0,6,6
18302,18302,18303,6,6,0
18303,18303,18304,6,1,-5
18304,18304,18305,1,8,7
18305,18305,18306,8,4,-4
18306,18306,18307,4,3,-1
18307,18307,18308,3,4,1
18308,18308,18309,4,7,3
18309,18309,18310,7,8,1
18310,18310,18311,8,8,0
18311,18311,18312,8,6,-2
18312,18312,18313,6,5,-1
18313,18313,18314,5,1,-4
18314,18314,18315,1,7,6
18315,18315,18316,7,1,-6
18316,18316,18317,1,8,7
18317,18317,18318,8,2,-6
18318,18318,18319,2,0,-2
18319,18319,18320,0,7,7
18320,18320,18321,7,1,-6
18321,18321,18322,1,7,6
18322,18322,18323,7,2,-5
18323,18323,18324,2,0,-2
18324,18324,18325,0,3,3
18325,18325,18326,3,5,2
18326,18326,18327,5,4,-1
18327,18327,18328,4,6,2
18328,18328,18329,6,5,-1
18329,18329,18330,5,6,1
18330,18330,18331,6,6,0
18331,18331,18332,6,4,-2
18332,18332,18333,4,7,3
18333,18333,18334,7,8,1
18334,18334,18335,8,8,0
18335,18335,18336,8,6,-2
18336,18336,18337,6,0,-6
18337,18337,18338,0,8,8
18338,18338,18339,8,1,-7
18339,18339,18340,1,5,4
18340,18340,18341,5,2,-3
18341,18341,18342,2,5,3
18342,18342,18343,5,3,-2
18343,18343,18344,3,6,3
18344,18344,18345,6,4,-2
18345,18345,18346,4,7,3
18346,18346,18347,7,5,-2
18347,18347,18348,5,8,3
18348,18348,18349,8,6,-2
18349,18349,18350,6,9,3
18350,18350,18351,9,7,-2
18351,18351,18352,7,1,-6
18352,18352,18353,1,8,7
18353,18353,18354,8,6,-2
18354,18354,18355,6,9,3
18355,18355,18356,9,2,-7
18356,18356,18357,2,0,-2
18357,18357,18358,0,7,7
18358,18358,18359,7,1,-6
18359,18359,18360,1,1,0
18360,18360,18361,1,2,1
18361,18361,18362,2,4,2
18362,18362,18363,4,3,-1
18363,18363,18364,3,5,2
18364,18364,18365,5,4,-1
18365,18365,18366,4,5,1
18366,18366,18367,5,7,2
18367,18367,18368,7,8,1
18368,18368,18369,8,8,0
18369,18369,18370,8,2,-6
18370,18370,18371,2,0,-2
18371,18371,18372,0,1,1
18372,18372,18373,1,8,7
18373,18373,18374,8,9,1
18374,18374,18375,9,3,-6
18375,18375,18376,3,6,3
18376,18376,18377,6,9,3
18377,18377,18378,9,8,-1
18378,18378,18379,8,5,-3
18379,18379,18380,5,3,-2
18380,18380,18381,3,6,3
18381,18381,18382,6,9,3
18382,18382,18383,9,8,-1
18383,18383,18384,8,1,-7
18384,18384,18385,1,4,3
18385,18385,18386,4,2,-2
18386,18386,18387,2,9,7
18387,18387,18388,9,6,-3
18388,18388,18389,6,1,-5
18389,18389,18390,1,3,2
18390,18390,18391,3,7,4
18391,18391,18392,7,7,0
18392,18392,18393,7,1,-6
18393,18393,18394,1,2,1
18394,18394,18395,2,2,0
18395,18395,18396,2,8,6
18396,18396,18397,8,3,-5
18397,18397,18398,3,4,1
18398,18398,18399,4,5,1
18399,18399,18400,5,1,-4
18400,18400,18401,1,9,8
18401,18401,18402,9,7,-2
18402,18402,18403,7,6,-1
18403,18403,18404,6,5,-1
18404,18404,18405,5,9,4
18405,18405,18406,9,8,-1
18406,18406,18407,8,1,-7
18407,18407,18408,1,7,6
18408,18408,18409,7,1,-6
18409,18409,18410,1,7,6
18410,18410,18411,7,1,-6
18411,18411,18412,1,0,-1
18412,18412,18413,0,2,2
18413,18413,18414,2,8,6
18414,18414,18415,8,9,1
18415,18415,18416,9,5,-4
18416,18416,18417,5,5,0
18417,18417,18418,5,5,0
18418,18418,18419,5,8,3
18419,18419,18420,8,4,-4
18420,18420,18421,4,1,-3
18421,18421,18422,1,6,5
18422,18422,18423,6,2,-4
18423,18423,18424,2,0,-2
18424,18424,18425,0,0,0
18425,18425,18426,0,3,3
18426,18426,18427,3,7,4
18427,18427,18428,7,6,-1
18428,18428,18429,6,7,1
18429,18429,18430,7,6,-1
18430,18430,18431,6,5,-1
18431,18431,18432,5,6,1
18432,18432,18433,6,8,2
18433,18433,18434,8,8,0
18434,18434,18435,8,2,-6
18435,18435,18436,2,4,2
18436,18436,18437,4,9,5
18437,18437,18438,9,4,-5
18438,18438,18439,4,8,4
18439,18439,18440,8,5,-3
18440,18440,18441,5,9,4
18441,18441,18442,9,1,-8
18442,18442,18443,1,0,-1
18443,18443,18444,0,1,1
18444,18444,18445,1,4,3
18445,18445,18446,4,5,1
18446,18446,18447,5,6,1
18447,18447,18448,6,9,3
18448,18448,18449,9,7,-2
18449,18449,18450,7,8,1
18450,18450,18451,8,1,-7
18451,18451,18452,1,1,0
18452,18452,18453,1,3,2
18453,18453,18454,3,2,-1
18454,18454,18455,2,4,2
18455,18455,18456,4,5,1
18456,18456,18457,5,5,0
18457,18457,18458,5,9,4
18458,18458,18459,9,6,-3
18459,18459,18460,6,2,-4
18460,18460,18461,2,0,-2
18461,18461,18462,0,0,0
18462,18462,18463,0,3,3
18463,18463,18464,3,0,-3
18464,18464,18465,0,6,6
18465,18465,18466,6,8,2
18466,18466,18467,8,8,0
18467,18467,18468,8,1,-7
18468,18468,18469,1,7,6
18469,18469,18470,7,5,-2
18470,18470,18471,5,0,-5
18471,18471,18472,0,7,7
18472,18472,18473,7,4,-3
18473,18473,18474,4,1,-3
18474,18474,18475,1,9,8
18475,18475,18476,9,5,-4
18476,18476,18477,5,3,-2
18477,18477,18478,3,8,5
18478,18478,18479,8,7,-1
18479,18479,18480,7,2,-5
18480,18480,18481,2,5,3
18481,18481,18482,5,1,-4
18482,18482,18483,1,4,3
18483,18483,18484,4,4,0
18484,18484,18485,4,3,-1
18485,18485,18486,3,0,-3
18486,18486,18487,0,4,4
18487,18487,18488,4,1,-3
18488,18488,18489,1,2,1
18489,18489,18490,2,4,2
18490,18490,18491,4,8,4
18491,18491,18492,8,1,-7
18492,18492,18493,1,1,0
18493,18493,18494,1,7,6
18494,18494,18495,7,5,-2
18495,18495,18496,5,4,-1
18496,18496,18497,4,1,-3
18497,18497,18498,1,7,6
18498,18498,18499,7,2,-5
18499,18499,18500,2,9,7
18500,18500,18501,9,4,-5
18501,18501,18502,4,7,3
18502,18502,18503,7,3,-4
18503,18503,18504,3,4,1
18504,18504,18505,4,0,-4
18505,18505,18506,0,9,9
18506,18506,18507,9,0,-9
18507,18507,18508,0,5,5
18508,18508,18509,5,0,-5
18509,18509,18510,0,9,9
18510,18510,18511,9,5,-4
18511,18511,18512,5,4,-1
18512,18512,18513,4,7,3
18513,18513,18514,7,2,-5
18514,18514,18515,2,0,-2
18515,18515,18516,0,1,1
18516,18516,18517,1,6,5
18517,18517,18518,6,5,-1
18518,18518,18519,5,4,-1
18519,18519,18520,4,6,2
18520,18520,18521,6,8,2
18521,18521,18522,8,3,-5
18522,18522,18523,3,8,5
18523,18523,18524,8,1,-7
18524,18524,18525,1,6,5
18525,18525,18526,6,2,-4
18526,18526,18527,2,3,1
18527,18527,18528,3,3,0
18528,18528,18529,3,9,6
18529,18529,18530,9,6,-3
18530,18530,18531,6,9,3
18531,18531,18532,9,7,-2
18532,18532,18533,7,8,1
18533,18533,18534,8,7,-1
18534,18534,18535,7,2,-5
18535,18535,18536,2,6,4
18536,18536,18537,6,7,1
18537,18537,18538,7,0,-7
18538,18538,18539,0,7,7
18539,18539,18540,7,1,-6
18540,18540,18541,1,1,0
18541,18541,18542,1,3,2
18542,18542,18543,3,0,-3
18543,18543,18544,0,2,2
18544,18544,18545,2,1,-1
18545,18545,18546,1,1,0
18546,18546,18547,1,2,1
18547,18547,18548,2,6,4
18548,18548,18549,6,3,-3
18549,18549,18550,3,5,2
18550,18550,18551,5,4,-1
18551,18551,18552,4,9,5
18552,18552,18553,9,5,-4
18553,18553,18554,5,9,4
18554,18554,18555,9,6,-3
18555,18555,18556,6,7,1
18556,18556,18557,7,7,0
18557,18557,18558,7,9,2
18558,18558,18559,9,8,-1
18559,18559,18560,8,4,-4
18560,18560,18561,4,9,5
18561,18561,18562,9,9,0
18562,18562,18563,9,0,-9
18563,18563,18564,0,0,0
18564,18564,18565,0,1,1
18565,18565,18566,1,2,1
18566,18566,18567,2,2,0
18567,18567,18568,2,1,-1
18568,18568,18569,1,3,2
18569,18569,18570,3,4,1
18570,18570,18571,4,4,0
18571,18571,18572,4,0,-4
18572,18572,18573,0,5,5
18573,18573,18574,5,8,3
18574,18574,18575,8,6,-2
18575,18575,18576,6,6,0
18576,18576,18577,6,8,2
18577,18577,18578,8,4,-4
18578,18578,18579,4,9,5
18579,18579,18580,9,8,-1
18580,18580,18581,8,0,-8
18581,18581,18582,0,4,4
18582,18582,18583,4,1,-3
18583,18583,18584,1,3,2
18584,18584,18585,3,2,-1
18585,18585,18586,2,0,-2
18586,18586,18587,0,3,3
18587,18587,18588,3,3,0
18588,18588,18589,3,4,1
18589,18589,18590,4,0,-4
18590,18590,18591,0,5,5
18591,18591,18592,5,4,-1
18592,18592,18593,4,6,2
18593,18593,18594,6,5,-1
18594,18594,18595,5,8,3
18595,18595,18596,8,4,-4
18596,18596,18597,4,7,3
18597,18597,18598,7,9,2
18598,18598,18599,9,0,-9
18599,18599,18600,0,5,5
18600,18600,18601,5,4,-1
18601,18601,18602,4,9,5
18602,18602,18603,9,0,-9
18603,18603,18604,0,4,4
18604,18604,18605,4,6,2
18605,18605,18606,6,0,-6
18606,18606,18607,0,4,4
18607,18607,18608,4,6,2
18608,18608,18609,6,7,1
18609,18609,18610,7,9,2
18610,18610,18611,9,6,-3
18611,18611,18612,6,3,-3
18612,18612,18613,3,2,-1
18613,18613,18614,2,8,6
18614,18614,18615,8,3,-5
18615,18615,18616,3,7,4
18616,18616,18617,7,4,-3
18617,18617,18618,4,8,4
18618,18618,18619,8,8,0
18619,18619,18620,8,2,-6
18620,18620,18621,2,7,5
18621,18621,18622,7,2,-5
18622,18622,18623,2,8,6
18623,18623,18624,8,9,1
18624,18624,18625,9,6,-3
18625,18625,18626,6,3,-3
18626,18626,18627,3,3,0
18627,18627,18628,3,9,6
18628,18628,18629,9,8,-1
18629,18629,18630,8,3,-5
18630,18630,18631,3,2,-1
18631,18631,18632,2,2,0
18632,18632,18633,2,2,0
18633,18633,18634,2,2,0
18634,18634,18635,2,8,6
18635,18635,18636,8,4,-4
18636,18636,18637,4,4,0
18637,18637,18638,4,4,0
18638,18638,18639,4,5,1
18639,18639,18640,5,1,-4
18640,18640,18641,1,0,-1
18641,18641,18642,0,8,8
18642,18642,18643,8,2,-6
18643,18643,18644,2,8,6
18644,18644,18645,8,0,-8
18645,18645,18646,0,3,3
18646,18646,18647,3,1,-2
18647,18647,18648,1,7,6
18648,18648,18649,7,1,-6
18649,18649,18650,1,0,-1
18650,18650,18651,0,2,2
18651,18651,18652,2,6,4
18652,18652,18653,6,9,3
18653,18653,18654,9,4,-5
18654,18654,18655,4,6,2
18655,18655,18656,6,1,-5
18656,18656,18657,1,8,7
18657,18657,18658,8,0,-8
18658,18658,18659,0,1,1
18659,18659,18660,1,8,7
18660,18660,18661,8,2,-6
18661,18661,18662,2,2,0
18662,18662,18663,2,1,-1
18663,18663,18664,1,1,0
18664,18664,18665,1,0,-1
18665,18665,18666,0,9,9
18666,18666,18667,9,6,-3
18667,18667,18668,6,9,3
18668,18668,18669,9,9,0
18669,18669,18670,9,6,-3
18670,18670,18671,6,7,1
18671,18671,18672,7,6,-1
18672,18672,18673,6,5,-1
18673,18673,18674,5,8,3
18674,18674,18675,8,3,-5
18675,18675,18676,3,5,2
18676,18676,18677,5,9,4
18677,18677,18678,9,6,-3
18678,18678,18679,6,3,-3
18679,18679,18680,3,9,6
18680,18680,18681,9,7,-2
18681,18681,18682,7,7,0
18682,18682,18683,7,1,-6
18683,18683,18684,1,2,1
18684,18684,18685,2,8,6
18685,18685,18686,8,4,-4
18686,18686,18687,4,3,-1
18687,18687,18688,3,9,6
18688,18688,18689,9,8,-1
18689,18689,18690,8,8,0
18690,18690,18691,8,7,-1
18691,18691,18692,7,1,-6
18692,18692,18693,1,2,1
18693,18693,18694,2,9,7
18694,18694,18695,9,1,-8
18695,18695,18696,1,5,4
18696,18696,18697,5,9,4
18697,18697,18698,9,9,0
18698,18698,18699,9,5,-4
18699,18699,18700,5,9,4
18700,18700,18701,9,5,-4
18701,18701,18702,5,6,1
18702,18702,18703,6,0,-6
18703,18703,18704,0,6,6
18704,18704,18705,6,1,-5
18705,18705,18706,1,7,6
18706,18706,18707,7,1,-6
18707,18707,18708,1,4,3
18708,18708,18709,4,9,5
18709,18709,18710,9,8,-1
18710,18710,18711,8,8,0
18711,18711,18712,8,0,-8
18712,18712,18713,0,2,2
18713,18713,18714,2,8,6
18714,18714,18715,8,0,-8
18715,18715,18716,0,6,6
18716,18716,18717,6,4,-2
18717,18717,18718,4,0,-4
18718,18718,18719,0,5,5
18719,18719,18720,5,7,2
18720,18720,18721,7,6,-1
18721,18721,18722,6,9,3
18722,18722,18723,9,5,-4
18723,18723,18724,5,4,-1
18724,18724,18725,4,0,-4
18725,18725,18726,0,4,4
18726,18726,18727,4,3,-1
18727,18727,18728,3,9,6
18728,18728,18729,9,7,-2
18729,18729,18730,7,4,-3
18730,18730,18731,4,9,5
18731,18731,18732,9,6,-3
18732,18732,18733,6,9,3
18733,18733,18734,9,7,-2
18734,18734,18735,7,3,-4
18735,18735,18736,3,7,4
18736,18736,18737,7,0,-7
18737,18737,18738,0,9,9
18738,18738,18739,9,3,-6
18739,18739,18740,3,8,5
18740,18740,18741,8,1,-7
18741,18741,18742,1,3,2
18742,18742,18743,3,0,-3
18743,18743,18744,0,9,9
18744,18744,18745,9,4,-5
18745,18745,18746,4,9,5
18746,18746,18747,9,9,0
18747,18747,18748,9,2,-7
18748,18748,18749,2,5,3
18749,18749,18750,5,0,-5
18750,18750,18751,0,4,4
18751,18751,18752,4,3,-1
18752,18752,18753,3,7,4
18753,18753,18754,7,7,0
18754,18754,18755,7,9,2
18755,18755,18756,9,9,0
18756,18756,18757,9,7,-2
18757,18757,18758,7,1,-6
18758,18758,18759,1,0,-1
18759,18759,18760,0,1,1
18760,18760,18761,1,1,0
18761,18761,18762,1,8,7
18762,18762,18763,8,2,-6
18763,18763,18764,2,2,0
18764,18764,18765,2,3,1
18765,18765,18766,3,3,0
18766,18766,18767,3,4,1
18767,18767,18768,4,1,-3
18768,18768,18769,1,5,4
18769,18769,18770,5,3,-2
18770,18770,18771,3,6,3
18771,18771,18772,6,6,0
18772,18772,18773,6,7,1
18773,18773,18774,7,8,1
18774,18774,18775,8,8,0
18775,18775,18776,8,2,-6
18776,18776,18777,2,9,7
18777,18777,18778,9,5,-4
18778,18778,18779,5,0,-5
18779,18779,18780,0,2,2
18780,18780,18781,2,1,-1
18781,18781,18782,1,5,4
18782,18782,18783,5,2,-3
18783,18783,18784,2,7,5
18784,18784,18785,7,3,-4
18785,18785,18786,3,9,6
18786,18786,18787,9,4,-5
18787,18787,18788,4,6,2
18788,18788,18789,6,5,-1
18789,18789,18790,5,1,-4
18790,18790,18791,1,6,5
18791,18791,18792,6,1,-5
18792,18792,18793,1,7,6
18793,18793,18794,7,0,-7
18794,18794,18795,0,8,8
18795,18795,18796,8,3,-5
18796,18796,18797,3,9,6
18797,18797,18798,9,8,-1
18798,18798,18799,8,0,-8
18799,18799,18800,0,1,1
18800,18800,18801,1,1,0
18801,18801,18802,1,3,2
18802,18802,18803,3,2,-1
18803,18803,18804,2,2,0
18804,18804,18805,2,3,1
18805,18805,18806,3,1,-2
18806,18806,18807,1,4,3
18807,18807,18808,4,5,1
18808,18808,18809,5,7,2
18809,18809,18810,7,7,0
18810,18810,18811,7,8,1
18811,18811,18812,8,3,-5
18812,18812,18813,3,9,6
18813,18813,18814,9,3,-6
18814,18814,18815,3,2,-1
18815,18815,18816,2,7,5
18816,18816,18817,7,2,-5
18817,18817,18818,2,7,5
18818,18818,18819,7,7,0
18819,18819,18820,7,9,2
18820,18820,18821,9,6,-3
18821,18821,18822,6,5,-1
18822,18822,18823,5,4,-1
18823,18823,18824,4,7,3
18824,18824,18825,7,7,0
18825,18825,18826,7,3,-4
18826,18826,18827,3,3,0
18827,18827,18828,3,9,6
18828,18828,18829,9,5,-4
18829,18829,18830,5,1,-4
18830,18830,18831,1,4,3
18831,18831,18832,4,0,-4
18832,18832,18833,0,1,1
18833,18833,18834,1,7,6
18834,18834,18835,7,8,1
18835,18835,18836,8,0,-8
18836,18836,18837,0,0,0
18837,18837,18838,0,6,6
18838,18838,18839,6,5,-1
18839,18839,18840,5,3,-2
18840,18840,18841,3,2,-1
18841,18841,18842,2,9,7
18842,18842,18843,9,7,-2
18843,18843,18844,7,7,0
18844,18844,18845,7,2,-5
18845,18845,18846,2,4,2
18846,18846,18847,4,3,-1
18847,18847,18848,3,6,3
18848,18848,18849,6,6,0
18849,18849,18850,6,2,-4
18850,18850,18851,2,2,0
18851,18851,18852,2,1,-1
18852,18852,18853,1,1,0
18853,18853,18854,1,4,3
18854,18854,18855,4,7,3
18855,18855,18856,7,8,1
18856,18856,18857,8,7,-1
18857,18857,18858,7,0,-7
18858,18858,18859,0,9,9
18859,18859,18860,9,9,0
18860,18860,18861,9,9,0
18861,18861,18862,9,3,-6
18862,18862,18863,3,1,-2
18863,18863,18864,1,2,1
18864,18864,18865,2,2,0
18865,18865,18866,2,4,2
18866,18866,18867,4,4,0
18867,18867,18868,4,0,-4
18868,18868,18869,0,6,6
18869,18869,18870,6,1,-5
18870,18870,18871,1,7,6
18871,18871,18872,7,8,1
18872,18872,18873,8,7,-1
18873,18873,18874,7,9,2
18874,18874,18875,9,5,-4
18875,18875,18876,5,7,2
18876,18876,18877,7,4,-3
18877,18877,18878,4,0,-4
18878,18878,18879,0,5,5
18879,18879,18880,5,1,-4
18880,18880,18881,1,0,-1
18881,18881,18882,0,5,5
18882,18882,18883,5,9,4
18883,18883,18884,9,8,-1
18884,18884,18885,8,9,1
18885,18885,18886,9,1,-8
18886,18886,18887,1,8,7
18887,18887,18888,8,4,-4
18888,18888,18889,4,0,-4
18889,18889,18890,0,8,8
18890,18890,18891,8,2,-6
18891,18891,18892,2,0,-2
18892,18892,18893,0,0,0
18893,18893,18894,0,7,7
18894,18894,18895,7,3,-4
18895,18895,18896,3,0,-3
18896,18896,18897,0,5,5
18897,18897,18898,5,4,-1
18898,18898,18899,4,1,-3
18899,18899,18900,1,2,1
18900,18900,18901,2,8,6
18901,18901,18902,8,8,0
18902,18902,18903,8,6,-2
18903,18903,18904,6,6,0
18904,18904,18905,6,4,-2
18905,18905,18906,4,1,-3
18906,18906,18907,1,6,5
18907,18907,18908,6,6,0
18908,18908,18909,6,0,-6
18909,18909,18910,0,7,7
18910,18910,18911,7,6,-1
18911,18911,18912,6,1,-5
18912,18912,18913,1,4,3
18913,18913,18914,4,0,-4
18914,18914,18915,0,3,3
18915,18915,18916,3,9,6
18916,18916,18917,9,9,0
18917,18917,18918,9,1,-8
18918,18918,18919,1,3,2
18919,18919,18920,3,3,0
18920,18920,18921,3,0,-3
18921,18921,18922,0,2,2
18922,18922,18923,2,0,-2
18923,18923,18924,0,3,3
18924,18924,18925,3,5,2
18925,18925,18926,5,0,-5
18926,18926,18927,0,2,2
18927,18927,18928,2,9,7
18928,18928,18929,9,5,-4
18929,18929,18930,5,2,-3
18930,18930,18931,2,8,6
18931,18931,18932,8,5,-3
18932,18932,18933,5,8,3
18933,18933,18934,8,5,-3
18934,18934,18935,5,9,4
18935,18935,18936,9,0,-9
18936,18936,18937,0,4,4
18937,18937,18938,4,5,1
18938,18938,18939,5,3,-2
18939,18939,18940,3,1,-2
18940,18940,18941,1,4,3
18941,18941,18942,4,1,-3
18942,18942,18943,1,2,1
18943,18943,18944,2,9,7
18944,18944,18945,9,8,-1
18945,18945,18946,8,2,-6
18946,18946,18947,2,5,3
18947,18947,18948,5,3,-2
18948,18948,18949,3,5,2
18949,18949,18950,5,7,2
18950,18950,18951,7,7,0
18951,18951,18952,7,8,1
18952,18952,18953,8,1,-7
18953,18953,18954,1,4,3
18954,18954,18955,4,3,-1
18955,18955,18956,3,6,3
18956,18956,18957,6,6,0
18957,18957,18958,6,1,-5
18958,18958,18959,1,9,8
18959,18959,18960,9,3,-6
18960,18960,18961,3,4,1
18961,18961,18962,4,7,3
18962,18962,18963,7,1,-6
18963,18963,18964,1,3,2
18964,18964,18965,3,3,0
18965,18965,18966,3,7,4
18966,18966,18967,7,8,1
18967,18967,18968,8,5,-3
18968,18968,18969,5,7,2
18969,18969,18970,7,0,-7
18970,18970,18971,0,6,6
18971,18971,18972,6,2,-4
18972,18972,18973,2,9,7
18973,18973,18974,9,3,-6
18974,18974,18975,3,3,0
18975,18975,18976,3,9,6
18976,18976,18977,9,3,-6
18977,18977,18978,3,2,-1
18978,18978,18979,2,7,5
18979,18979,18980,7,1,-6
18980,18980,18981,1,4,3
18981,18981,18982,4,6,2
18982,18982,18983,6,1,-5
18983,18983,18984,1,9,8
18984,18984,18985,9,9,0
18985,18985,18986,9,3,-6
18986,18986,18987,3,1,-2
18987,18987,18988,1,4,3
18988,18988,18989,4,0,-4
18989,18989,18990,0,4,4
18990,18990,18991,4,0,-4
18991,18991,18992,0,3,3
18992,18992,18993,3,1,-2
18993,18993,18994,1,8,7
18994,18994,18995,8,2,-6
18995,18995,18996,2,9,7
18996,18996,18997,9,3,-6
18997,18997,18998,3,2,-1
18998,18998,18999,2,4,2
18999,18999,19000,4,8,4
19000,19000,19001,8,5,-3
19001,19001,19002,5,6,1
19002,19002,19003,6,7,1
19003,19003,19004,7,0,-7
19004,19004,19005,0,8,8
19005,19005,19006,8,0,-8
19006,19006,19007,0,9,9
19007,19007,19008,9,0,-9
19008,19008,19009,0,0,0
19009,19009,19010,0,1,1
19010,19010,19011,1,1,0
19011,19011,19012,1,0,-1
19012,19012,19013,0,2,2
19013,19013,19014,2,3,1
19014,19014,19015,3,3,0
19015,19015,19016,3,3,0
19016,19016,19017,3,4,1
19017,19017,19018,4,1,-3
19018,19018,19019,1,5,4
19019,19019,19020,5,5,0
19020,19020,19021,5,6,1
19021,19021,19022,6,5,-1
19022,19022,19023,5,7,2
19023,19023,19024,7,9,2
19024,19024,19025,9,8,-1
19025,19025,19026,8,4,-4
19026,19026,19027,4,0,-4
19027,19027,19028,0,2,2
19028,19028,19029,2,1,-1
19029,19029,19030,1,9,8
19030,19030,19031,9,2,-7
19031,19031,19032,2,4,2
19032,19032,19033,4,4,0
19033,19033,19034,4,4,0
19034,19034,19035,4,5,1
19035,19035,19036,5,1,-4
19036,19036,19037,1,6,5
19037,19037,19038,6,0,-6
19038,19038,19039,0,7,7
19039,19039,19040,7,6,-1
19040,19040,19041,6,8,2
19041,19041,19042,8,9,1
19042,19042,19043,9,8,-1
19043,19043,19044,8,4,-4
19044,19044,19045,4,9,5
19045,19045,19046,9,8,-1
19046,19046,19047,8,9,1
19047,19047,19048,9,6,-3
19048,19048,19049,6,0,-6
19049,19049,19050,0,7,7
19050,19050,19051,7,1,-6
19051,19051,19052,1,8,7
19052,19052,19053,8,2,-6
19053,19053,19054,2,7,5
19054,19054,19055,7,4,-3
19055,19055,19056,4,5,1
19056,19056,19057,5,7,2
19057,19057,19058,7,1,-6
19058,19058,19059,1,4,3
19059,19059,19060,4,0,-4
19060,19060,19061,0,0,0
19061,19061,19062,0,6,6
19062,19062,19063,6,3,-3
19063,19063,19064,3,4,1
19064,19064,19065,4,8,4
19065,19065,19066,8,6,-2
19066,19066,19067,6,8,2
19067,19067,19068,8,1,-7
19068,19068,19069,1,2,1
19069,19069,19070,2,1,-1
19070,19070,19071,1,1,0
19071,19071,19072,1,0,-1
19072,19072,19073,0,7,7
19073,19073,19074,7,0,-7
19074,19074,19075,0,3,3
19075,19075,19076,3,4,1
19076,19076,19077,4,5,1
19077,19077,19078,5,5,0
19078,19078,19079,5,8,3
19079,19079,19080,8,0,-8
19080,19080,19081,0,5,5
19081,19081,19082,5,0,-5
19082,19082,19083,0,5,5
19083,19083,19084,5,2,-3
19084,19084,19085,2,9,7
19085,19085,19086,9,7,-2
19086,19086,19087,7,2,-5
19087,19087,19088,2,4,2
19088,19088,19089,4,5,1
19089,19089,19090,5,1,-4
19090,19090,19091,1,1,0
19091,19091,19092,1,3,2
19092,19092,19093,3,1,-2
19093,19093,19094,1,1,0
19094,19094,19095,1,6,5
19095,19095,19096,6,1,-5
19096,19096,19097,1,2,1
19097,19097,19098,2,9,7
19098,19098,19099,9,1,-8
19099,19099,19100,1,1,0
19100,19100,19101,1,3,2
19101,19101,19102,3,1,-2
19102,19102,19103,1,8,7
19103,19103,19104,8,0,-8
19104,19104,19105,0,6,6
19105,19105,19106,6,5,-1
19106,19106,19107,5,4,-1
19107,19107,19108,4,5,1
19108,19108,19109,5,9,4
19109,19109,19110,9,3,-6
19110,19110,19111,3,4,1
19111,19111,19112,4,4,0
19112,19112,19113,4,9,5
19113,19113,19114,9,3,-6
19114,19114,19115,3,2,-1
19115,19115,19116,2,3,1
19116,19116,19117,3,0,-3
19117,19117,19118,0,6,6
19118,19118,19119,6,0,-6
19119,19119,19120,0,9,9
19120,19120,19121,9,4,-5
19121,19121,19122,4,1,-3
19122,19122,19123,1,4,3
19123,19123,19124,4,8,4
19124,19124,19125,8,6,-2
19125,19125,19126,6,9,3
19126,19126,19127,9,0,-9
19127,19127,19128,0,8,8
19128,19128,19129,8,2,-6
19129,19129,19130,2,5,3
19130,19130,19131,5,8,3
19131,19131,19132,8,2,-6
19132,19132,19133,2,0,-2
19133,19133,19134,0,6,6
19134,19134,19135,6,6,0
19135,19135,19136,6,1,-5
19136,19136,19137,1,8,7
19137,19137,19138,8,4,-4
19138,19138,19139,4,1,-3
19139,19139,19140,1,9,8
19140,19140,19141,9,7,-2
19141,19141,19142,7,6,-1
19142,19142,19143,6,9,3
19143,19143,19144,9,9,0
19144,19144,19145,9,1,-8
19145,19145,19146,1,9,8
19146,19146,19147,9,9,0
19147,19147,19148,9,8,-1
19148,19148,19149,8,2,-6
19149,19149,19150,2,1,-1
19150,19150,19151,1,6,5
19151,19151,19152,6,2,-4
19152,19152,19153,2,7,5
19153,19153,19154,7,2,-5
19154,19154,19155,2,6,4
19155,19155,19156,6,0,-6
19156,19156,19157,0,6,6
19157,19157,19158,6,1,-5
19158,19158,19159,1,8,7
19159,19159,19160,8,5,-3
19160,19160,19161,5,4,-1
19161,19161,19162,4,5,1
19162,19162,19163,5,9,4
19163,19163,19164,9,7,-2
19164,19164,19165,7,2,-5
19165,19165,19166,2,0,-2
19166,19166,19167,0,1,1
19167,19167,19168,1,1,0
19168,19168,19169,1,3,2
19169,19169,19170,3,5,2
19170,19170,19171,5,0,-5
19171,19171,19172,0,7,7
19172,19172,19173,7,5,-2
19173,19173,19174,5,5,0
19174,19174,19175,5,5,0
19175,19175,19176,5,1,-4
19176,19176,19177,1,8,7
19177,19177,19178,8,9,1
19178,19178,19179,9,0,-9
19179,19179,19180,0,0,0
19180,19180,19181,0,3,3
19181,19181,19182,3,8,5
19182,19182,19183,8,7,-1
19183,19183,19184,7,7,0
19184,19184,19185,7,9,2
19185,19185,19186,9,5,-4
19186,19186,19187,5,7,2
19187,19187,19188,7,1,-6
19188,19188,19189,1,0,-1
19189,19189,19190,0,9,9
19190,19190,19191,9,2,-7
19191,19191,19192,2,4,2
19192,19192,19193,4,7,3
19193,19193,19194,7,8,1
19194,19194,19195,8,3,-5
19195,19195,19196,3,6,3
19196,19196,19197,6,6,0
19197,19197,19198,6,4,-2
19198,19198,19199,4,7,3
19199,19199,19200,7,3,-4
19200,19200,19201,3,8,5
19201,19201,19202,8,4,-4
19202,19202,19203,4,0,-4
19203,19203,19204,0,8,8
19204,19204,19205,8,3,-5
19205,19205,19206,3,6,3
19206,19206,19207,6,5,-1
19207,19207,19208,5,6,1
19208,19208,19209,6,0,-6
19209,19209,19210,0,2,2
19210,19210,19211,2,1,-1
19211,19211,19212,1,9,8
19212,19212,19213,9,2,-7
19213,19213,19214,2,8,6
19214,19214,19215,8,3,-5
19215,19215,19216,3,0,-3
19216,19216,19217,0,4,4
19217,19217,19218,4,6,2
19218,19218,19219,6,5,-1
19219,19219,19220,5,9,4
19220,19220,19221,9,7,-2
19221,19221,19222,7,3,-4
19222,19222,19223,3,8,5
19223,19223,19224,8,8,0
19224,19224,19225,8,0,-8
19225,19225,19226,0,7,7
19226,19226,19227,7,1,-6
19227,19227,19228,1,6,5
19228,19228,19229,6,2,-4
19229,19229,19230,2,3,1
19230,19230,19231,3,3,0
19231,19231,19232,3,2,-1
19232,19232,19233,2,4,2
19233,19233,19234,4,3,-1
19234,19234,19235,3,7,4
19235,19235,19236,7,5,-2
19236,19236,19237,5,8,3
19237,19237,19238,8,3,-5
19238,19238,19239,3,9,6
19239,19239,19240,9,0,-9
19240,19240,19241,0,0,0
19241,19241,19242,0,8,8
19242,19242,19243,8,1,-7
19243,19243,19244,1,9,8
19244,19244,19245,9,2,-7
19245,19245,19246,2,3,1
19246,19246,19247,3,3,0
19247,19247,19248,3,2,-1
19248,19248,19249,2,4,2
19249,19249,19250,4,3,-1
19250,19250,19251,3,7,4
19251,19251,19252,7,4,-3
19252,19252,19253,4,8,4
19253,19253,19254,8,9,1
19254,19254,19255,9,9,0
19255,19255,19256,9,9,0
19256,19256,19257,9,7,-2
19257,19257,19258,7,0,-7
19258,19258,19259,0,7,7
19259,19259,19260,7,7,0
19260,19260,19261,7,0,-7
19261,19261,19262,0,7,7
19262,19262,19263,7,3,-4
19263,19263,19264,3,3,0
19264,19264,19265,3,1,-2
19265,19265,19266,1,3,2
19266,19266,19267,3,8,5
19267,19267,19268,8,9,1
19268,19268,19269,9,9,0
19269,19269,19270,9,7,-2
19270,19270,19271,7,2,-5
19271,19271,19272,2,6,4
19272,19272,19273,6,1,-5
19273,19273,19274,1,6,5
19274,19274,19275,6,8,2
19275,19275,19276,8,6,-2
19276,19276,19277,6,6,0
19277,19277,19278,6,1,-5
19278,19278,19279,1,5,4
19279,19279,19280,5,3,-2
19280,19280,19281,3,4,1
19281,19281,19282,4,1,-3
19282,19282,19283,1,7,6
19283,19283,19284,7,7,0
19284,19284,19285,7,3,-4
19285,19285,19286,3,4,1
19286,19286,19287,4,4,0
19287,19287,19288,4,5,1
19288,19288,19289,5,1,-4
19289,19289,19290,1,6,5
19290,19290,19291,6,8,2
19291,19291,19292,8,0,-8
19292,19292,19293,0,6,6
19293,19293,19294,6,4,-2
19294,19294,19295,4,9,5
19295,19295,19296,9,2,-7
19296,19296,19297,2,1,-1
19297,19297,19298,1,6,5
19298,19298,19299,6,4,-2
19299,19299,19300,4,9,5
19300,19300,19301,9,5,-4
19301,19301,19302,5,3,-2
19302,19302,19303,3,0,-3
19303,19303,19304,0,1,1
19304,19304,19305,1,1,0
19305,19305,19306,1,5,4
19306,19306,19307,5,3,-2
19307,19307,19308,3,0,-3
19308,19308,19309,0,6,6
19309,19309,19310,6,9,3
19310,19310,19311,9,4,-5
19311,19311,19312,4,7,3
19312,19312,19313,7,8,1
19313,19313,19314,8,2,-6
19314,19314,19315,2,9,7
19315,19315,19316,9,6,-3
19316,19316,19317,6,8,2
19317,19317,19318,8,5,-3
19318,19318,19319,5,5,0
19319,19319,19320,5,9,4
19320,19320,19321,9,2,-7
19321,19321,19322,2,9,7
19322,19322,19323,9,1,-8
19323,19323,19324,1,2,1
19324,19324,19325,2,0,-2
19325,19325,19326,0,3,3
19326,19326,19327,3,7,4
19327,19327,19328,7,5,-2
19328,19328,19329,5,6,1
19329,19329,19330,6,6,0
19330,19330,19331,6,6,0
19331,19331,19332,6,6,0
19332,19332,19333,6,3,-3
19333,19333,19334,3,7,4
19334,19334,19335,7,3,-4
19335,19335,19336,3,2,-1
19336,19336,19337,2,3,1
19337,19337,19338,3,3,0
19338,19338,19339,3,1,-2
19339,19339,19340,1,4,3
19340,19340,19341,4,7,3
19341,19341,19342,7,3,-4
19342,19342,19343,3,2,-1
19343,19343,19344,2,7,5
19344,19344,19345,7,2,-5
19345,19345,19346,2,1,-1
19346,19346,19347,1,3,2
19347,19347,19348,3,3,0
19348,19348,19349,3,6,3
19349,19349,19350,6,8,2
19350,19350,19351,8,8,0
19351,19351,19352,8,7,-1
19352,19352,19353,7,5,-2
19353,19353,19354,5,5,0
19354,19354,19355,5,1,-4
19355,19355,19356,1,6,5
19356,19356,19357,6,4,-2
19357,19357,19358,4,8,4
19358,19358,19359,8,9,1
19359,19359,19360,9,0,-9
19360,19360,19361,0,0,0
19361,19361,19362,0,8,8
19362,19362,19363,8,6,-2
19363,19363,19364,6,5,-1
19364,19364,19365,5,8,3
19365,19365,19366,8,5,-3
19366,19366,19367,5,8,3
19367,19367,19368,8,3,-5
19368,19368,19369,3,0,-3
19369,19369,19370,0,7,7
19370,19370,19371,7,8,1
19371,19371,19372,8,7,-1
19372,19372,19373,7,2,-5
19373,19373,19374,2,5,3
19374,19374,19375,5,4,-1
19375,19375,19376,4,0,-4
19376,19376,19377,0,3,3
19377,19377,19378,3,4,1
19378,19378,19379,4,7,3
19379,19379,19380,7,4,-3
19380,19380,19381,4,1,-3
19381,19381,19382,1,6,5
19382,19382,19383,6,7,1
19383,19383,19384,7,6,-1
19384,19384,19385,6,6,0
19385,19385,19386,6,3,-3
19386,19386,19387,3,9,6
19387,19387,19388,9,1,-8
19388,19388,19389,1,4,3
19389,19389,19390,4,5,1
19390,19390,19391,5,2,-3
19391,19391,19392,2,8,6
19392,19392,19393,8,9,1
19393,19393,19394,9,1,-8
19394,19394,19395,1,9,8
19395,19395,19396,9,5,-4
19396,19396,19397,5,2,-3
19397,19397,19398,2,5,3
19398,19398,19399,5,0,-5
19399,19399,19400,0,1,1
19400,19400,19401,1,4,3
19401,19401,19402,4,2,-2
19402,19402,19403,2,9,7
19403,19403,19404,9,4,-5
19404,19404,19405,4,4,0
19405,19405,19406,4,4,0
19406,19406,19407,4,0,-4
19407,19407,19408,0,6,6
19408,19408,19409,6,7,1
19409,19409,19410,7,1,-6
19410,19410,19411,1,1,0
19411,19411,19412,1,9,8
19412,19412,19413,9,3,-6
19413,19413,19414,3,4,1
19414,19414,19415,4,2,-2
19415,19415,19416,2,7,5
19416,19416,19417,7,9,2
19417,19417,19418,9,4,-5
19418,19418,19419,4,0,-4
19419,19419,19420,0,1,1
19420,19420,19421,1,1,0
19421,19421,19422,1,5,4
19422,19422,19423,5,2,-3
19423,19423,19424,2,7,5
19424,19424,19425,7,3,-4
19425,19425,19426,3,6,3
19426,19426,19427,6,4,-2
19427,19427,19428,4,9,5
19428,19428,19429,9,5,-4
19429,19429,19430,5,5,0
19430,19430,19431,5,6,1
19431,19431,19432,6,2,-4
19432,19432,19433,2,7,5
19433,19433,19434,7,7,0
19434,19434,19435,7,8,1
19435,19435,19436,8,5,-3
19436,19436,19437,5,9,4
19437,19437,19438,9,3,-6
19438,19438,19439,3,0,-3
19439,19439,19440,0,1,1
19440,19440,19441,1,1,0
19441,19441,19442,1,3,2
19442,19442,19443,3,2,-1
19443,19443,19444,2,2,0
19444,19444,19445,2,3,1
19445,19445,19446,3,1,-2
19446,19446,19447,1,4,3
19447,19447,19448,4,7,3
19448,19448,19449,7,5,-2
19449,19449,19450,5,2,-3
19450,19450,19451,2,6,4
19451,19451,19452,6,1,-5
19452,19452,19453,1,7,6
19453,19453,19454,7,0,-7
19454,19454,19455,0,8,8
19455,19455,19456,8,5,-3
19456,19456,19457,5,9,4
19457,19457,19458,9,8,-1
19458,19458,19459,8,0,-8
19459,19459,19460,0,8,8
19460,19460,19461,8,1,-7
19461,19461,19462,1,6,5
19462,19462,19463,6,2,-4
19463,19463,19464,2,6,4
19464,19464,19465,6,3,-3
19465,19465,19466,3,2,-1
19466,19466,19467,2,4,2
19467,19467,19468,4,2,-2
19468,19468,19469,2,5,3
19469,19469,19470,5,8,3
19470,19470,19471,8,6,-2
19471,19471,19472,6,5,-1
19472,19472,19473,5,7,2
19473,19473,19474,7,3,-4
19474,19474,19475,3,8,5
19475,19475,19476,8,5,-3
19476,19476,19477,5,9,4
19477,19477,19478,9,4,-5
19478,19478,19479,4,7,3
19479,19479,19480,7,0,-7
19480,19480,19481,0,6,6
19481,19481,19482,6,1,-5
19482,19482,19483,1,4,3
19483,19483,19484,4,4,0
19484,19484,19485,4,0,-4
19485,19485,19486,0,1,1
19486,19486,19487,1,5,4
19487,19487,19488,5,6,1
19488,19488,19489,6,8,2
19489,19489,19490,8,0,-8
19490,19490,19491,0,0,0
19491,19491,19492,0,0,0
19492,19492,19493,0,7,7
19493,19493,19494,7,9,2
19494,19494,19495,9,3,-6
19495,19495,19496,3,6,3
19496,19496,19497,6,5,-1
19497,19497,19498,5,4,-1
19498,19498,19499,4,4,0
19499,19499,19500,4,3,-1
19500,19500,19501,3,3,0
19501,19501,19502,3,2,-1
19502,19502,19503,2,6,4
19503,19503,19504,6,0,-6
19504,19504,19505,0,2,2
19505,19505,19506,2,5,3
19506,19506,19507,5,1,-4
19507,19507,19508,1,2,1
19508,19508,19509,2,7,5
19509,19509,19510,7,1,-6
19510,19510,19511,1,7,6
19511,19511,19512,7,9,2
19512,19512,19513,9,9,0
19513,19513,19514,9,4,-5
19514,19514,19515,4,9,5
19515,19515,19516,9,1,-8
19516,19516,19517,1,1,0
19517,19517,19518,1,3,2
19518,19518,19519,3,2,-1
19519,19519,19520,2,4,2
19520,19520,19521,4,4,0
19521,19521,19522,4,4,0
19522,19522,19523,4,6,2
19523,19523,19524,6,2,-4
19524,19524,19525,2,7,5
19525,19525,19526,7,1,-6
19526,19526,19527,1,7,6
19527,19527,19528,7,1,-6
19528,19528,19529,1,5,4
19529,19529,19530,5,6,1
19530,19530,19531,6,4,-2
19531,19531,19532,4,6,2
19532,19532,19533,6,5,-1
19533,19533,19534,5,7,2
19534,19534,19535,7,0,-7
19535,19535,19536,0,3,3
19536,19536,19537,3,9,6
19537,19537,19538,9,8,-1
19538,19538,19539,8,9,1
19539,19539,19540,9,8,-1
19540,19540,19541,8,8,0
19541,19541,19542,8,0,-8
19542,19542,19543,0,0,0
19543,19543,19544,0,1,1
19544,19544,19545,1,2,1
19545,19545,19546,2,9,7
19546,19546,19547,9,0,-9
19547,19547,19548,0,3,3
19548,19548,19549,3,3,0
19549,19549,19550,3,0,-3
19550,19550,19551,0,5,5
19551,19551,19552,5,1,-4
19552,19552,19553,1,6,5
19553,19553,19554,6,0,-6
19554,19554,19555,0,1,1
19555,19555,19556,1,2,1
19556,19556,19557,2,8,6
19557,19557,19558,8,9,1
19558,19558,19559,9,6,-3
19559,19559,19560,6,9,3
19560,19560,19561,9,4,-5
19561,19561,19562,4,6,2
19562,19562,19563,6,6,0
19563,19563,19564,6,4,-2
19564,19564,19565,4,0,-4
19565,19565,19566,0,8,8
19566,19566,19567,8,9,1
19567,19567,19568,9,2,-7
19568,19568,19569,2,2,0
19569,19569,19570,2,8,6
19570,19570,19571,8,6,-2
19571,19571,19572,6,7,1
19572,19572,19573,7,4,-3
19573,19573,19574,4,7,3
19574,19574,19575,7,3,-4
19575,19575,19576,3,9,6
19576,19576,19577,9,9,0
19577,19577,19578,9,5,-4
19578,19578,19579,5,3,-2
19579,19579,19580,3,7,4
19580,19580,19581,7,0,-7
19581,19581,19582,0,8,8
19582,19582,19583,8,0,-8
19583,19583,19584,0,0,0
19584,19584,19585,0,5,5
19585,19585,19586,5,9,4
19586,19586,19587,9,2,-7
19587,19587,19588,2,0,-2
19588,19588,19589,0,5,5
19589,19589,19590,5,5,0
19590,19590,19591,5,8,3
19591,19591,19592,8,7,-1
19592,19592,19593,7,8,1
19593,19593,19594,8,0,-8
19594,19594,19595,0,8,8
19595,19595,19596,8,9,1
19596,19596,19597,9,9,0
19597,19597,19598,9,1,-8
19598,19598,19599,1,4,3
19599,19599,19600,4,8,4
19600,19600,19601,8,3,-5
19601,19601,19602,3,2,-1
19602,19602,19603,2,8,6
19603,19603,19604,8,0,-8
19604,19604,19605,0,8,8
19605,19605,19606,8,2,-6
19606,19606,19607,2,5,3
19607,19607,19608,5,4,-1
19608,19608,19609,4,5,1
19609,19609,19610,5,5,0
19610,19610,19611,5,7,2
19611,19611,19612,7,0,-7
19612,19612,19613,0,1,1
19613,19613,19614,1,1,0
19614,19614,19615,1,3,2
19615,19615,19616,3,9,6
19616,19616,19617,9,6,-3
19617,19617,19618,6,8,2
19618,19618,19619,8,9,1
19619,19619,19620,9,3,-6
19620,19620,19621,3,4,1
19621,19621,19622,4,1,-3
19622,19622,19623,1,1,0
19623,19623,19624,1,6,5
19624,19624,19625,6,7,1
19625,19625,19626,7,1,-6
19626,19626,19627,1,6,5
19627,19627,19628,6,0,-6
19628,19628,19629,0,9,9
19629,19629,19630,9,1,-8
19630,19630,19631,1,3,2
19631,19631,19632,3,2,-1
19632,19632,19633,2,3,1
19633,19633,19634,3,4,1
19634,19634,19635,4,7,3
19635,19635,19636,7,7,0
19636,19636,19637,7,4,-3
19637,19637,19638,4,5,1
19638,19638,19639,5,1,-4
19639,19639,19640,1,1,0
19640,19640,19641,1,9,8
19641,19641,19642,9,7,-2
19642,19642,19643,7,1,-6
19643,19643,19644,1,9,8
19644,19644,19645,9,0,-9
19645,19645,19646,0,0,0
19646,19646,19647,0,6,6
19647,19647,19648,6,7,1
19648,19648,19649,7,0,-7
19649,19649,19650,0,8,8
19650,19650,19651,8,1,-7
19651,19651,19652,1,1,0
19652,19652,19653,1,2,1
19653,19653,19654,2,2,0
19654,19654,19655,2,3,1
19655,19655,19656,3,6,3
19656,19656,19657,6,4,-2
19657,19657,19658,4,7,3
19658,19658,19659,7,5,-2
19659,19659,19660,5,3,-2
19660,19660,19661,3,6,3
19661,19661,19662,6,8,2
19662,19662,19663,8,7,-1
19663,19663,19664,7,0,-7
19664,19664,19665,0,8,8
19665,19665,19666,8,4,-4
19666,19666,19667,4,9,5
19667,19667,19668,9,7,-2
19668,19668,19669,7,0,-7
19669,19669,19670,0,5,5
19670,19670,19671,5,1,-4
19671,19671,19672,1,4,3
19672,19672,19673,4,2,-2
19673,19673,19674,2,1,-1
19674,19674,19675,1,3,2
19675,19675,19676,3,5,2
19676,19676,19677,5,4,-1
19677,19677,19678,4,6,2
19678,19678,19679,6,5,-1
19679,19679,19680,5,2,-3
19680,19680,19681,2,6,4
19681,19681,19682,6,0,-6
19682,19682,19683,0,7,7
19683,19683,19684,7,6,-1
19684,19684,19685,6,8,2
19685,19685,19686,8,0,-8
19686,19686,19687,0,9,9
19687,19687,19688,9,2,-7
19688,19688,19689,2,0,-2
19689,19689,19690,0,9,9
19690,19690,19691,9,1,-8
19691,19691,19692,1,8,7
19692,19692,19693,8,2,-6
19693,19693,19694,2,2,0
19694,19694,19695,2,3,1
19695,19695,19696,3,9,6
19696,19696,19697,9,4,-5
19697,19697,19698,4,6,2
19698,19698,19699,6,5,-1
19699,19699,19700,5,4,-1
19700,19700,19701,4,6,2
19701,19701,19702,6,5,-1
19702,19702,19703,5,7,2
19703,19703,19704,7,7,0
19704,19704,19705,7,8,1
19705,19705,19706,8,5,-3
19706,19706,19707,5,9,4
19707,19707,19708,9,3,-6
19708,19708,19709,3,0,-3
19709,19709,19710,0,6,6
19710,19710,19711,6,8,2
19711,19711,19712,8,6,-2
19712,19712,19713,6,3,-3
19713,19713,19714,3,0,-3
19714,19714,19715,0,9,9
19715,19715,19716,9,8,-1
19716,19716,19717,8,5,-3
19717,19717,19718,5,9,4
19718,19718,19719,9,5,-4
19719,19719,19720,5,8,3
19720,19720,19721,8,2,-6
19721,19721,19722,2,6,4
19722,19722,19723,6,6,0
19723,19723,19724,6,1,-5
19724,19724,19725,1,8,7
19725,19725,19726,8,0,-8
19726,19726,19727,0,4,4
19727,19727,19728,4,9,5
19728,19728,19729,9,9,0
19729,19729,19730,9,9,0
19730,19730,19731,9,1,-8
19731,19731,19732,1,0,-1
19732,19732,19733,0,7,7
19733,19733,19734,7,3,-4
19734,19734,19735,3,1,-2
19735,19735,19736,1,3,2
19736,19736,19737,3,2,-1
19737,19737,19738,2,0,-2
19738,19738,19739,0,3,3
19739,19739,19740,3,7,4
19740,19740,19741,7,5,-2
19741,19741,19742,5,1,-4
19742,19742,19743,1,9,8
19743,19743,19744,9,0,-9
19744,19744,19745,0,6,6
19745,19745,19746,6,5,-1
19746,19746,19747,5,9,4
19747,19747,19748,9,9,0
19748,19748,19749,9,1,-8
19749,19749,19750,1,2,1
19750,19750,19751,2,1,-1
19751,19751,19752,1,5,4
19752,19752,19753,5,1,-4
19753,19753,19754,1,6,5
19754,19754,19755,6,2,-4
19755,19755,19756,2,8,6
19756,19756,19757,8,9,1
19757,19757,19758,9,3,-6
19758,19758,19759,3,5,2
19759,19759,19760,5,0,-5
19760,19760,19761,0,6,6
19761,19761,19762,6,6,0
19762,19762,19763,6,8,2
19763,19763,19764,8,2,-6
19764,19764,19765,2,1,-1
19765,19765,19766,1,9,8
19766,19766,19767,9,2,-7
19767,19767,19768,2,1,-1
19768,19768,19769,1,0,-1
19769,19769,19770,0,0,0
19770,19770,19771,0,7,7
19771,19771,19772,7,0,-7
19772,19772,19773,0,7,7
19773,19773,19774,7,0,-7
19774,19774,19775,0,5,5
19775,19775,19776,5,1,-4
19776,19776,19777,1,8,7
19777,19777,19778,8,9,1
19778,19778,19779,9,2,-7
19779,19779,19780,2,7,5
19780,19780,19781,7,9,2
19781,19781,19782,9,1,-8
19782,19782,19783,1,8,7
19783,19783,19784,8,2,-6
19784,19784,19785,2,9,7
19785,19785,19786,9,0,-9
19786,19786,19787,0,0,0
19787,19787,19788,0,6,6
19788,19788,19789,6,4,-2
19789,19789,19790,4,8,4
19790,19790,19791,8,7,-1
19791,19791,19792,7,8,1
19792,19792,19793,8,3,-5
19793,19793,19794,3,4,1
19794,19794,19795,4,4,0
19795,19795,19796,4,0,-4
19796,19796,19797,0,5,5
19797,19797,19798,5,0,-5
19798,19798,19799,0,6,6
19799,19799,19800,6,7,1
19800,19800,19801,7,0,-7
19801,19801,19802,0,2,2
19802,19802,19803,2,3,1
19803,19803,19804,3,1,-2
19804,19804,19805,1,6,5
19805,19805,19806,6,9,3
19806,19806,19807,9,8,-1
19807,19807,19808,8,2,-6
19808,19808,19809,2,7,5
19809,19809,19810,7,4,-3
19810,19810,19811,4,0,-4
19811,19811,19812,0,7,7
19812,19812,19813,7,4,-3
19813,19813,19814,4,9,5
19814,19814,19815,9,2,-7
19815,19815,19816,2,1,-1
19816,19816,19817,1,7,6
19817,19817,19818,7,0,-7
19818,19818,19819,0,4,4
19819,19819,19820,4,5,1
19820,19820,19821,5,3,-2
19821,19821,19822,3,0,-3
19822,19822,19823,0,7,7
19823,19823,19824,7,9,2
19824,19824,19825,9,5,-4
19825,19825,19826,5,8,3
19826,19826,19827,8,4,-4
19827,19827,19828,4,6,2
19828,19828,19829,6,3,-3
19829,19829,19830,3,1,-2
19830,19830,19831,1,4,3
19831,19831,19832,4,9,5
19832,19832,19833,9,2,-7
19833,19833,19834,2,3,1
19834,19834,19835,3,8,5
19835,19835,19836,8,3,-5
19836,19836,19837,3,1,-2
19837,19837,19838,1,7,6
19838,19838,19839,7,5,-2
19839,19839,19840,5,4,-1
19840,19840,19841,4,1,-3
19841,19841,19842,1,7,6
19842,19842,19843,7,2,-5
19843,19843,19844,2,7,5
19844,19844,19845,7,0,-7
19845,19845,19846,0,5,5
19846,19846,19847,5,2,-3
19847,19847,19848,2,6,4
19848,19848,19849,6,5,-1
19849,19849,19850,5,1,-4
19850,19850,19851,1,6,5
19851,19851,19852,6,5,-1
19852,19852,19853,5,4,-1
19853,19853,19854,4,2,-2
19854,19854,19855,2,3,1
19855,19855,19856,3,0,-3
19856,19856,19857,0,0,0
19857,19857,19858,0,5,5
19858,19858,19859,5,0,-5
19859,19859,19860,0,9,9
19860,19860,19861,9,0,-9
19861,19861,19862,0,5,5
19862,19862,19863,5,3,-2
19863,19863,19864,3,8,5
19864,19864,19865,8,3,-5
19865,19865,19866,3,3,0
19866,19866,19867,3,5,2
19867,19867,19868,5,5,0
19868,19868,19869,5,7,2
19869,19869,19870,7,5,-2
19870,19870,19871,5,0,-5
19871,19871,19872,0,0,0
19872,19872,19873,0,6,6
19873,19873,19874,6,5,-1
19874,19874,19875,5,4,-1
19875,19875,19876,4,2,-2
19876,19876,19877,2,8,6
19877,19877,19878,8,3,-5
19878,19878,19879,3,8,5
19879,19879,19880,8,1,-7
19880,19880,19881,1,6,5
19881,19881,19882,6,4,-2
19882,19882,19883,4,3,-1
19883,19883,19884,3,1,-2
19884,19884,19885,1,9,8
19885,19885,19886,9,2,-7
19886,19886,19887,2,9,7
19887,19887,19888,9,5,-4
19888,19888,19889,5,8,3
19889,19889,19890,8,2,-6
19890,19890,19891,2,2,0
19891,19891,19892,2,5,3
19892,19892,19893,5,7,2
19893,19893,19894,7,1,-6
19894,19894,19895,1,7,6
19895,19895,19896,7,6,-1
19896,19896,19897,6,1,-5
19897,19897,19898,1,1,0
19898,19898,19899,1,0,-1
19899,19899,19900,0,0,0
19900,19900,19901,0,1,1
19901,19901,19902,1,0,-1
19902,19902,19903,0,2,2
19903,19903,19904,2,7,5
19904,19904,19905,7,3,-4
19905,19905,19906,3,8,5
19906,19906,19907,8,4,-4
19907,19907,19908,4,0,-4
19908,19908,19909,0,5,5
19909,19909,19910,5,9,4
19910,19910,19911,9,8,-1
19911,19911,19912,8,7,-1
19912,19912,19913,7,9,2
19913,19913,19914,9,9,0
19914,19914,19915,9,0,-9
19915,19915,19916,0,6,6
19916,19916,19917,6,1,-5
19917,19917,19918,1,1,0
19918,19918,19919,1,2,1
19919,19919,19920,2,5,3
19920,19920,19921,5,3,-2
19921,19921,19922,3,4,1
19922,19922,19923,4,4,0
19923,19923,19924,4,0,-4
19924,19924,19925,0,5,5
19925,19925,19926,5,2,-3
19926,19926,19927,2,6,4
19927,19927,19928,6,8,2
19928,19928,19929,8,7,-1
19929,19929,19930,7,0,-7
19930,19930,19931,0,8,8
19931,19931,19932,8,8,0
19932,19932,19933,8,9,1
19933,19933,19934,9,9,0
19934,19934,19935,9,0,-9
19935,19935,19936,0,4,4
19936,19936,19937,4,1,-3
19937,19937,19938,1,9,8
19938,19938,19939,9,2,-7
19939,19939,19940,2,1,-1
19940,19940,19941,1,3,2
19941,19941,19942,3,5,2
19942,19942,19943,5,4,-1
19943,19943,19944,4,5,1
19944,19944,19945,5,5,0
19945,19945,19946,5,6,1
19946,19946,19947,6,6,0
19947,19947,19948,6,8,2
19948,19948,19949,8,7,-1
19949,19949,19950,7,3,-4
19950,19950,19951,3,8,5
19951,19951,19952,8,4,-4
19952,19952,19953,4,9,5
19953,19953,19954,9,6,-3
19954,19954,19955,6,1,-5
19955,19955,19956,1,6,5
19956,19956,19957,6,4,-2
19957,19957,19958,4,5,1
19958,19958,19959,5,5,0
19959,19959,19960,5,6,1
19960,19960,19961,6,4,-2
19961,19961,19962,4,3,-1
19962,19962,19963,3,2,-1
19963,19963,19964,2,6,4
19964,19964,19965,6,3,-3
19965,19965,19966,3,1,-2
19966,19966,19967,1,3,2
19967,19967,19968,3,1,-2
19968,19968,19969,1,0,-1
19969,19969,19970,0,6,6
19970,19970,19971,6,9,3
19971,19971,19972,9,9,0
19972,19972,19973,9,5,-4
19973,19973,19974,5,0,-5
19974,19974,19975,0,4,4
19975,19975,19976,4,3,-1
19976,19976,19977,3,3,0
19977,19977,19978,3,7,4
19978,19978,19979,7,0,-7
19979,19979,19980,0,5,5
19980,19980,19981,5,8,3
19981,19981,19982,8,2,-6
19982,19982,19983,2,4,2
19983,19983,19984,4,6,2
19984,19984,19985,6,0,-6
19985,19985,19986,0,6,6
19986,19986,19987,6,7,1
19987,19987,19988,7,8,1
19988,19988,19989,8,7,-1
19989,19989,19990,7,0,-7
19990,19990,19991,0,1,1
19991,19991,19992,1,9,8
19992,19992,19993,9,6,-3
19993,19993,19994,6,5,-1
19994,19994,19995,5,9,4
19995,19995,19996,9,5,-4
19996,19996,19997,5,1,-4
19997,19997,19998,1,4,3
19998,19998,19999,4,2,-2
19999,19999,20000,2,5,3
20000,20000,20001,5,9,4
20001,20001,20002,9,7,-2
20002,20002,20003,7,3,-4
20003,20003,20004,3,7,4
20004,20004,20005,7,6,-1
20005,20005,20006,6,5,-1
20006,20006,20007,5,2,-3
20007,20007,20008,2,4,2
20008,20008,20009,4,3,-1
20009,20009,20010,3,0,-3
20010,20010,20011,0,4,4
20011,20011,20012,4,0,-4
20012,20012,20013,0,6,6
20013,20013,20014,6,8,2
20014,20014,20015,8,8,0
20015,20015,20016,8,3,-5
20016,20016,20017,3,5,2
20017,20017,20018,5,1,-4
20018,20018,20019,1,7,6
20019,20019,20020,7,8,1
20020,20020,20021,8,2,-6
20021,20021,20022,2,2,0
20022,20022,20023,2,3,1
20023,20023,20024,3,8,5
20024,20024,20025,8,8,0
20025,20025,20026,8,9,1
20026,20026,20027,9,1,-8
20027,20027,20028,1,2,1
20028,20028,20029,2,2,0
20029,20029,20030,2,7,5
20030,20030,20031,7,9,2
20031,20031,20032,9,7,-2
20032,20032,20033,7,5,-2
20033,20033,20034,5,5,0
20034,20034,20035,5,8,3
20035,20035,20036,8,1,-7
20036,20036,20037,1,8,7
20037,20037,20038,8,5,-3
20038,20038,20039,5,7,2
20039,20039,20040,7,4,-3
20040,20040,20041,4,1,-3
20041,20041,20042,1,2,1
20042,20042,20043,2,7,5
20043,20043,20044,7,5,-2
20044,20044,20045,5,1,-4
20045,20045,20046,1,1,0
20046,20046,20047,1,1,0
20047,20047,20048,1,7,6
20048,20048,20049,7,0,-7
20049,20049,20050,0,9,9
20050,20050,20051,9,3,-6
20051,20051,20052,3,1,-2
20052,20052,20053,1,4,3
20053,20053,20054,4,9,5
20054,20054,20055,9,2,-7
20055,20055,20056,2,4,2
20056,20056,20057,4,6,2
20057,20057,20058,6,1,-5
20058,20058,20059,1,4,3
20059,20059,20060,4,0,-4
20060,20060,20061,0,7,7
20061,20061,20062,7,8,1
20062,20062,20063,8,4,-4
20063,20063,20064,4,1,-3
20064,20064,20065,1,2,1
20065,20065,20066,2,1,-1
20066,20066,20067,1,7,6
20067,20067,20068,7,8,1
20068,20068,20069,8,4,-4
20069,20069,20070,4,1,-3
20070,20070,20071,1,2,1
20071,20071,20072,2,3,1
20072,20072,20073,3,9,6
20073,20073,20074,9,4,-5
20074,20074,20075,4,9,5
20075,20075,20076,9,6,-3
20076,20076,20077,6,2,-4
20077,20077,20078,2,2,0
20078,20078,20079,2,8,6
20079,20079,20080,8,3,-5
20080,20080,20081,3,6,3
20081,20081,20082,6,4,-2
20082,20082,20083,4,1,-3
20083,20083,20084,1,9,8
20084,20084,20085,9,0,-9
20085,20085,20086,0,9,9
20086,20086,20087,9,6,-3
20087,20087,20088,6,0,-6
20088,20088,20089,0,8,8
20089,20089,20090,8,7,-1
20090,20090,20091,7,5,-2
20091,20091,20092,5,5,0
20092,20092,20093,5,5,0
20093,20093,20094,5,1,-4
20094,20094,20095,1,0,-1
20095,20095,20096,0,3,3
20096,20096,20097,3,5,2
20097,20097,20098,5,4,-1
20098,20098,20099,4,3,-1
20099,20099,20100,3,2,-1
20100,20100,20101,2,5,3
20101,20101,20102,5,8,3
20102,20102,20103,8,9,1
20103,20103,20104,9,6,-3
20104,20104,20105,6,7,1
20105,20105,20106,7,8,1
20106,20106,20107,8,8,0
20107,20107,20108,8,1,-7
20108,20108,20109,1,5,4
20109,20109,20110,5,4,-1
20110,20110,20111,4,9,5
20111,20111,20112,9,9,0
20112,20112,20113,9,6,-3
20113,20113,20114,6,0,-6
20114,20114,20115,0,9,9
20115,20115,20116,9,8,-1
20116,20116,20117,8,0,-8
20117,20117,20118,0,4,4
20118,20118,20119,4,6,2
20119,20119,20120,6,5,-1
20120,20120,20121,5,3,-2
20121,20121,20122,3,6,3
20122,20122,20123,6,0,-6
20123,20123,20124,0,6,6
20124,20124,20125,6,5,-1
20125,20125,20126,5,9,4
20126,20126,20127,9,8,-1
20127,20127,20128,8,0,-8
20128,20128,20129,0,9,9
20129,20129,20130,9,9,0
20130,20130,20131,9,1,-8
20131,20131,20132,1,1,0
20132,20132,20133,1,8,7
20133,20133,20134,8,7,-1
20134,20134,20135,7,1,-6
20135,20135,20136,1,6,5
20136,20136,20137,6,6,0
20137,20137,20138,6,9,3
20138,20138,20139,9,0,-9
20139,20139,20140,0,5,5
20140,20140,20141,5,0,-5
20141,20141,20142,0,6,6
20142,20142,20143,6,1,-5
20143,20143,20144,1,4,3
20144,20144,20145,4,2,-2
20145,20145,20146,2,1,-1
20146,20146,20147,1,3,2
20147,20147,20148,3,6,3
20148,20148,20149,6,4,-2
20149,20149,20150,4,3,-1
20150,20150,20151,3,5,2
20151,20151,20152,5,6,1
20152,20152,20153,6,6,0
20153,20153,20154,6,6,0
20154,20154,20155,6,7,1
20155,20155,20156,7,6,-1
20156,20156,20157,6,8,2
20157,20157,20158,8,7,-1
20158,20158,20159,7,9,2
20159,20159,20160,9,2,-7
20160,20160,20161,2,0,-2
20161,20161,20162,0,7,7
20162,20162,20163,7,1,-6
20163,20163,20164,1,9,8
20164,20164,20165,9,2,-7
20165,20165,20166,2,3,1
20166,20166,20167,3,3,0
20167,20167,20168,3,6,3
20168,20168,20169,6,4,-2
20169,20169,20170,4,9,5
20170,20170,20171,9,5,-4
20171,20171,20172,5,4,-1
20172,20172,20173,4,6,2
20173,20173,20174,6,0,-6
20174,20174,20175,0,0,0
20175,20175,20176,0,4,4
20176,20176,20177,4,1,-3
20177,20177,20178,1,1,0
20178,20178,20179,1,2,1
20179,20179,20180,2,4,2
20180,20180,20181,4,3,-1
20181,20181,20182,3,4,1
20182,20182,20183,4,4,0
20183,20183,20184,4,9,5
20184,20184,20185,9,5,-4
20185,20185,20186,5,5,0
20186,20186,20187,5,6,1
20187,20187,20188,6,9,3
20188,20188,20189,9,7,-2
20189,20189,20190,7,5,-2
20190,20190,20191,5,8,3
20191,20191,20192,8,3,-5
20192,20192,20193,3,9,6
20193,20193,20194,9,1,-8
20194,20194,20195,1,1,0
20195,20195,20196,1,9,8
20196,20196,20197,9,4,-5
20197,20197,20198,4,8,4
20198,20198,20199,8,5,-3
20199,20199,20200,5,5,0
20200,20200,20201,5,3,-2
20201,20201,20202,3,9,6
20202,20202,20203,9,3,-6
20203,20203,20204,3,8,5
20204,20204,20205,8,0,-8
20205,20205,20206,0,7,7
20206,20206,20207,7,9,2
20207,20207,20208,9,4,-5
20208,20208,20209,4,5,1
20209,20209,20210,5,5,0
20210,20210,20211,5,4,-1
20211,20211,20212,4,1,-3
20212,20212,20213,1,3,2
20213,20213,20214,3,7,4
20214,20214,20215,7,0,-7
20215,20215,20216,0,9,9
20216,20216,20217,9,8,-1
20217,20217,20218,8,7,-1
20218,20218,20219,7,4,-3
20219,20219,20220,4,3,-1
20220,20220,20221,3,6,3
20221,20221,20222,6,3,-3
20222,20222,20223,3,7,4
20223,20223,20224,7,2,-5
20224,20224,20225,2,0,-2
20225,20225,20226,0,7,7
20226,20226,20227,7,7,0
20227,20227,20228,7,9,2
20228,20228,20229,9,7,-2
20229,20229,20230,7,4,-3
20230,20230,20231,4,1,-3
20231,20231,20232,1,1,0
20232,20232,20233,1,6,5
20233,20233,20234,6,4,-2
20234,20234,20235,4,9,5
20235,20235,20236,9,4,-5
20236,20236,20237,4,1,-3
20237,20237,20238,1,0,-1
20238,20238,20239,0,2,2
20239,20239,20240,2,2,0
20240,20240,20241,2,9,7
20241,20241,20242,9,2,-7
20242,20242,20243,2,3,1
20243,20243,20244,3,0,-3
20244,20244,20245,0,6,6
20245,20245,20246,6,5,-1
20246,20246,20247,5,2,-3
20247,20247,20248,2,9,7
20248,20248,20249,9,3,-6
20249,20249,20250,3,4,1
20250,20250,20251,4,4,0
20251,20251,20252,4,3,-1
20252,20252,20253,3,6,3
20253,20253,20254,6,9,3
20254,20254,20255,9,7,-2
20255,20255,20256,7,0,-7
20256,20256,20257,0,2,2
20257,20257,20258,2,4,2
20258,20258,20259,4,3,-1
20259,20259,20260,3,7,4
20260,20260,20261,7,8,1
20261,20261,20262,8,4,-4
20262,20262,20263,4,1,-3
20263,20263,20264,1,9,8
20264,20264,20265,9,2,-7
20265,20265,20266,2,5,3
20266,20266,20267,5,9,4
20267,20267,20268,9,2,-7
20268,20268,20269,2,8,6
20269,20269,20270,8,9,1
20270,20270,20271,9,8,-1
20271,20271,20272,8,6,-2
20272,20272,20273,6,7,1
20273,20273,20274,7,1,-6
20274,20274,20275,1,1,0
20275,20275,20276,1,4,3
20276,20276,20277,4,7,3
20277,20277,20278,7,3,-4
20278,20278,20279,3,1,-2
20279,20279,20280,1,7,6
20280,20280,20281,7,1,-6
20281,20281,20282,1,9,8
20282,20282,20283,9,0,-9
20283,20283,20284,0,2,2
20284,20284,20285,2,3,1
20285,20285,20286,3,6,3
20286,20286,20287,6,4,-2
20287,20287,20288,4,6,2
20288,20288,20289,6,2,-4
20289,20289,20290,2,9,7
20290,20290,20291,9,6,-3
20291,20291,20292,6,0,-6
20292,20292,20293,0,4,4
20293,20293,20294,4,4,0
20294,20294,20295,4,7,3
20295,20295,20296,7,7,0
20296,20296,20297,7,4,-3
20297,20297,20298,4,1,-3
20298,20298,20299,1,2,1
20299,20299,20300,2,8,6
20300,20300,20301,8,7,-1
20301,20301,20302,7,1,-6
20302,20302,20303,1,4,3
20303,20303,20304,4,7,3
20304,20304,20305,7,2,-5
20305,20305,20306,2,5,3
20306,20306,20307,5,9,4
20307,20307,20308,9,9,0
20308,20308,20309,9,2,-7
20309,20309,20310,2,7,5
20310,20310,20311,7,7,0
20311,20311,20312,7,7,0
20312,20312,20313,7,2,-5
20313,20313,20314,2,3,1
20314,20314,20315,3,8,5
20315,20315,20316,8,9,1
20316,20316,20317,9,6,-3
20317,20317,20318,6,7,1
20318,20318,20319,7,1,-6
20319,20319,20320,1,6,5
20320,20320,20321,6,0,-6
20321,20321,20322,0,1,1
20322,20322,20323,1,6,5
20323,20323,20324,6,6,0
20324,20324,20325,6,5,-1
20325,20325,20326,5,3,-2
20326,20326,20327,3,1,-2
20327,20327,20328,1,8,7
20328,20328,20329,8,3,-5
20329,20329,20330,3,9,6
20330,20330,20331,9,5,-4
20331,20331,20332,5,1,-4
20332,20332,20333,1,9,8
20333,20333,20334,9,0,-9
20334,20334,20335,0,7,7
20335,20335,20336,7,8,1
20336,20336,20337,8,4,-4
20337,20337,20338,4,4,0
20338,20338,20339,4,8,4
20339,20339,20340,8,1,-7
20340,20340,20341,1,9,8
20341,20341,20342,9,5,-4
20342,20342,20343,5,6,1
20343,20343,20344,6,3,-3
20344,20344,20345,3,9,6
20345,20345,20346,9,4,-5
20346,20346,20347,4,3,-1
20347,20347,20348,3,1,-2
20348,20348,20349,1,0,-1
20349,20349,20350,0,8,8
20350,20350,20351,8,0,-8
20351,20351,20352,0,8,8
20352,20352,20353,8,6,-2
20353,20353,20354,6,7,1
20354,20354,20355,7,3,-4
20355,20355,20356,3,3,0
20356,20356,20357,3,0,-3
20357,20357,20358,0,9,9
20358,20358,20359,9,5,-4
20359,20359,20360,5,9,4
20360,20360,20361,9,1,-8
20361,20361,20362,1,3,2
20362,20362,20363,3,8,5
20363,20363,20364,8,8,0
20364,20364,20365,8,1,-7
20365,20365,20366,1,9,8
20366,20366,20367,9,6,-3
20367,20367,20368,6,4,-2
20368,20368,20369,4,0,-4
20369,20369,20370,0,7,7
20370,20370,20371,7,0,-7
20371,20371,20372,0,8,8
20372,20372,20373,8,1,-7
20373,20373,20374,1,5,4
20374,20374,20375,5,2,-3
20375,20375,20376,2,9,7
20376,20376,20377,9,3,-6
20377,20377,20378,3,3,0
20378,20378,20379,3,4,1
20379,20379,20380,4,7,3
20380,20380,20381,7,5,-2
20381,20381,20382,5,2,-3
20382,20382,20383,2,6,4
20383,20383,20384,6,1,-5
20384,20384,20385,1,7,6
20385,20385,20386,7,7,0
20386,20386,20387,7,8,1
20387,20387,20388,8,0,-8
20388,20388,20389,0,9,9
20389,20389,20390,9,5,-4
20390,20390,20391,5,0,-5
20391,20391,20392,0,0,0
20392,20392,20393,0,1,1
20393,20393,20394,1,1,0
20394,20394,20395,1,2,1
20395,20395,20396,2,4,2
20396,20396,20397,4,3,-1
20397,20397,20398,3,7,4
20398,20398,20399,7,4,-3
20399,20399,20400,4,3,-1
20400,20400,20401,3,6,3
20401,20401,20402,6,9,3
20402,20402,20403,9,7,-2
20403,20403,20404,7,7,0
20404,20404,20405,7,8,1
20405,20405,20406,8,7,-1
20406,20406,20407,7,0,-7
20407,20407,20408,0,8,8
20408,20408,20409,8,1,-7
20409,20409,20410,1,9,8
20410,20410,20411,9,2,-7
20411,20411,20412,2,8,6
20412,20412,20413,8,3,-5
20413,20413,20414,3,2,-1
20414,20414,20415,2,4,2
20415,20415,20416,4,6,2
20416,20416,20417,6,7,1
20417,20417,20418,7,0,-7
20418,20418,20419,0,8,8
20419,20419,20420,8,0,-8
20420,20420,20421,0,9,9
20421,20421,20422,9,7,-2
20422,20422,20423,7,3,-4
20423,20423,20424,3,2,-1
20424,20424,20425,2,4,2
20425,20425,20426,4,3,-1
20426,20426,20427,3,1,-2
20427,20427,20428,1,5,4
20428,20428,20429,5,4,-1
20429,20429,20430,4,3,-1
20430,20430,20431,3,6,3
20431,20431,20432,6,2,-4
20432,20432,20433,2,6,4
20433,20433,20434,6,9,3
20434,20434,20435,9,7,-2
20435,20435,20436,7,2,-5
20436,20436,20437,2,3,1
20437,20437,20438,3,1,-2
20438,20438,20439,1,3,2
20439,20439,20440,3,2,-1
20440,20440,20441,2,2,0
20441,20441,20442,2,2,0
20442,20442,20443,2,1,-1
20443,20443,20444,1,9,8
20444,20444,20445,9,9,0
20445,20445,20446,9,2,-7
20446,20446,20447,2,4,2
20447,20447,20448,4,2,-2
20448,20448,20449,2,7,5
20449,20449,20450,7,9,2
20450,20450,20451,9,3,-6
20451,20451,20452,3,7,4
20452,20452,20453,7,5,-2
20453,20453,20454,5,2,-3
20454,20454,20455,2,4,2
20455,20455,20456,4,1,-3
20456,20456,20457,1,9,8
20457,20457,20458,9,3,-6
20458,20458,20459,3,1,-2
20459,20459,20460,1,4,3
20460,20460,20461,4,1,-3
20461,20461,20462,1,9,8
20462,20462,20463,9,0,-9
20463,20463,20464,0,4,4
20464,20464,20465,4,1,-3
20465,20465,20466,1,7,6
20466,20466,20467,7,4,-3
20467,20467,20468,4,4,0
20468,20468,20469,4,6,2
20469,20469,20470,6,3,-3
20470,20470,20471,3,0,-3
20471,20471,20472,0,8,8
20472,20472,20473,8,2,-6
20473,20473,20474,2,1,-1
20474,20474,20475,1,1,0
20475,20475,20476,1,5,4
20476,20476,20477,5,7,2
20477,20477,20478,7,0,-7
20478,20478,20479,0,5,5
20479,20479,20480,5,6,1
20480,20480,20481,6,0,-6
20481,20481,20482,0,0,0
20482,20482,20483,0,0,0
20483,20483,20484,0,4,4
20484,20484,20485,4,2,-2
20485,20485,20486,2,6,4
20486,20486,20487,6,0,-6
20487,20487,20488,0,2,2
20488,20488,20489,2,6,4
20489,20489,20490,6,4,-2
20490,20490,20491,4,8,4
20491,20491,20492,8,3,-5
20492,20492,20493,3,2,-1
20493,20493,20494,2,6,4
20494,20494,20495,6,9,3
20495,20495,20496,9,4,-5
20496,20496,20497,4,2,-2
20497,20497,20498,2,7,5
20498,20498,20499,7,3,-4
20499,20499,20500,3,3,0
20500,20500,20501,3,7,4
20501,20501,20502,7,2,-5
20502,20502,20503,2,6,4
20503,20503,20504,6,7,1
20504,20504,20505,7,9,2
20505,20505,20506,9,1,-8
20506,20506,20507,1,8,7
20507,20507,20508,8,9,1
20508,20508,20509,9,7,-2
20509,20509,20510,7,0,-7
20510,20510,20511,0,8,8
20511,20511,20512,8,6,-2
20512,20512,20513,6,9,3
20513,20513,20514,9,2,-7
20514,20514,20515,2,2,0
20515,20515,20516,2,8,6
20516,20516,20517,8,2,-6
20517,20517,20518,2,9,7
20518,20518,20519,9,9,0
20519,20519,20520,9,2,-7
20520,20520,20521,2,8,6
20521,20521,20522,8,2,-6
20522,20522,20523,2,6,4
20523,20523,20524,6,8,2
20524,20524,20525,8,4,-4
20525,20525,20526,4,2,-2
20526,20526,20527,2,4,2
20527,20527,20528,4,5,1
20528,20528,20529,5,4,-1
20529,20529,20530,4,5,1
20530,20530,20531,5,0,-5
20531,20531,20532,0,7,7
20532,20532,20533,7,0,-7
20533,20533,20534,0,5,5
20534,20534,20535,5,8,3
20535,20535,20536,8,1,-7
20536,20536,20537,1,0,-1
20537,20537,20538,0,3,3
20538,20538,20539,3,8,5
20539,20539,20540,8,3,-5
20540,20540,20541,3,6,3
20541,20541,20542,6,2,-4
20542,20542,20543,2,6,4
20543,20543,20544,6,3,-3
20544,20544,20545,3,8,5
20545,20545,20546,8,9,1
20546,20546,20547,9,5,-4
20547,20547,20548,5,0,-5
20548,20548,20549,0,7,7
20549,20549,20550,7,2,-5
20550,20550,20551,2,0,-2
20551,20551,20552,0,7,7
20552,20552,20553,7,3,-4
20553,20553,20554,3,9,6
20554,20554,20555,9,6,-3
20555,20555,20556,6,1,-5
20556,20556,20557,1,7,6
20557,20557,20558,7,7,0
20558,20558,20559,7,8,1
20559,20559,20560,8,8,0
20560,20560,20561,8,3,-5
20561,20561,20562,3,9,6
20562,20562,20563,9,1,-8
20563,20563,20564,1,5,4
20564,20564,20565,5,3,-2
20565,20565,20566,3,7,4
20566,20566,20567,7,9,2
20567,20567,20568,9,2,-7
20568,20568,20569,2,5,3
20569,20569,20570,5,3,-2
20570,20570,20571,3,9,6
20571,20571,20572,9,6,-3
20572,20572,20573,6,9,3
20573,20573,20574,9,4,-5
20574,20574,20575,4,5,1
20575,20575,20576,5,7,2
20576,20576,20577,7,0,-7
20577,20577,20578,0,8,8
20578,20578,20579,8,7,-1
20579,20579,20580,7,8,1
20580,20580,20581,8,2,-6
20581,20581,20582,2,7,5
20582,20582,20583,7,7,0
20583,20583,20584,7,0,-7
20584,20584,20585,0,4,4
20585,20585,20586,4,5,1
20586,20586,20587,5,3,-2
20587,20587,20588,3,7,4
20588,20588,20589,7,1,-6
20589,20589,20590,1,5,4
20590,20590,20591,5,0,-5
20591,20591,20592,0,8,8
20592,20592,20593,8,1,-7
20593,20593,20594,1,9,8
20594,20594,20595,9,2,-7
20595,20595,20596,2,6,4
20596,20596,20597,6,3,-3
20597,20597,20598,3,5,2
20598,20598,20599,5,4,-1
20599,20599,20600,4,7,3
20600,20600,20601,7,5,-2
20601,20601,20602,5,0,-5
20602,20602,20603,0,6,6
20603,20603,20604,6,1,-5
20604,20604,20605,1,7,6
20605,20605,20606,7,3,-4
20606,20606,20607,3,8,5
20607,20607,20608,8,0,-8
20608,20608,20609,0,0,0
20609,20609,20610,0,3,3
20610,20610,20611,3,1,-2
20611,20611,20612,1,2,1
20612,20612,20613,2,2,0
20613,20613,20614,2,8,6
20614,20614,20615,8,3,-5
20615,20615,20616,3,3,0
20616,20616,20617,3,4,1
20617,20617,20618,4,8,4
20618,20618,20619,8,7,-1
20619,20619,20620,7,4,-3
20620,20620,20621,4,8,4
20621,20621,20622,8,0,-8
20622,20622,20623,0,9,9
20623,20623,20624,9,2,-7
20624,20624,20625,2,0,-2
20625,20625,20626,0,3,3
20626,20626,20627,3,1,-2
20627,20627,20628,1,5,4
20628,20628,20629,5,2,-3
20629,20629,20630,2,8,6
20630,20630,20631,8,3,-5
20631,20631,20632,3,0,-3
20632,20632,20633,0,4,4
20633,20633,20634,4,4,0
20634,20634,20635,4,5,1
20635,20635,20636,5,9,4
20636,20636,20637,9,6,-3
20637,20637,20638,6,9,3
20638,20638,20639,9,8,-1
20639,20639,20640,8,8,0
20640,20640,20641,8,9,1
20641,20641,20642,9,0,-9
20642,20642,20643,0,1,1
20643,20643,20644,1,9,8
20644,20644,20645,9,0,-9
20645,20645,20646,0,7,7
20646,20646,20647,7,6,-1
20647,20647,20648,6,8,2
20648,20648,20649,8,3,-5
20649,20649,20650,3,4,1
20650,20650,20651,4,4,0
20651,20651,20652,4,4,0
20652,20652,20653,4,4,0
20653,20653,20654,4,1,-3
20654,20654,20655,1,2,1
20655,20655,20656,2,6,4
20656,20656,20657,6,8,2
20657,20657,20658,8,0,-8
20658,20658,20659,0,1,1
20659,20659,20660,1,8,7
20660,20660,20661,8,0,-8
20661,20661,20662,0,0,0
20662,20662,20663,0,6,6
20663,20663,20664,6,3,-3
20664,20664,20665,3,4,1
20665,20665,20666,4,8,4
20666,20666,20667,8,9,1
20667,20667,20668,9,5,-4
20668,20668,20669,5,7,2
20669,20669,20670,7,3,-4
20670,20670,20671,3,2,-1
20671,20671,20672,2,1,-1
20672,20672,20673,1,3,2
20673,20673,20674,3,1,-2
20674,20674,20675,1,3,2
20675,20675,20676,3,9,6
20676,20676,20677,9,9,0
20677,20677,20678,9,1,-8
20678,20678,20679,1,2,1
20679,20679,20680,2,4,2
20680,20680,20681,4,0,-4
20681,20681,20682,0,6,6
20682,20682,20683,6,9,3
20683,20683,20684,9,9,0
20684,20684,20685,9,3,-6
20685,20685,20686,3,1,-2
20686,20686,20687,1,3,2
20687,20687,20688,3,0,-3
20688,20688,20689,0,9,9
20689,20689,20690,9,8,-1
20690,20690,20691,8,1,-7
20691,20691,20692,1,9,8
20692,20692,20693,9,5,-4
20693,20693,20694,5,7,2
20694,20694,20695,7,2,-5
20695,20695,20696,2,4,2
20696,20696,20697,4,3,-1
20697,20697,20698,3,9,6
20698,20698,20699,9,1,-8
20699,20699,20700,1,9,8
20700,20700,20701,9,6,-3
20701,20701,20702,6,4,-2
20702,20702,20703,4,7,3
20703,20703,20704,7,6,-1
20704,20704,20705,6,3,-3
20705,20705,20706,3,1,-2
20706,20706,20707,1,7,6
20707,20707,20708,7,3,-4
20708,20708,20709,3,8,5
20709,20709,20710,8,2,-6
20710,20710,20711,2,4,2
20711,20711,20712,4,8,4
20712,20712,20713,8,0,-8
20713,20713,20714,0,4,4
20714,20714,20715,4,2,-2
20715,20715,20716,2,5,3
20716,20716,20717,5,4,-1
20717,20717,20718,4,5,1
20718,20718,20719,5,0,-5
20719,20719,20720,0,7,7
20720,20720,20721,7,2,-5
20721,20721,20722,2,8,6
20722,20722,20723,8,7,-1
20723,20723,20724,7,0,-7
20724,20724,20725,0,8,8
20725,20725,20726,8,4,-4
20726,20726,20727,4,0,-4
20727,20727,20728,0,3,3
20728,20728,20729,3,7,4
20729,20729,20730,7,4,-3
20730,20730,20731,4,0,-4
20731,20731,20732,0,8,8
20732,20732,20733,8,6,-2
20733,20733,20734,6,9,3
20734,20734,20735,9,9,0
20735,20735,20736,9,6,-3
20736,20736,20737,6,3,-3
20737,20737,20738,3,3,0
20738,20738,20739,3,2,-1
20739,20739,20740,2,7,5
20740,20740,20741,7,4,-3
20741,20741,20742,4,2,-2
20742,20742,20743,2,8,6
20743,20743,20744,8,6,-2
20744,20744,20745,6,6,0
20745,20745,20746,6,1,-5
20746,20746,20747,1,0,-1
20747,20747,20748,0,2,2
20748,20748,20749,2,1,-1
20749,20749,20750,1,9,8
20750,20750,20751,9,0,-9
20751,20751,20752,0,3,3
20752,20752,20753,3,8,5
20753,20753,20754,8,5,-3
20754,20754,20755,5,1,-4
20755,20755,20756,1,3,2
20756,20756,20757,3,6,3
20757,20757,20758,6,8,2
20758,20758,20759,8,7,-1
20759,20759,20760,7,1,-6
20760,20760,20761,1,2,1
20761,20761,20762,2,0,-2
20762,20762,20763,0,9,9
20763,20763,20764,9,6,-3
20764,20764,20765,6,7,1
20765,20765,20766,7,7,0
20766,20766,20767,7,9,2
20767,20767,20768,9,4,-5
20768,20768,20769,4,5,1
20769,20769,20770,5,2,-3
20770,20770,20771,2,8,6
20771,20771,20772,8,1,-7
20772,20772,20773,1,9,8
20773,20773,20774,9,8,-1
20774,20774,20775,8,6,-2
20775,20775,20776,6,4,-2
20776,20776,20777,4,5,1
20777,20777,20778,5,9,4
20778,20778,20779,9,2,-7
20779,20779,20780,2,3,1
20780,20780,20781,3,6,3
20781,20781,20782,6,6,0
20782,20782,20783,6,2,-4
20783,20783,20784,2,5,3
20784,20784,20785,5,8,3
20785,20785,20786,8,2,-6
20786,20786,20787,2,1,-1
20787,20787,20788,1,9,8
20788,20788,20789,9,7,-2
20789,20789,20790,7,3,-4
20790,20790,20791,3,5,2
20791,20791,20792,5,9,4
20792,20792,20793,9,5,-4
20793,20793,20794,5,4,-1
20794,20794,20795,4,7,3
20795,20795,20796,7,6,-1
20796,20796,20797,6,3,-3
20797,20797,20798,3,1,-2
20798,20798,20799,1,5,4
20799,20799,20800,5,3,-2
20800,20800,20801,3,0,-3
20801,20801,20802,0,1,1
20802,20802,20803,1,1,0
20803,20803,20804,1,5,4
20804,20804,20805,5,3,-2
20805,20805,20806,3,6,3
20806,20806,20807,6,8,2
20807,20807,20808,8,6,-2
20808,20808,20809,6,4,-2
20809,20809,20810,4,1,-3
20810,20810,20811,1,9,8
20811,20811,20812,9,8,-1
20812,20812,20813,8,4,-4
20813,20813,20814,4,0,-4
20814,20814,20815,0,5,5
20815,20815,20816,5,0,-5
20816,20816,20817,0,1,1
20817,20817,20818,1,9,8
20818,20818,20819,9,8,-1
20819,20819,20820,8,9,1
20820,20820,20821,9,6,-3
20821,20821,20822,6,6,0
20822,20822,20823,6,8,2
20823,20823,20824,8,1,-7
20824,20824,20825,1,9,8
20825,20825,20826,9,9,0
20826,20826,20827,9,0,-9
20827,20827,20828,0,1,1
20828,20828,20829,1,1,0
20829,20829,20830,1,9,8
20830,20830,20831,9,2,-7
20831,20831,20832,2,2,0
20832,20832,20833,2,3,1
20833,20833,20834,3,7,4
20834,20834,20835,7,4,-3
20835,20835,20836,4,4,0
20836,20836,20837,4,5,1
20837,20837,20838,5,1,-4
20838,20838,20839,1,6,5
20839,20839,20840,6,0,-6
20840,20840,20841,0,9,9
20841,20841,20842,9,3,-6
20842,20842,20843,3,0,-3
20843,20843,20844,0,3,3
20844,20844,20845,3,1,-2
20845,20845,20846,1,0,-1
20846,20846,20847,0,2,2
20847,20847,20848,2,1,-1
20848,20848,20849,1,3,2
20849,20849,20850,3,2,-1
20850,20850,20851,2,4,2
20851,20851,20852,4,1,-3
20852,20852,20853,1,5,4
20853,20853,20854,5,5,0
20854,20854,20855,5,6,1
20855,20855,20856,6,7,1
20856,20856,20857,7,7,0
20857,20857,20858,7,8,1
20858,20858,20859,8,8,0
20859,20859,20860,8,5,-3
20860,20860,20861,5,9,4
20861,20861,20862,9,2,-7
20862,20862,20863,2,0,-2
20863,20863,20864,0,9,9
20864,20864,20865,9,1,-8
20865,20865,20866,1,7,6
20866,20866,20867,7,2,-5
20867,20867,20868,2,3,1
20868,20868,20869,3,3,0
20869,20869,20870,3,1,-2
20870,20870,20871,1,9,8
20871,20871,20872,9,3,-6
20872,20872,20873,3,8,5
20873,20873,20874,8,2,-6
20874,20874,20875,2,1,-1
20875,20875,20876,1,8,7
20876,20876,20877,8,0,-8
20877,20877,20878,0,5,5
20878,20878,20879,5,9,4
20879,20879,20880,9,8,-1
20880,20880,20881,8,5,-3
20881,20881,20882,5,2,-3
20882,20882,20883,2,7,5
20883,20883,20884,7,1,-6
20884,20884,20885,1,5,4
20885,20885,20886,5,0,-5
20886,20886,20887,0,1,1
20887,20887,20888,1,1,0
20888,20888,20889,1,8,7
20889,20889,20890,8,5,-3
20890,20890,20891,5,6,1
20891,20891,20892,6,6,0
20892,20892,20893,6,9,3
20893,20893,20894,9,4,-5
20894,20894,20895,4,0,-4
20895,20895,20896,0,6,6
20896,20896,20897,6,4,-2
20897,20897,20898,4,1,-3
20898,20898,20899,1,1,0
20899,20899,20900,1,9,8
20900,20900,20901,9,9,0
20901,20901,20902,9,3,-6
20902,20902,20903,3,3,0
20903,20903,20904,3,8,5
20904,20904,20905,8,8,0
20905,20905,20906,8,8,0
20906,20906,20907,8,4,-4
20907,20907,20908,4,4,0
20908,20908,20909,4,7,3
20909,20909,20910,7,2,-5
20910,20910,20911,2,0,-2
20911,20911,20912,0,1,1
20912,20912,20913,1,1,0
20913,20913,20914,1,5,4
20914,20914,20915,5,9,4
20915,20915,20916,9,6,-3
20916,20916,20917,6,2,-4
20917,20917,20918,2,9,7
20918,20918,20919,9,8,-1
20919,20919,20920,8,9,1
20920,20920,20921,9,7,-2
20921,20921,20922,7,5,-2
20922,20922,20923,5,8,3
20923,20923,20924,8,4,-4
20924,20924,20925,4,9,5
20925,20925,20926,9,3,-6
20926,20926,20927,3,6,3
20927,20927,20928,6,0,-6
20928,20928,20929,0,0,0
20929,20929,20930,0,2,2
20930,20930,20931,2,6,4
20931,20931,20932,6,4,-2
20932,20932,20933,4,5,1
20933,20933,20934,5,0,-5
20934,20934,20935,0,5,5
20935,20935,20936,5,0,-5
20936,20936,20937,0,3,3
20937,20937,20938,3,8,5
20938,20938,20939,8,3,-5
20939,20939,20940,3,6,3
20940,20940,20941,6,3,-3
20941,20941,20942,3,3,0
20942,20942,20943,3,9,6
20943,20943,20944,9,2,-7
20944,20944,20945,2,8,6
20945,20945,20946,8,3,-5
20946,20946,20947,3,0,-3
20947,20947,20948,0,6,6
20948,20948,20949,6,6,0
20949,20949,20950,6,4,-2
20950,20950,20951,4,1,-3
20951,20951,20952,1,3,2
20952,20952,20953,3,0,-3
20953,20953,20954,0,8,8
20954,20954,20955,8,0,-8
20955,20955,20956,0,4,4
20956,20956,20957,4,6,2
20957,20957,20958,6,0,-6
20958,20958,20959,0,2,2
20959,20959,20960,2,2,0
20960,20960,20961,2,1,-1
20961,20961,20962,1,4,3
20962,20962,20963,4,1,-3
20963,20963,20964,1,9,8
20964,20964,20965,9,3,-6
20965,20965,20966,3,8,5
20966,20966,20967,8,2,-6
20967,20967,20968,2,8,6
20968,20968,20969,8,7,-1
20969,20969,20970,7,2,-5
20970,20970,20971,2,7,5
20971,20971,20972,7,4,-3
20972,20972,20973,4,8,4
20973,20973,20974,8,1,-7
20974,20974,20975,1,8,7
20975,20975,20976,8,5,-3
20976,20976,20977,5,7,2
20977,20977,20978,7,6,-1
20978,20978,20979,6,0,-6
20979,20979,20980,0,7,7
20980,20980,20981,7,2,-5
20981,20981,20982,2,9,7
20982,20982,20983,9,0,-9
20983,20983,20984,0,6,6
20984,20984,20985,6,3,-3
20985,20985,20986,3,8,5
20986,20986,20987,8,1,-7
20987,20987,20988,1,1,0
20988,20988,20989,1,3,2
20989,20989,20990,3,1,-2
20990,20990,20991,1,7,6
20991,20991,20992,7,2,-5
20992,20992,20993,2,2,0
20993,20993,20994,2,5,3
20994,20994,20995,5,4,-1
20995,20995,20996,4,7,3
20996,20996,20997,7,9,2
20997,20997,20998,9,6,-3
20998,20998,20999,6,4,-2
20999,20999,21000,4,7,3
21000,21000,21001,7,3,-4
21001,21001,21002,3,1,-2
21002,21002,21003,1,6,5
21003,21003,21004,6,6,0
21004,21004,21005,6,5,-1
21005,21005,21006,5,2,-3
21006,21006,21007,2,3,1
21007,21007,21008,3,6,3
21008,21008,21009,6,2,-4
21009,21009,21010,2,1,-1
21010,21010,21011,1,5,4
21011,21011,21012,5,2,-3
21012,21012,21013,2,5,3
21013,21013,21014,5,2,-3
21014,21014,21015,2,9,7
21015,21015,21016,9,5,-4
21016,21016,21017,5,4,-1
21017,21017,21018,4,3,-1
21018,21018,21019,3,1,-2
21019,21019,21020,1,9,8
21020,21020,21021,9,7,-2
21021,21021,21022,7,4,-3
21022,21022,21023,4,2,-2
21023,21023,21024,2,2,0
21024,21024,21025,2,6,4
21025,21025,21026,6,3,-3
21026,21026,21027,3,5,2
21027,21027,21028,5,0,-5
21028,21028,21029,0,0,0
21029,21029,21030,0,6,6
21030,21030,21031,6,1,-5
21031,21031,21032,1,9,8
21032,21032,21033,9,2,-7
21033,21033,21034,2,5,3
21034,21034,21035,5,3,-2
21035,21035,21036,3,6,3
21036,21036,21037,6,4,-2
21037,21037,21038,4,3,-1
21038,21038,21039,3,5,2
21039,21039,21040,5,9,4
21040,21040,21041,9,6,-3
21041,21041,21042,6,2,-4
21042,21042,21043,2,7,5
21043,21043,21044,7,2,-5
21044,21044,21045,2,8,6
21045,21045,21046,8,8,0
21046,21046,21047,8,9,1
21047,21047,21048,9,8,-1
21048,21048,21049,8,0,-8
21049,21049,21050,0,7,7
21050,21050,21051,7,1,-6
21051,21051,21052,1,1,0
21052,21052,21053,1,2,1
21053,21053,21054,2,1,-1
21054,21054,21055,1,3,2
21055,21055,21056,3,3,0
21056,21056,21057,3,4,1
21057,21057,21058,4,5,1
21058,21058,21059,5,5,0
21059,21059,21060,5,1,-4
21060,21060,21061,1,6,5
21061,21061,21062,6,7,1
21062,21062,21063,7,7,0
21063,21063,21064,7,0,-7
21064,21064,21065,0,8,8
21065,21065,21066,8,0,-8
21066,21066,21067,0,9,9
21067,21067,21068,9,1,-8
21068,21068,21069,1,0,-1
21069,21069,21070,0,1,1
21070,21070,21071,1,1,0
21071,21071,21072,1,9,8
21072,21072,21073,9,2,-7
21073,21073,21074,2,6,4
21074,21074,21075,6,3,-3
21075,21075,21076,3,4,1
21076,21076,21077,4,4,0
21077,21077,21078,4,0,-4
21078,21078,21079,0,5,5
21079,21079,21080,5,3,-2
21080,21080,21081,3,6,3
21081,21081,21082,6,0,-6
21082,21082,21083,0,7,7
21083,21083,21084,7,6,-1
21084,21084,21085,6,8,2
21085,21085,21086,8,7,-1
21086,21086,21087,7,9,2
21087,21087,21088,9,1,-8
21088,21088,21089,1,8,7
21089,21089,21090,8,1,-7
21090,21090,21091,1,9,8
21091,21091,21092,9,3,-6
21092,21092,21093,3,5,2
21093,21093,21094,5,1,-4
21094,21094,21095,1,7,6
21095,21095,21096,7,4,-3
21096,21096,21097,4,0,-4
21097,21097,21098,0,3,3
21098,21098,21099,3,3,0
21099,21099,21100,3,6,3
21100,21100,21101,6,1,-5
21101,21101,21102,1,3,2
21102,21102,21103,3,6,3
21103,21103,21104,6,8,2
21104,21104,21105,8,8,0
21105,21105,21106,8,8,0
21106,21106,21107,8,4,-4
21107,21107,21108,4,9,5
21108,21108,21109,9,1,-8
21109,21109,21110,1,8,7
21110,21110,21111,8,7,-1
21111,21111,21112,7,3,-4
21112,21112,21113,3,6,3
21113,21113,21114,6,5,-1
21114,21114,21115,5,5,0
21115,21115,21116,5,3,-2
21116,21116,21117,3,6,3
21117,21117,21118,6,8,2
21118,21118,21119,8,4,-4
21119,21119,21120,4,8,4
21120,21120,21121,8,2,-6
21121,21121,21122,2,6,4
21122,21122,21123,6,7,1
21123,21123,21124,7,5,-2
21124,21124,21125,5,8,3
21125,21125,21126,8,6,-2
21126,21126,21127,6,1,-5
21127,21127,21128,1,6,5
21128,21128,21129,6,3,-3
21129,21129,21130,3,4,1
21130,21130,21131,4,4,0
21131,21131,21132,4,0,-4
21132,21132,21133,0,7,7
21133,21133,21134,7,4,-3
21134,21134,21135,4,2,-2
21135,21135,21136,2,2,0
21136,21136,21137,2,0,-2
21137,21137,21138,0,9,9
21138,21138,21139,9,5,-4
21139,21139,21140,5,4,-1
21140,21140,21141,4,0,-4
21141,21141,21142,0,0,0
21142,21142,21143,0,1,1
21143,21143,21144,1,3,2
21144,21144,21145,3,9,6
21145,21145,21146,9,8,-1
21146,21146,21147,8,2,-6
21147,21147,21148,2,7,5
21148,21148,21149,7,3,-4
21149,21149,21150,3,3,0
21150,21150,21151,3,2,-1
21151,21151,21152,2,4,2
21152,21152,21153,4,3,-1
21153,21153,21154,3,3,0
21154,21154,21155,3,5,2
21155,21155,21156,5,3,-2
21156,21156,21157,3,5,2
21157,21157,21158,5,9,4
21158,21158,21159,9,7,-2
21159,21159,21160,7,7,0
21160,21160,21161,7,8,1
21161,21161,21162,8,9,1
21162,21162,21163,9,4,-5
21163,21163,21164,4,2,-2
21164,21164,21165,2,9,7
21165,21165,21166,9,1,-8
21166,21166,21167,1,9,8
21167,21167,21168,9,1,-8
21168,21168,21169,1,7,6
21169,21169,21170,7,3,-4
21170,21170,21171,3,1,-2
21171,21171,21172,1,9,8
21172,21172,21173,9,1,-8
21173,21173,21174,1,2,1
21174,21174,21175,2,7,5
21175,21175,21176,7,3,-4
21176,21176,21177,3,8,5
21177,21177,21178,8,1,-7
21178,21178,21179,1,3,2
21179,21179,21180,3,6,3
21180,21180,21181,6,4,-2
21181,21181,21182,4,3,-1
21182,21182,21183,3,8,5
21183,21183,21184,8,5,-3
21184,21184,21185,5,6,1
21185,21185,21186,6,4,-2
21186,21186,21187,4,3,-1
21187,21187,21188,3,8,5
21188,21188,21189,8,8,0
21189,21189,21190,8,8,0
21190,21190,21191,8,0,-8
21191,21191,21192,0,9,9
21192,21192,21193,9,9,0
21193,21193,21194,9,2,-7
21194,21194,21195,2,6,4
21195,21195,21196,6,1,-5
21196,21196,21197,1,2,1
21197,21197,21198,2,5,3
21198,21198,21199,5,0,-5
21199,21199,21200,0,1,1
21200,21200,21201,1,1,0
21201,21201,21202,1,1,0
21202,21202,21203,1,0,-1
21203,21203,21204,0,5,5
21204,21204,21205,5,6,1
21205,21205,21206,6,5,-1
21206,21206,21207,5,2,-3
21207,21207,21208,2,3,1
21208,21208,21209,3,3,0
21209,21209,21210,3,5,2
21210,21210,21211,5,8,3
21211,21211,21212,8,8,0
21212,21212,21213,8,9,1
21213,21213,21214,9,6,-3
21214,21214,21215,6,0,-6
21215,21215,21216,0,0,0
21216,21216,21217,0,7,7
21217,21217,21218,7,9,2
21218,21218,21219,9,2,-7
21219,21219,21220,2,1,-1
21220,21220,21221,1,3,2
21221,21221,21222,3,7,4
21222,21222,21223,7,4,-3
21223,21223,21224,4,9,5
21224,21224,21225,9,5,-4
21225,21225,21226,5,6,1
21226,21226,21227,6,5,-1
21227,21227,21228,5,3,-2
21228,21228,21229,3,2,-1
21229,21229,21230,2,1,-1
21230,21230,21231,1,8,7
21231,21231,21232,8,4,-4
21232,21232,21233,4,5,1
21233,21233,21234,5,6,1
21234,21234,21235,6,4,-2
21235,21235,21236,4,7,3
21236,21236,21237,7,6,-1
21237,21237,21238,6,3,-3
21238,21238,21239,3,6,3
21239,21239,21240,6,7,1
21240,21240,21241,7,6,-1
21241,21241,21242,6,0,-6
21242,21242,21243,0,7,7
21243,21243,21244,7,5,-2
21244,21244,21245,5,9,4
21245,21245,21246,9,4,-5
21246,21246,21247,4,1,-3
21247,21247,21248,1,1,0
21248,21248,21249,1,8,7
21249,21249,21250,8,3,-5
21250,21250,21251,3,2,-1
21251,21251,21252,2,5,3
21252,21252,21253,5,1,-4
21253,21253,21254,1,2,1
21254,21254,21255,2,2,0
21255,21255,21256,2,0,-2
21256,21256,21257,0,6,6
21257,21257,21258,6,7,1
21258,21258,21259,7,5,-2
21259,21259,21260,5,0,-5
21260,21260,21261,0,3,3
21261,21261,21262,3,4,1
21262,21262,21263,4,4,0
21263,21263,21264,4,5,1
21264,21264,21265,5,7,2
21265,21265,21266,7,0,-7
21266,21266,21267,0,9,9
21267,21267,21268,9,6,-3
21268,21268,21269,6,4,-2
21269,21269,21270,4,4,0
21270,21270,21271,4,0,-4
21271,21271,21272,0,1,1
21272,21272,21273,1,0,-1
21273,21273,21274,0,2,2
21274,21274,21275,2,5,3
21275,21275,21276,5,5,0
21276,21276,21277,5,9,4
21277,21277,21278,9,3,-6
21278,21278,21279,3,0,-3
21279,21279,21280,0,8,8
21280,21280,21281,8,1,-7
21281,21281,21282,1,8,7
21282,21282,21283,8,2,-6
21283,21283,21284,2,3,1
21284,21284,21285,3,3,0
21285,21285,21286,3,8,5
21286,21286,21287,8,4,-4
21287,21287,21288,4,1,-3
21288,21288,21289,1,5,4
21289,21289,21290,5,6,1
21290,21290,21291,6,6,0
21291,21291,21292,6,1,-5
21292,21292,21293,1,7,6
21293,21293,21294,7,6,-1
21294,21294,21295,6,8,2
21295,21295,21296,8,4,-4
21296,21296,21297,4,9,5
21297,21297,21298,9,6,-3
21298,21298,21299,6,0,-6
21299,21299,21300,0,9,9
21300,21300,21301,9,1,-8
21301,21301,21302,1,9,8
21302,21302,21303,9,2,-7
21303,21303,21304,2,4,2
21304,21304,21305,4,3,-1
21305,21305,21306,3,3,0
21306,21306,21307,3,4,1
21307,21307,21308,4,0,-4
21308,21308,21309,0,5,5
21309,21309,21310,5,8,3
21310,21310,21311,8,6,-2
21311,21311,21312,6,8,2
21312,21312,21313,8,7,-1
21313,21313,21314,7,0,-7
21314,21314,21315,0,8,8
21315,21315,21316,8,6,-2
21316,21316,21317,6,9,3
21317,21317,21318,9,7,-2
21318,21318,21319,7,0,-7
21319,21319,21320,0,3,3
21320,21320,21321,3,1,-2
21321,21321,21322,1,7,6
21322,21322,21323,7,2,-5
21323,21323,21324,2,2,0
21324,21324,21325,2,3,1
21325,21325,21326,3,4,1
21326,21326,21327,4,4,0
21327,21327,21328,4,3,-1
21328,21328,21329,3,5,2
21329,21329,21330,5,2,-3
21330,21330,21331,2,6,4
21331,21331,21332,6,6,0
21332,21332,21333,6,7,1
21333,21333,21334,7,1,-6
21334,21334,21335,1,7,6
21335,21335,21336,7,9,2
21336,21336,21337,9,6,-3
21337,21337,21338,6,5,-1
21338,21338,21339,5,4,-1
21339,21339,21340,4,4,0
21340,21340,21341,4,3,-1
21341,21341,21342,3,1,-2
21342,21342,21343,1,0,-1
21343,21343,21344,0,9,9
21344,21344,21345,9,6,-3
21345,21345,21346,6,5,-1
21346,21346,21347,5,6,1
21347,21347,21348,6,6,0
21348,21348,21349,6,6,0
21349,21349,21350,6,0,-6
21350,21350,21351,0,9,9
21351,21351,21352,9,7,-2
21352,21352,21353,7,0,-7
21353,21353,21354,0,0,0
21354,21354,21355,0,0,0
21355,21355,21356,0,9,9
21356,21356,21357,9,1,-8
21357,21357,21358,1,0,-1
21358,21358,21359,0,3,3
21359,21359,21360,3,5,2
21360,21360,21361,5,9,4
21361,21361,21362,9,1,-8
21362,21362,21363,1,4,3
21363,21363,21364,4,1,-3
21364,21364,21365,1,5,4
21365,21365,21366,5,2,-3
21366,21366,21367,2,7,5
21367,21367,21368,7,6,-1
21368,21368,21369,6,9,3
21369,21369,21370,9,3,-6
21370,21370,21371,3,5,2
21371,21371,21372,5,0,-5
21372,21372,21373,0,6,6
21373,21373,21374,6,4,-2
21374,21374,21375,4,8,4
21375,21375,21376,8,1,-7
21376,21376,21377,1,9,8
21377,21377,21378,9,9,0
21378,21378,21379,9,1,-8
21379,21379,21380,1,0,-1
21380,21380,21381,0,3,3
21381,21381,21382,3,2,-1
21382,21382,21383,2,8,6
21383,21383,21384,8,8,0
21384,21384,21385,8,5,-3
21385,21385,21386,5,7,2
21386,21386,21387,7,7,0
21387,21387,21388,7,7,0
21388,21388,21389,7,8,1
21389,21389,21390,8,3,-5
21390,21390,21391,3,1,-2
21391,21391,21392,1,6,5
21392,21392,21393,6,4,-2
21393,21393,21394,4,1,-3
21394,21394,21395,1,8,7
21395,21395,21396,8,7,-1
21396,21396,21397,7,5,-2
21397,21397,21398,5,1,-4
21398,21398,21399,1,8,7
21399,21399,21400,8,7,-1
21400,21400,21401,7,1,-6
21401,21401,21402,1,1,0
21402,21402,21403,1,0,-1
21403,21403,21404,0,6,6
21404,21404,21405,6,7,1
21405,21405,21406,7,8,1
21406,21406,21407,8,6,-2
21407,21407,21408,6,8,2
21408,21408,21409,8,1,-7
21409,21409,21410,1,6,5
21410,21410,21411,6,6,0
21411,21411,21412,6,7,1
21412,21412,21413,7,0,-7
21413,21413,21414,0,2,2
21414,21414,21415,2,3,1
21415,21415,21416,3,5,2
21416,21416,21417,5,4,-1
21417,21417,21418,4,6,2
21418,21418,21419,6,6,0
21419,21419,21420,6,3,-3
21420,21420,21421,3,8,5
21421,21421,21422,8,9,1
21422,21422,21423,9,9,0
21423,21423,21424,9,1,-8
21424,21424,21425,1,2,1
21425,21425,21426,2,6,4
21426,21426,21427,6,1,-5
21427,21427,21428,1,3,2
21428,21428,21429,3,7,4
21429,21429,21430,7,4,-3
21430,21430,21431,4,4,0
21431,21431,21432,4,8,4
21432,21432,21433,8,5,-3
21433,21433,21434,5,6,1
21434,21434,21435,6,2,-4
21435,21435,21436,2,2,0
21436,21436,21437,2,7,5
21437,21437,21438,7,2,-5
21438,21438,21439,2,5,3
21439,21439,21440,5,5,0
21440,21440,21441,5,2,-3
21441,21441,21442,2,4,2
21442,21442,21443,4,2,-2
21443,21443,21444,2,2,0
21444,21444,21445,2,9,7
21445,21445,21446,9,1,-8
21446,21446,21447,1,3,2
21447,21447,21448,3,4,1
21448,21448,21449,4,9,5
21449,21449,21450,9,2,-7
21450,21450,21451,2,2,0
21451,21451,21452,2,6,4
21452,21452,21453,6,2,-4
21453,21453,21454,2,0,-2
21454,21454,21455,0,5,5
21455,21455,21456,5,7,2
21456,21456,21457,7,8,1
21457,21457,21458,8,3,-5
21458,21458,21459,3,7,4
21459,21459,21460,7,1,-6
21460,21460,21461,1,4,3
21461,21461,21462,4,7,3
21462,21462,21463,7,7,0
21463,21463,21464,7,7,0
21464,21464,21465,7,1,-6
21465,21465,21466,1,3,2
21466,21466,21467,3,8,5
21467,21467,21468,8,3,-5
21468,21468,21469,3,0,-3
21469,21469,21470,0,2,2
21470,21470,21471,2,9,7
21471,21471,21472,9,4,-5
21472,21472,21473,4,6,2
21473,21473,21474,6,1,-5
21474,21474,21475,1,8,7
21475,21475,21476,8,1,-7
21476,21476,21477,1,1,0
21477,21477,21478,1,7,6
21478,21478,21479,7,1,-6
21479,21479,21480,1,4,3
21480,21480,21481,4,5,1
21481,21481,21482,5,7,2
21482,21482,21483,7,7,0
21483,21483,21484,7,5,-2
21484,21484,21485,5,6,1
21485,21485,21486,6,8,2
21486,21486,21487,8,3,-5
21487,21487,21488,3,6,3
21488,21488,21489,6,5,-1
21489,21489,21490,5,4,-1
21490,21490,21491,4,4,0
21491,21491,21492,4,1,-3
21492,21492,21493,1,2,1
21493,21493,21494,2,8,6
21494,21494,21495,8,9,1
21495,21495,21496,9,3,-6
21496,21496,21497,3,0,-3
21497,21497,21498,0,1,1
21498,21498,21499,1,4,3
21499,21499,21500,4,4,0
21500,21500,21501,4,7,3
21501,21501,21502,7,2,-5
21502,21502,21503,2,4,2
21503,21503,21504,4,2,-2
21504,21504,21505,2,3,1
21505,21505,21506,3,0,-3
21506,21506,21507,0,2,2
21507,21507,21508,2,0,-2
21508,21508,21509,0,9,9
21509,21509,21510,9,9,0
21510,21510,21511,9,2,-7
21511,21511,21512,2,3,1
21512,21512,21513,3,0,-3
21513,21513,21514,0,7,7
21514,21514,21515,7,3,-4
21515,21515,21516,3,9,6
21516,21516,21517,9,4,-5
21517,21517,21518,4,7,3
21518,21518,21519,7,5,-2
21519,21519,21520,5,8,3
21520,21520,21521,8,0,-8
21521,21521,21522,0,2,2
21522,21522,21523,2,0,-2
21523,21523,21524,0,3,3
21524,21524,21525,3,3,0
21525,21525,21526,3,0,-3
21526,21526,21527,0,2,2
21527,21527,21528,2,2,0
21528,21528,21529,2,8,6
21529,21529,21530,8,5,-3
21530,21530,21531,5,3,-2
21531,21531,21532,3,5,2
21532,21532,21533,5,0,-5
21533,21533,21534,0,0,0
21534,21534,21535,0,1,1
21535,21535,21536,1,2,1
21536,21536,21537,2,2,0
21537,21537,21538,2,6,4
21538,21538,21539,6,3,-3
21539,21539,21540,3,9,6
21540,21540,21541,9,4,-5
21541,21541,21542,4,0,-4
21542,21542,21543,0,5,5
21543,21543,21544,5,2,-3
21544,21544,21545,2,6,4
21545,21545,21546,6,0,-6
21546,21546,21547,0,7,7
21547,21547,21548,7,5,-2
21548,21548,21549,5,8,3
21549,21549,21550,8,5,-3
21550,21550,21551,5,9,4
21551,21551,21552,9,1,-8
21552,21552,21553,1,0,-1
21553,21553,21554,0,1,1
21554,21554,21555,1,1,0
21555,21555,21556,1,8,7
21556,21556,21557,8,2,-6
21557,21557,21558,2,5,3
21558,21558,21559,5,3,-2
21559,21559,21560,3,0,-3
21560,21560,21561,0,4,4
21561,21561,21562,4,9,5
21562,21562,21563,9,5,-4
21563,21563,21564,5,6,1
21564,21564,21565,6,6,0
21565,21565,21566,6,2,-4
21566,21566,21567,2,7,5
21567,21567,21568,7,1,-6
21568,21568,21569,1,8,7
21569,21569,21570,8,3,-5
21570,21570,21571,3,9,6
21571,21571,21572,9,7,-2
21572,21572,21573,7,0,-7
21573,21573,21574,0,1,1
21574,21574,21575,1,1,0
21575,21575,21576,1,0,-1
21576,21576,21577,0,2,2
21577,21577,21578,2,8,6
21578,21578,21579,8,3,-5
21579,21579,21580,3,3,0
21580,21580,21581,3,4,1
21581,21581,21582,4,3,-1
21582,21582,21583,3,5,2
21583,21583,21584,5,3,-2
21584,21584,21585,3,6,3
21585,21585,21586,6,0,-6
21586,21586,21587,0,7,7
21587,21587,21588,7,5,-2
21588,21588,21589,5,8,3
21589,21589,21590,8,4,-4
21590,21590,21591,4,9,5
21591,21591,21592,9,9,0
21592,21592,21593,9,8,-1
21593,21593,21594,8,1,-7
21594,21594,21595,1,9,8
21595,21595,21596,9,3,-6
21596,21596,21597,3,2,-1
21597,21597,21598,2,2,0
21598,21598,21599,2,6,4
21599,21599,21600,6,0,-6
21600,21600,21601,0,1,1
21601,21601,21602,1,0,-1
21602,21602,21603,0,7,7
21603,21603,21604,7,5,-2
21604,21604,21605,5,6,1
21605,21605,21606,6,3,-3
21606,21606,21607,3,3,0
21607,21607,21608,3,0,-3
21608,21608,21609,0,5,5
21609,21609,21610,5,3,-2
21610,21610,21611,3,4,1
21611,21611,21612,4,0,-4
21612,21612,21613,0,8,8
21613,21613,21614,8,0,-8
21614,21614,21615,0,2,2
21615,21615,21616,2,9,7
21616,21616,21617,9,6,-3
21617,21617,21618,6,1,-5
21618,21618,21619,1,4,3
21619,21619,21620,4,0,-4
21620,21620,21621,0,7,7
21621,21621,21622,7,3,-4
21622,21622,21623,3,2,-1
21623,21623,21624,2,7,5
21624,21624,21625,7,3,-4
21625,21625,21626,3,5,2
21626,21626,21627,5,4,-1
21627,21627,21628,4,0,-4
21628,21628,21629,0,5,5
21629,21629,21630,5,2,-3
21630,21630,21631,2,9,7
21631,21631,21632,9,5,-4
21632,21632,21633,5,2,-3
21633,21633,21634,2,1,-1
21634,21634,21635,1,0,-1
21635,21635,21636,0,2,2
21636,21636,21637,2,3,1
21637,21637,21638,3,2,-1
21638,21638,21639,2,9,7
21639,21639,21640,9,0,-9
21640,21640,21641,0,7,7
21641,21641,21642,7,4,-3
21642,21642,21643,4,3,-1
21643,21643,21644,3,4,1
21644,21644,21645,4,9,5
21645,21645,21646,9,9,0
21646,21646,21647,9,3,-6
21647,21647,21648,3,4,1
21648,21648,21649,4,8,4
21649,21649,21650,8,8,0
21650,21650,21651,8,7,-1
21651,21651,21652,7,2,-5
21652,21652,21653,2,4,2
21653,21653,21654,4,3,-1
21654,21654,21655,3,4,1
21655,21655,21656,4,8,4
21656,21656,21657,8,9,1
21657,21657,21658,9,0,-9
21658,21658,21659,0,8,8
21659,21659,21660,8,3,-5
21660,21660,21661,3,5,2
21661,21661,21662,5,7,2
21662,21662,21663,7,8,1
21663,21663,21664,8,4,-4
21664,21664,21665,4,2,-2
21665,21665,21666,2,7,5
21666,21666,21667,7,6,-1
21667,21667,21668,6,2,-4
21668,21668,21669,2,9,7
21669,21669,21670,9,2,-7
21670,21670,21671,2,5,3
21671,21671,21672,5,7,2
21672,21672,21673,7,3,-4
21673,21673,21674,3,2,-1
21674,21674,21675,2,6,4
21675,21675,21676,6,6,0
21676,21676,21677,6,5,-1
21677,21677,21678,5,5,0
21678,21678,21679,5,7,2
21679,21679,21680,7,1,-6
21680,21680,21681,1,0,-1
21681,21681,21682,0,1,1
21682,21682,21683,1,2,1
21683,21683,21684,2,6,4
21684,21684,21685,6,3,-3
21685,21685,21686,3,9,6
21686,21686,21687,9,1,-8
21687,21687,21688,1,8,7
21688,21688,21689,8,3,-5
21689,21689,21690,3,3,0
21690,21690,21691,3,2,-1
21691,21691,21692,2,2,0
21692,21692,21693,2,7,5
21693,21693,21694,7,8,1
21694,21694,21695,8,3,-5
21695,21695,21696,3,6,3
21696,21696,21697,6,1,-5
21697,21697,21698,1,1,0
21698,21698,21699,1,1,0
21699,21699,21700,1,7,6
21700,21700,21701,7,7,0
21701,21701,21702,7,1,-6
21702,21702,21703,1,0,-1
21703,21703,21704,0,7,7
21704,21704,21705,7,8,1
21705,21705,21706,8,7,-1
21706,21706,21707,7,5,-2
21707,21707,21708,5,8,3
21708,21708,21709,8,1,-7
21709,21709,21710,1,7,6
21710,21710,21711,7,8,1
21711,21711,21712,8,6,-2
21712,21712,21713,6,2,-4
21713,21713,21714,2,3,1
21714,21714,21715,3,1,-2
21715,21715,21716,1,1,0
21716,21716,21717,1,3,2
21717,21717,21718,3,9,6
21718,21718,21719,9,7,-2
21719,21719,21720,7,3,-4
21720,21720,21721,3,0,-3
21721,21721,21722,0,2,2
21722,21722,21723,2,8,6
21723,21723,21724,8,9,1
21724,21724,21725,9,7,-2
21725,21725,21726,7,3,-4
21726,21726,21727,3,2,-1
21727,21727,21728,2,6,4
21728,21728,21729,6,4,-2
21729,21729,21730,4,8,4
21730,21730,21731,8,4,-4
21731,21731,21732,4,7,3
21732,21732,21733,7,8,1
21733,21733,21734,8,5,-3
21734,21734,21735,5,0,-5
21735,21735,21736,0,0,0
21736,21736,21737,0,1,1
21737,21737,21738,1,4,3
21738,21738,21739,4,5,1
21739,21739,21740,5,1,-4
21740,21740,21741,1,1,0
21741,21741,21742,1,2,1
21742,21742,21743,2,4,2
21743,21743,21744,4,1,-3
21744,21744,21745,1,6,5
21745,21745,21746,6,4,-2
21746,21746,21747,4,0,-4
21747,21747,21748,0,9,9
21748,21748,21749,9,5,-4
21749,21749,21750,5,2,-3
21750,21750,21751,2,1,-1
21751,21751,21752,1,6,5
21752,21752,21753,6,6,0
21753,21753,21754,6,5,-1
21754,21754,21755,5,6,1
21755,21755,21756,6,9,3
21756,21756,21757,9,9,0
21757,21757,21758,9,7,-2
21758,21758,21759,7,0,-7
21759,21759,21760,0,2,2
21760,21760,21761,2,7,5
21761,21761,21762,7,6,-1
21762,21762,21763,6,6,0
21763,21763,21764,6,6,0
21764,21764,21765,6,1,-5
21765,21765,21766,1,0,-1
21766,21766,21767,0,1,1
21767,21767,21768,1,0,-1
21768,21768,21769,0,0,0
21769,21769,21770,0,4,4
21770,21770,21771,4,1,-3
21771,21771,21772,1,6,5
21772,21772,21773,6,2,-4
21773,21773,21774,2,9,7
21774,21774,21775,9,3,-6
21775,21775,21776,3,4,1
21776,21776,21777,4,4,0
21777,21777,21778,4,8,4
21778,21778,21779,8,5,-3
21779,21779,21780,5,0,-5
21780,21780,21781,0,6,6
21781,21781,21782,6,5,-1
21782,21782,21783,5,7,2
21783,21783,21784,7,2,-5
21784,21784,21785,2,8,6
21785,21785,21786,8,9,1
21786,21786,21787,9,9,0
21787,21787,21788,9,2,-7
21788,21788,21789,2,0,-2
21789,21789,21790,0,7,7
21790,21790,21791,7,1,-6
21791,21791,21792,1,4,3
21792,21792,21793,4,2,-2
21793,21793,21794,2,1,-1
21794,21794,21795,1,3,2
21795,21795,21796,3,2,-1
21796,21796,21797,2,4,2
21797,21797,21798,4,2,-2
21798,21798,21799,2,5,3
21799,21799,21800,5,0,-5
21800,21800,21801,0,6,6
21801,21801,21802,6,2,-4
21802,21802,21803,2,7,5
21803,21803,21804,7,2,-5
21804,21804,21805,2,8,6
21805,21805,21806,8,5,-3
21806,21806,21807,5,9,4
21807,21807,21808,9,6,-3
21808,21808,21809,6,0,-6
21809,21809,21810,0,5,5
21810,21810,21811,5,1,-4
21811,21811,21812,1,3,2
21812,21812,21813,3,2,-1
21813,21813,21814,2,4,2
21814,21814,21815,4,3,-1
21815,21815,21816,3,7,4
21816,21816,21817,7,4,-3
21817,21817,21818,4,1,-3
21818,21818,21819,1,5,4
21819,21819,21820,5,5,0
21820,21820,21821,5,6,1
21821,21821,21822,6,4,-2
21822,21822,21823,4,7,3
21823,21823,21824,7,7,0
21824,21824,21825,7,8,1
21825,21825,21826,8,8,0
21826,21826,21827,8,9,1
21827,21827,21828,9,4,-5
21828,21828,21829,4,1,-3
21829,21829,21830,1,4,3
21830,21830,21831,4,3,-1
21831,21831,21832,3,6,3
21832,21832,21833,6,5,-1
21833,21833,21834,5,7,2
21834,21834,21835,7,9,2
21835,21835,21836,9,5,-4
21836,21836,21837,5,4,-1
21837,21837,21838,4,6,2
21838,21838,21839,6,1,-5
21839,21839,21840,1,9,8
21840,21840,21841,9,7,-2
21841,21841,21842,7,9,2
21842,21842,21843,9,7,-2
21843,21843,21844,7,6,-1
21844,21844,21845,6,2,-4
21845,21845,21846,2,4,2
21846,21846,21847,4,1,-3
21847,21847,21848,1,0,-1
21848,21848,21849,0,4,4
21849,21849,21850,4,5,1
21850,21850,21851,5,8,3
21851,21851,21852,8,2,-6
21852,21852,21853,2,3,1
21853,21853,21854,3,6,3
21854,21854,21855,6,8,2
21855,21855,21856,8,6,-2
21856,21856,21857,6,2,-4
21857,21857,21858,2,4,2
21858,21858,21859,4,9,5
21859,21859,21860,9,6,-3
21860,21860,21861,6,3,-3
21861,21861,21862,3,6,3
21862,21862,21863,6,8,2
21863,21863,21864,8,3,-5
21864,21864,21865,3,5,2
21865,21865,21866,5,3,-2
21866,21866,21867,3,4,1
21867,21867,21868,4,8,4
21868,21868,21869,8,9,1
21869,21869,21870,9,9,0
21870,21870,21871,9,7,-2
21871,21871,21872,7,9,2
21872,21872,21873,9,5,-4
21873,21873,21874,5,0,-5
21874,21874,21875,0,4,4
21875,21875,21876,4,9,5
21876,21876,21877,9,3,-6
21877,21877,21878,3,1,-2
21878,21878,21879,1,9,8
21879,21879,21880,9,2,-7
21880,21880,21881,2,2,0
21881,21881,21882,2,4,2
21882,21882,21883,4,5,1
21883,21883,21884,5,1,-4
21884,21884,21885,1,7,6
21885,21885,21886,7,4,-3
21886,21886,21887,4,4,0
21887,21887,21888,4,4,0
21888,21888,21889,4,1,-3
21889,21889,21890,1,0,-1
21890,21890,21891,0,2,2
21891,21891,21892,2,9,7
21892,21892,21893,9,3,-6
21893,21893,21894,3,7,4
21894,21894,21895,7,5,-2
21895,21895,21896,5,8,3
21896,21896,21897,8,9,1
21897,21897,21898,9,0,-9
21898,21898,21899,0,1,1
21899,21899,21900,1,6,5
21900,21900,21901,6,6,0
21901,21901,21902,6,5,-1
21902,21902,21903,5,0,-5
21903,21903,21904,0,7,7
21904,21904,21905,7,1,-6
21905,21905,21906,1,4,3
21906,21906,21907,4,0,-4
21907,21907,21908,0,1,1
21908,21908,21909,1,0,-1
21909,21909,21910,0,0,0
21910,21910,21911,0,2,2
21911,21911,21912,2,6,4
21912,21912,21913,6,8,2
21913,21913,21914,8,5,-3
21914,21914,21915,5,7,2
21915,21915,21916,7,4,-3
21916,21916,21917,4,2,-2
21917,21917,21918,2,6,4
21918,21918,21919,6,5,-1
21919,21919,21920,5,6,1
21920,21920,21921,6,1,-5
21921,21921,21922,1,4,3
21922,21922,21923,4,1,-3
21923,21923,21924,1,9,8
21924,21924,21925,9,8,-1
21925,21925,21926,8,8,0
21926,21926,21927,8,5,-3
21927,21927,21928,5,1,-4
21928,21928,21929,1,6,5
21929,21929,21930,6,3,-3
21930,21930,21931,3,4,1
21931,21931,21932,4,0,-4
21932,21932,21933,0,0,0
21933,21933,21934,0,6,6
21934,21934,21935,6,4,-2
21935,21935,21936,4,4,0
21936,21936,21937,4,7,3
21937,21937,21938,7,3,-4
21938,21938,21939,3,3,0
21939,21939,21940,3,4,1
21940,21940,21941,4,6,2
21941,21941,21942,6,1,-5
21942,21942,21943,1,8,7
21943,21943,21944,8,1,-7
21944,21944,21945,1,0,-1
21945,21945,21946,0,3,3
21946,21946,21947,3,3,0
21947,21947,21948,3,3,0
21948,21948,21949,3,7,4
21949,21949,21950,7,3,-4
21950,21950,21951,3,4,1
21951,21951,21952,4,2,-2
21952,21952,21953,2,0,-2
21953,21953,21954,0,0,0
21954,21954,21955,0,6,6
21955,21955,21956,6,5,-1
21956,21956,21957,5,9,4
21957,21957,21958,9,1,-8
21958,21958,21959,1,2,1
21959,21959,21960,2,0,-2
21960,21960,21961,0,6,6
21961,21961,21962,6,8,2
21962,21962,21963,8,5,-3
21963,21963,21964,5,1,-4
21964,21964,21965,1,8,7
21965,21965,21966,8,3,-5
21966,21966,21967,3,6,3
21967,21967,21968,6,4,-2
21968,21968,21969,4,9,5
21969,21969,21970,9,0,-9
21970,21970,21971,0,0,0
21971,21971,21972,0,1,1
21972,21972,21973,1,4,3
21973,21973,21974,4,3,-1
21974,21974,21975,3,0,-3
21975,21975,21976,0,5,5
21976,21976,21977,5,6,1
21977,21977,21978,6,1,-5
21978,21978,21979,1,1,0
21979,21979,21980,1,3,2
21980,21980,21981,3,9,6
21981,21981,21982,9,2,-7
21982,21982,21983,2,2,0
21983,21983,21984,2,1,-1
21984,21984,21985,1,0,-1
21985,21985,21986,0,3,3
21986,21986,21987,3,9,6
21987,21987,21988,9,4,-5
21988,21988,21989,4,5,1
21989,21989,21990,5,1,-4
21990,21990,21991,1,1,0
21991,21991,21992,1,4,3
21992,21992,21993,4,3,-1
21993,21993,21994,3,4,1
21994,21994,21995,4,6,2
21995,21995,21996,6,0,-6
21996,21996,21997,0,9,9
21997,21997,21998,9,3,-6
21998,21998,21999,3,4,1
21999,21999,22000,4,3,-1
22000,22000,22001,3,8,5
22001,22001,22002,8,3,-5
22002,22002,22003,3,3,0
22003,22003,22004,3,1,-2
22004,22004,22005,1,7,6
22005,22005,22006,7,6,-1
22006,22006,22007,6,7,1
22007,22007,22008,7,0,-7
22008,22008,22009,0,6,6
22009,22009,22010,6,2,-4
22010,22010,22011,2,3,1
22011,22011,22012,3,4,1
22012,22012,22013,4,0,-4
22013,22013,22014,0,3,3
22014,22014,22015,3,5,2
22015,22015,22016,5,7,2
22016,22016,22017,7,6,-1
22017,22017,22018,6,7,1
22018,22018,22019,7,2,-5
22019,22019,22020,2,5,3
22020,22020,22021,5,2,-3
22021,22021,22022,2,7,5
22022,22022,22023,7,0,-7
22023,22023,22024,0,3,3
22024,22024,22025,3,1,-2
22025,22025,22026,1,2,1
22026,22026,22027,2,2,0
22027,22027,22028,2,4,2
22028,22028,22029,4,3,-1
22029,22029,22030,3,5,2
22030,22030,22031,5,4,-1
22031,22031,22032,4,3,-1
22032,22032,22033,3,5,2
22033,22033,22034,5,4,-1
22034,22034,22035,4,6,2
22035,22035,22036,6,2,-4
22036,22036,22037,2,7,5
22037,22037,22038,7,5,-2
22038,22038,22039,5,8,3
22039,22039,22040,8,0,-8
22040,22040,22041,0,9,9
22041,22041,22042,9,5,-4
22042,22042,22043,5,0,-5
22043,22043,22044,0,2,2
22044,22044,22045,2,1,-1
22045,22045,22046,1,0,-1
22046,22046,22047,0,2,2
22047,22047,22048,2,0,-2
22048,22048,22049,0,3,3
22049,22049,22050,3,9,6
22050,22050,22051,9,4,-5
22051,22051,22052,4,7,3
22052,22052,22053,7,5,-2
22053,22053,22054,5,8,3
22054,22054,22055,8,6,-2
22055,22055,22056,6,2,-4
22056,22056,22057,2,7,5
22057,22057,22058,7,3,-4
22058,22058,22059,3,8,5
22059,22059,22060,8,8,0
22060,22060,22061,8,9,1
22061,22061,22062,9,2,-7
22062,22062,22063,2,0,-2
22063,22063,22064,0,4,4
22064,22064,22065,4,1,-3
22065,22065,22066,1,1,0
22066,22066,22067,1,2,1
22067,22067,22068,2,6,4
22068,22068,22069,6,3,-3
22069,22069,22070,3,2,-1
22070,22070,22071,2,4,2
22071,22071,22072,4,9,5
22072,22072,22073,9,5,-4
22073,22073,22074,5,6,1
22074,22074,22075,6,6,0
22075,22075,22076,6,2,-4
22076,22076,22077,2,7,5
22077,22077,22078,7,9,2
22078,22078,22079,9,8,-1
22079,22079,22080,8,9,1
22080,22080,22081,9,9,0
22081,22081,22082,9,7,-2
22082,22082,22083,7,2,-5
22083,22083,22084,2,6,4
22084,22084,22085,6,4,-2
22085,22085,22086,4,9,5
22086,22086,22087,9,1,-8
22087,22087,22088,1,9,8
22088,22088,22089,9,5,-4
22089,22089,22090,5,7,2
22090,22090,22091,7,6,-1
22091,22091,22092,6,3,-3
22092,22092,22093,3,1,-2
22093,22093,22094,1,7,6
22094,22094,22095,7,1,-6
22095,22095,22096,1,4,3
22096,22096,22097,4,7,3
22097,22097,22098,7,4,-3
22098,22098,22099,4,8,4
22099,22099,22100,8,2,-6
22100,22100,22101,2,5,3
22101,22101,22102,5,5,0
22102,22102,22103,5,3,-2
22103,22103,22104,3,2,-1
22104,22104,22105,2,4,2
22105,22105,22106,4,1,-3
22106,22106,22107,1,6,5
22107,22107,22108,6,9,3
22108,22108,22109,9,7,-2
22109,22109,22110,7,9,2
22110,22110,22111,9,0,-9
22111,22111,22112,0,2,2
22112,22112,22113,2,3,1
22113,22113,22114,3,3,0
22114,22114,22115,3,2,-1
22115,22115,22116,2,9,7
22116,22116,22117,9,9,0
22117,22117,22118,9,8,-1
22118,22118,22119,8,8,0
22119,22119,22120,8,1,-7
22120,22120,22121,1,6,5
22121,22121,22122,6,3,-3
22122,22122,22123,3,8,5
22123,22123,22124,8,2,-6
22124,22124,22125,2,9,7
22125,22125,22126,9,3,-6
22126,22126,22127,3,9,6
22127,22127,22128,9,6,-3
22128,22128,22129,6,7,1
22129,22129,22130,7,5,-2
22130,22130,22131,5,7,2
22131,22131,22132,7,2,-5
22132,22132,22133,2,2,0
22133,22133,22134,2,7,5
22134,22134,22135,7,1,-6
22135,22135,22136,1,8,7
22136,22136,22137,8,1,-7
22137,22137,22138,1,4,3
22138,22138,22139,4,2,-2
22139,22139,22140,2,9,7
22140,22140,22141,9,8,-1
22141,22141,22142,8,6,-2
22142,22142,22143,6,0,-6
22143,22143,22144,0,0,0
22144,22144,22145,0,6,6
22145,22145,22146,6,2,-4
22146,22146,22147,2,5,3
22147,22147,22148,5,9,4
22148,22148,22149,9,3,-6
22149,22149,22150,3,8,5
22150,22150,22151,8,8,0
22151,22151,22152,8,0,-8
22152,22152,22153,0,1,1
22153,22153,22154,1,3,2
22154,22154,22155,3,3,0
22155,22155,22156,3,5,2
22156,22156,22157,5,6,1
22157,22157,22158,6,1,-5
22158,22158,22159,1,0,-1
22159,22159,22160,0,6,6
22160,22160,22161,6,4,-2
22161,22161,22162,4,3,-1
22162,22162,22163,3,8,5
22163,22163,22164,8,1,-7
22164,22164,22165,1,9,8
22165,22165,22166,9,8,-1
22166,22166,22167,8,7,-1
22167,22167,22168,7,1,-6
22168,22168,22169,1,2,1
22169,22169,22170,2,1,-1
22170,22170,22171,1,7,6
22171,22171,22172,7,3,-4
22172,22172,22173,3,1,-2
22173,22173,22174,1,9,8
22174,22174,22175,9,8,-1
22175,22175,22176,8,9,1
22176,22176,22177,9,2,-7
22177,22177,22178,2,6,4
22178,22178,22179,6,1,-5
22179,22179,22180,1,5,4
22180,22180,22181,5,7,2
22181,22181,22182,7,3,-4
22182,22182,22183,3,7,4
22183,22183,22184,7,2,-5
22184,22184,22185,2,3,1
22185,22185,22186,3,5,2
22186,22186,22187,5,2,-3
22187,22187,22188,2,2,0
22188,22188,22189,2,4,2
22189,22189,22190,4,6,2
22190,22190,22191,6,6,0
22191,22191,22192,6,1,-5
22192,22192,22193,1,5,4
22193,22193,22194,5,5,0
22194,22194,22195,5,9,4
22195,22195,22196,9,0,-9
22196,22196,22197,0,4,4
22197,22197,22198,4,2,-2
22198,22198,22199,2,2,0
22199,22199,22200,2,2,0
22200,22200,22201,2,8,6
22201,22201,22202,8,0,-8
22202,22202,22203,0,2,2
22203,22203,22204,2,3,1
22204,22204,22205,3,5,2
22205,22205,22206,5,3,-2
22206,22206,22207,3,1,-2
22207,22207,22208,1,0,-1
22208,22208,22209,0,0,0
22209,22209,22210,0,6,6
22210,22210,22211,6,5,-1
22211,22211,22212,5,6,1
22212,22212,22213,6,0,-6
22213,22213,22214,0,1,1
22214,22214,22215,1,6,5
22215,22215,22216,6,9,3
22216,22216,22217,9,2,-7
22217,22217,22218,2,3,1
22218,22218,22219,3,3,0
22219,22219,22220,3,7,4
22220,22220,22221,7,6,-1
22221,22221,22222,6,1,-5
22222,22222,22223,1,9,8
22223,22223,22224,9,0,-9
22224,22224,22225,0,0,0
22225,22225,22226,0,2,2
22226,22226,22227,2,1,-1
22227,22227,22228,1,7,6
22228,22228,22229,7,2,-5
22229,22229,22230,2,9,7
22230,22230,22231,9,3,-6
22231,22231,22232,3,2,-1
22232,22232,22233,2,4,2
22233,22233,22234,4,3,-1
22234,22234,22235,3,5,2
22235,22235,22236,5,2,-3
22236,22236,22237,2,6,4
22237,22237,22238,6,3,-3
22238,22238,22239,3,7,4
22239,22239,22240,7,6,-1
22240,22240,22241,6,8,2
22241,22241,22242,8,4,-4
22242,22242,22243,4,9,5
22243,22243,22244,9,5,-4
22244,22244,22245,5,0,-5
22245,22245,22246,0,9,9
22246,22246,22247,9,1,-8
22247,22247,22248,1,1,0
22248,22248,22249,1,2,1
22249,22249,22250,2,7,5
22250,22250,22251,7,3,-4
22251,22251,22252,3,2,-1
22252,22252,22253,2,4,2
22253,22253,22254,4,0,-4
22254,22254,22255,0,5,5
22255,22255,22256,5,9,4
22256,22256,22257,9,6,-3
22257,22257,22258,6,6,0
22258,22258,22259,6,7,1
22259,22259,22260,7,6,-1
22260,22260,22261,6,8,2
22261,22261,22262,8,4,-4
22262,22262,22263,4,9,5
22263,22263,22264,9,5,-4
22264,22264,22265,5,0,-5
22265,22265,22266,0,8,8
22266,22266,22267,8,1,-7
22267,22267,22268,1,5,4
22268,22268,22269,5,2,-3
22269,22269,22270,2,0,-2
22270,22270,22271,0,3,3
22271,22271,22272,3,5,2
22272,22272,22273,5,4,-1
22273,22273,22274,4,8,4
22274,22274,22275,8,5,-3
22275,22275,22276,5,4,-1
22276,22276,22277,4,6,2
22277,22277,22278,6,2,-4
22278,22278,22279,2,7,5
22279,22279,22280,7,2,-5
22280,22280,22281,2,8,6
22281,22281,22282,8,6,-2
22282,22282,22283,6,9,3
22283,22283,22284,9,2,-7
22284,22284,22285,2,4,2
22285,22285,22286,4,8,4
22286,22286,22287,8,7,-1
22287,22287,22288,7,0,-7
22288,22288,22289,0,8,8
22289,22289,22290,8,8,0
22290,22290,22291,8,6,-2
22291,22291,22292,6,8,2
22292,22292,22293,8,3,-5
22293,22293,22294,3,0,-3
22294,22294,22295,0,4,4
22295,22295,22296,4,9,5
22296,22296,22297,9,0,-9
22297,22297,22298,0,6,6
22298,22298,22299,6,9,3
22299,22299,22300,9,7,-2
22300,22300,22301,7,7,0
22301,22301,22302,7,5,-2
22302,22302,22303,5,1,-4
22303,22303,22304,1,3,2
22304,22304,22305,3,9,6
22305,22305,22306,9,0,-9
22306,22306,22307,0,3,3
22307,22307,22308,3,8,5
22308,22308,22309,8,8,0
22309,22309,22310,8,5,-3
22310,22310,22311,5,4,-1
22311,22311,22312,4,9,5
22312,22312,22313,9,7,-2
22313,22313,22314,7,7,0
22314,22314,22315,7,3,-4
22315,22315,22316,3,9,6
22316,22316,22317,9,0,-9
22317,22317,22318,0,3,3
22318,22318,22319,3,9,6
22319,22319,22320,9,8,-1
22320,22320,22321,8,9,1
22321,22321,22322,9,3,-6
22322,22322,22323,3,6,3
22323,22323,22324,6,8,2
22324,22324,22325,8,1,-7
22325,22325,22326,1,7,6
22326,22326,22327,7,4,-3
22327,22327,22328,4,1,-3
22328,22328,22329,1,5,4
22329,22329,22330,5,1,-4
22330,22330,22331,1,4,3
22331,22331,22332,4,9,5
22332,22332,22333,9,6,-3
22333,22333,22334,6,9,3
22334,22334,22335,9,2,-7
22335,22335,22336,2,7,5
22336,22336,22337,7,0,-7
22337,22337,22338,0,9,9
22338,22338,22339,9,6,-3
22339,22339,22340,6,9,3
22340,22340,22341,9,2,-7
22341,22341,22342,2,7,5
22342,22342,22343,7,1,-6
22343,22343,22344,1,0,-1
22344,22344,22345,0,1,1
22345,22345,22346,1,7,6
22346,22346,22347,7,1,-6
22347,22347,22348,1,7,6
22348,22348,22349,7,1,-6
22349,22349,22350,1,7,6
22350,22350,22351,7,7,0
22351,22351,22352,7,0,-7
22352,22352,22353,0,2,2
22353,22353,22354,2,5,3
22354,22354,22355,5,4,-1
22355,22355,22356,4,2,-2
22356,22356,22357,2,2,0
22357,22357,22358,2,2,0
22358,22358,22359,2,9,7
22359,22359,22360,9,6,-3
22360,22360,22361,6,4,-2
22361,22361,22362,4,0,-4
22362,22362,22363,0,5,5
22363,22363,22364,5,0,-5
22364,22364,22365,0,8,8
22365,22365,22366,8,3,-5
22366,22366,22367,3,4,1
22367,22367,22368,4,2,-2
22368,22368,22369,2,2,0
22369,22369,22370,2,1,-1
22370,22370,22371,1,7,6
22371,22371,22372,7,4,-3
22372,22372,22373,4,0,-4
22373,22373,22374,0,3,3
22374,22374,22375,3,0,-3
22375,22375,22376,0,2,2
22376,22376,22377,2,7,5
22377,22377,22378,7,0,-7
22378,22378,22379,0,5,5
22379,22379,22380,5,5,0
22380,22380,22381,5,7,2
22381,22381,22382,7,5,-2
22382,22382,22383,5,6,1
22383,22383,22384,6,6,0
22384,22384,22385,6,6,0
22385,22385,22386,6,2,-4
22386,22386,22387,2,6,4
22387,22387,22388,6,9,3
22388,22388,22389,9,8,-1
22389,22389,22390,8,9,1
22390,22390,22391,9,2,-7
22391,22391,22392,2,7,5
22392,22392,22393,7,5,-2
22393,22393,22394,5,4,-1
22394,22394,22395,4,2,-2
22395,22395,22396,2,5,3
22396,22396,22397,5,2,-3
22397,22397,22398,2,1,-1
22398,22398,22399,1,7,6
22399,22399,22400,7,4,-3
22400,22400,22401,4,7,3
22401,22401,22402,7,4,-3
22402,22402,22403,4,4,0
22403,22403,22404,4,3,-1
22404,22404,22405,3,0,-3
22405,22405,22406,0,9,9
22406,22406,22407,9,2,-7
22407,22407,22408,2,3,1
22408,22408,22409,3,4,1
22409,22409,22410,4,1,-3
22410,22410,22411,1,2,1
22411,22411,22412,2,1,-1
22412,22412,22413,1,3,2
22413,22413,22414,3,2,-1
22414,22414,22415,2,3,1
22415,22415,22416,3,7,4
22416,22416,22417,7,3,-4
22417,22417,22418,3,4,1
22418,22418,22419,4,1,-3
22419,22419,22420,1,7,6
22420,22420,22421,7,8,1
22421,22421,22422,8,6,-2
22422,22422,22423,6,9,3
22423,22423,22424,9,6,-3
22424,22424,22425,6,6,0
22425,22425,22426,6,5,-1
22426,22426,22427,5,1,-4
22427,22427,22428,1,5,4
22428,22428,22429,5,0,-5
22429,22429,22430,0,0,0
22430,22430,22431,0,5,5
22431,22431,22432,5,0,-5
22432,22432,22433,0,9,9
22433,22433,22434,9,4,-5
22434,22434,22435,4,6,2
22435,22435,22436,6,0,-6
22436,22436,22437,0,9,9
22437,22437,22438,9,8,-1
22438,22438,22439,8,8,0
22439,22439,22440,8,0,-8
22440,22440,22441,0,0,0
22441,22441,22442,0,2,2
22442,22442,22443,2,3,1
22443,22443,22444,3,0,-3
22444,22444,22445,0,0,0
22445,22445,22446,0,2,2
22446,22446,22447,2,9,7
22447,22447,22448,9,6,-3
22448,22448,22449,6,6,0
22449,22449,22450,6,9,3
22450,22450,22451,9,3,-6
22451,22451,22452,3,1,-2
22452,22452,22453,1,0,-1
22453,22453,22454,0,7,7
22454,22454,22455,7,1,-6
22455,22455,22456,1,4,3
22456,22456,22457,4,2,-2
22457,22457,22458,2,9,7
22458,22458,22459,9,3,-6
22459,22459,22460,3,3,0
22460,22460,22461,3,4,1
22461,22461,22462,4,1,-3
22462,22462,22463,1,5,4
22463,22463,22464,5,1,-4
22464,22464,22465,1,6,5
22465,22465,22466,6,1,-5
22466,22466,22467,1,7,6
22467,22467,22468,7,3,-4
22468,22468,22469,3,8,5
22469,22469,22470,8,5,-3
22470,22470,22471,5,9,4
22471,22471,22472,9,4,-5
22472,22472,22473,4,0,-4
22473,22473,22474,0,3,3
22474,22474,22475,3,1,-2
22475,22475,22476,1,1,0
22476,22476,22477,1,3,2
22477,22477,22478,3,1,-2
22478,22478,22479,1,4,3
22479,22479,22480,4,4,0
22480,22480,22481,4,7,3
22481,22481,22482,7,4,-3
22482,22482,22483,4,8,4
22483,22483,22484,8,8,0
22484,22484,22485,8,9,1
22485,22485,22486,9,2,-7
22486,22486,22487,2,0,-2
22487,22487,22488,0,3,3
22488,22488,22489,3,1,-2
22489,22489,22490,1,1,0
22490,22490,22491,1,2,1
22491,22491,22492,2,3,1
22492,22492,22493,3,3,0
22493,22493,22494,3,8,5
22494,22494,22495,8,4,-4
22495,22495,22496,4,3,-1
22496,22496,22497,3,7,4
22497,22497,22498,7,7,0
22498,22498,22499,7,8,1
22499,22499,22500,8,2,-6
22500,22500,22501,2,9,7
22501,22501,22502,9,1,-8
22502,22502,22503,1,9,8
22503,22503,22504,9,4,-5
22504,22504,22505,4,9,5
22505,22505,22506,9,5,-4
22506,22506,22507,5,8,3
22507,22507,22508,8,5,-3
22508,22508,22509,5,5,0
22509,22509,22510,5,0,-5
22510,22510,22511,0,0,0
22511,22511,22512,0,1,1
22512,22512,22513,1,7,6
22513,22513,22514,7,9,2
22514,22514,22515,9,7,-2
22515,22515,22516,7,2,-5
22516,22516,22517,2,5,3
22517,22517,22518,5,4,-1
22518,22518,22519,4,7,3
22519,22519,22520,7,6,-1
22520,22520,22521,6,9,3
22521,22521,22522,9,3,-6
22522,22522,22523,3,9,6
22523,22523,22524,9,2,-7
22524,22524,22525,2,4,2
22525,22525,22526,4,8,4
22526,22526,22527,8,7,-1
22527,22527,22528,7,7,0
22528,22528,22529,7,0,-7
22529,22529,22530,0,7,7
22530,22530,22531,7,4,-3
22531,22531,22532,4,8,4
22532,22532,22533,8,1,-7
22533,22533,22534,1,7,6
22534,22534,22535,7,4,-3
22535,22535,22536,4,3,-1
22536,22536,22537,3,4,1
22537,22537,22538,4,1,-3
22538,22538,22539,1,7,6
22539,22539,22540,7,9,2
22540,22540,22541,9,5,-4
22541,22541,22542,5,3,-2
22542,22542,22543,3,8,5
22543,22543,22544,8,4,-4
22544,22544,22545,4,1,-3
22545,22545,22546,1,7,6
22546,22546,22547,7,4,-3
22547,22547,22548,4,2,-2
22548,22548,22549,2,9,7
22549,22549,22550,9,6,-3
22550,22550,22551,6,8,2
22551,22551,22552,8,9,1
22552,22552,22553,9,4,-5
22553,22553,22554,4,2,-2
22554,22554,22555,2,1,-1
22555,22555,22556,1,5,4
22556,22556,22557,5,8,3
22557,22557,22558,8,2,-6
22558,22558,22559,2,6,4
22559,22559,22560,6,1,-5
22560,22560,22561,1,6,5
22561,22561,22562,6,6,0
22562,22562,22563,6,4,-2
22563,22563,22564,4,4,0
22564,22564,22565,4,5,1
22565,22565,22566,5,5,0
22566,22566,22567,5,3,-2
22567,22567,22568,3,8,5
22568,22568,22569,8,3,-5
22569,22569,22570,3,7,4
22570,22570,22571,7,5,-2
22571,22571,22572,5,4,-1
22572,22572,22573,4,2,-2
22573,22573,22574,2,4,2
22574,22574,22575,4,5,1
22575,22575,22576,5,9,4
22576,22576,22577,9,7,-2
22577,22577,22578,7,3,-4
22578,22578,22579,3,2,-1
22579,22579,22580,2,4,2
22580,22580,22581,4,5,1
22581,22581,22582,5,1,-4
22582,22582,22583,1,0,-1
22583,22583,22584,0,4,4
22584,22584,22585,4,8,4
22585,22585,22586,8,1,-7
22586,22586,22587,1,3,2
22587,22587,22588,3,7,4
22588,22588,22589,7,0,-7
22589,22589,22590,0,4,4
22590,22590,22591,4,8,4
22591,22591,22592,8,6,-2
22592,22592,22593,6,7,1
22593,22593,22594,7,2,-5
22594,22594,22595,2,4,2
22595,22595,22596,4,0,-4
22596,22596,22597,0,9,9
22597,22597,22598,9,3,-6
22598,22598,22599,3,5,2
22599,22599,22600,5,6,1
22600,22600,22601,6,0,-6
22601,22601,22602,0,4,4
22602,22602,22603,4,0,-4
22603,22603,22604,0,8,8
22604,22604,22605,8,0,-8
22605,22605,22606,0,2,2
22606,22606,22607,2,4,2
22607,22607,22608,4,7,3
22608,22608,22609,7,6,-1
22609,22609,22610,6,9,3
22610,22610,22611,9,2,-7
22611,22611,22612,2,2,0
22612,22612,22613,2,7,5
22613,22613,22614,7,4,-3
22614,22614,22615,4,6,2
22615,22615,22616,6,6,0
22616,22616,22617,6,8,2
22617,22617,22618,8,6,-2
22618,22618,22619,6,3,-3
22619,22619,22620,3,2,-1
22620,22620,22621,2,1,-1
22621,22621,22622,1,5,4
22622,22622,22623,5,8,3
22623,22623,22624,8,2,-6
22624,22624,22625,2,3,1
22625,22625,22626,3,7,4
22626,22626,22627,7,1,-6
22627,22627,22628,1,1,0
22628,22628,22629,1,0,-1
22629,22629,22630,0,4,4
22630,22630,22631,4,3,-1
22631,22631,22632,3,1,-2
22632,22632,22633,1,6,5
22633,22633,22634,6,0,-6
22634,22634,22635,0,2,2
22635,22635,22636,2,0,-2
22636,22636,22637,0,0,0
22637,22637,22638,0,5,5
22638,22638,22639,5,1,-4
22639,22639,22640,1,0,-1
22640,22640,22641,0,2,2
22641,22641,22642,2,1,-1
22642,22642,22643,1,3,2
22643,22643,22644,3,1,-2
22644,22644,22645,1,4,3
22645,22645,22646,4,0,-4
22646,22646,22647,0,5,5
22647,22647,22648,5,9,4
22648,22648,22649,9,6,-3
22649,22649,22650,6,5,-1
22650,22650,22651,5,7,2
22651,22651,22652,7,4,-3
22652,22652,22653,4,8,4
22653,22653,22654,8,6,-2
22654,22654,22655,6,9,3
22655,22655,22656,9,1,-8
22656,22656,22657,1,0,-1
22657,22657,22658,0,0,0
22658,22658,22659,0,1,1
22659,22659,22660,1,4,3
22660,22660,22661,4,2,-2
22661,22661,22662,2,7,5
22662,22662,22663,7,3,-4
22663,22663,22664,3,9,6
22664,22664,22665,9,6,-3
22665,22665,22666,6,4,-2
22666,22666,22667,4,7,3
22667,22667,22668,7,3,-4
22668,22668,22669,3,0,-3
22669,22669,22670,0,4,4
22670,22670,22671,4,1,-3
22671,22671,22672,1,9,8
22672,22672,22673,9,2,-7
22673,22673,22674,2,3,1
22674,22674,22675,3,3,0
22675,22675,22676,3,4,1
22676,22676,22677,4,4,0
22677,22677,22678,4,9,5
22678,22678,22679,9,5,-4
22679,22679,22680,5,5,0
22680,22680,22681,5,6,1
22681,22681,22682,6,8,2
22682,22682,22683,8,7,-1
22683,22683,22684,7,9,2
22684,22684,22685,9,8,-1
22685,22685,22686,8,5,-3
22686,22686,22687,5,9,4
22687,22687,22688,9,2,-7
22688,22688,22689,2,1,-1
22689,22689,22690,1,6,5
22690,22690,22691,6,0,-6
22691,22691,22692,0,9,9
22692,22692,22693,9,6,-3
22693,22693,22694,6,4,-2
22694,22694,22695,4,3,-1
22695,22695,22696,3,2,-1
22696,22696,22697,2,4,2
22697,22697,22698,4,6,2
22698,22698,22699,6,4,-2
22699,22699,22700,4,1,-3
22700,22700,22701,1,2,1
22701,22701,22702,2,6,4
22702,22702,22703,6,8,2
22703,22703,22704,8,5,-3
22704,22704,22705,5,1,-4
22705,22705,22706,1,0,-1
22706,22706,22707,0,0,0
22707,22707,22708,0,3,3
22708,22708,22709,3,6,3
22709,22709,22710,6,0,-6
22710,22710,22711,0,7,7
22711,22711,22712,7,2,-5
22712,22712,22713,2,2,0
22713,22713,22714,2,4,2
22714,22714,22715,4,3,-1
22715,22715,22716,3,6,3
22716,22716,22717,6,3,-3
22717,22717,22718,3,6,3
22718,22718,22719,6,9,3
22719,22719,22720,9,5,-4
22720,22720,22721,5,3,-2
22721,22721,22722,3,4,1
22722,22722,22723,4,3,-1
22723,22723,22724,3,8,5
22724,22724,22725,8,9,1
22725,22725,22726,9,2,-7
22726,22726,22727,2,1,-1
22727,22727,22728,1,3,2
22728,22728,22729,3,5,2
22729,22729,22730,5,3,-2
22730,22730,22731,3,2,-1
22731,22731,22732,2,5,3
22732,22732,22733,5,3,-2
22733,22733,22734,3,5,2
22734,22734,22735,5,1,-4
22735,22735,22736,1,5,4
22736,22736,22737,5,6,1
22737,22737,22738,6,3,-3
22738,22738,22739,3,7,4
22739,22739,22740,7,7,0
22740,22740,22741,7,3,-4
22741,22741,22742,3,2,-1
22742,22742,22743,2,7,5
22743,22743,22744,7,0,-7
22744,22744,22745,0,8,8
22745,22745,22746,8,5,-3
22746,22746,22747,5,4,-1
22747,22747,22748,4,1,-3
22748,22748,22749,1,0,-1
22749,22749,22750,0,4,4
22750,22750,22751,4,2,-2
22751,22751,22752,2,0,-2
22752,22752,22753,0,7,7
22753,22753,22754,7,7,0
22754,22754,22755,7,8,1
22755,22755,22756,8,5,-3
22756,22756,22757,5,0,-5
22757,22757,22758,0,6,6
22758,22758,22759,6,7,1
22759,22759,22760,7,8,1
22760,22760,22761,8,0,-8
22761,22761,22762,0,9,9
22762,22762,22763,9,6,-3
22763,22763,22764,6,0,-6
22764,22764,22765,0,9,9
22765,22765,22766,9,4,-5
22766,22766,22767,4,3,-1
22767,22767,22768,3,4,1
22768,22768,22769,4,2,-2
22769,22769,22770,2,3,1
22770,22770,22771,3,4,1
22771,22771,22772,4,9,5
22772,22772,22773,9,8,-1
22773,22773,22774,8,4,-4
22774,22774,22775,4,6,2
22775,22775,22776,6,1,-5
22776,22776,22777,1,0,-1
22777,22777,22778,0,2,2
22778,22778,22779,2,5,3
22779,22779,22780,5,9,4
22780,22780,22781,9,7,-2
22781,22781,22782,7,9,2
22782,22782,22783,9,5,-4
22783,22783,22784,5,8,3
22784,22784,22785,8,1,-7
22785,22785,22786,1,4,3
22786,22786,22787,4,0,-4
22787,22787,22788,0,1,1
22788,22788,22789,1,6,5
22789,22789,22790,6,7,1
22790,22790,22791,7,7,0
22791,22791,22792,7,2,-5
22792,22792,22793,2,2,0
22793,22793,22794,2,1,-1
22794,22794,22795,1,9,8
22795,22795,22796,9,7,-2
22796,22796,22797,7,7,0
22797,22797,22798,7,1,-6
22798,22798,22799,1,9,8
22799,22799,22800,9,2,-7
22800,22800,22801,2,5,3
22801,22801,22802,5,5,0
22802,22802,22803,5,6,1
22803,22803,22804,6,9,3
22804,22804,22805,9,5,-4
22805,22805,22806,5,6,1
22806,22806,22807,6,2,-4
22807,22807,22808,2,8,6
22808,22808,22809,8,6,-2
22809,22809,22810,6,8,2
22810,22810,22811,8,2,-6
22811,22811,22812,2,1,-1
22812,22812,22813,1,8,7
22813,22813,22814,8,6,-2
22814,22814,22815,6,1,-5
22815,22815,22816,1,0,-1
22816,22816,22817,0,7,7
22817,22817,22818,7,4,-3
22818,22818,22819,4,5,1
22819,22819,22820,5,6,1
22820,22820,22821,6,5,-1
22821,22821,22822,5,5,0
22822,22822,22823,5,7,2
22823,22823,22824,7,9,2
22824,22824,22825,9,3,-6
22825,22825,22826,3,7,4
22826,22826,22827,7,5,-2
22827,22827,22828,5,1,-4
22828,22828,22829,1,0,-1
22829,22829,22830,0,6,6
22830,22830,22831,6,1,-5
22831,22831,22832,1,0,-1
22832,22832,22833,0,1,1
22833,22833,22834,1,6,5
22834,22834,22835,6,3,-3
22835,22835,22836,3,7,4
22836,22836,22837,7,8,1
22837,22837,22838,8,4,-4
22838,22838,22839,4,4,0
22839,22839,22840,4,6,2
22840,22840,22841,6,9,3
22841,22841,22842,9,9,0
22842,22842,22843,9,4,-5
22843,22843,22844,4,1,-3
22844,22844,22845,1,5,4
22845,22845,22846,5,5,0
22846,22846,22847,5,1,-4
22847,22847,22848,1,1,0
22848,22848,22849,1,8,7
22849,22849,22850,8,1,-7
22850,22850,22851,1,6,5
22851,22851,22852,6,2,-4
22852,22852,22853,2,8,6
22853,22853,22854,8,9,1
22854,22854,22855,9,9,0
22855,22855,22856,9,2,-7
22856,22856,22857,2,0,-2
22857,22857,22858,0,7,7
22858,22858,22859,7,1,-6
22859,22859,22860,1,0,-1
22860,22860,22861,0,2,2
22861,22861,22862,2,7,5
22862,22862,22863,7,3,-4
22863,22863,22864,3,2,-1
22864,22864,22865,2,4,2
22865,22865,22866,4,5,1
22866,22866,22867,5,5,0
22867,22867,22868,5,1,-4
22868,22868,22869,1,6,5
22869,22869,22870,6,7,1
22870,22870,22871,7,7,0
22871,22871,22872,7,6,-1
22872,22872,22873,6,8,2
22873,22873,22874,8,0,-8
22874,22874,22875,0,9,9
22875,22875,22876,9,7,-2
22876,22876,22877,7,0,-7
22877,22877,22878,0,2,2
22878,22878,22879,2,1,-1
22879,22879,22880,1,7,6
22880,22880,22881,7,2,-5
22881,22881,22882,2,0,-2
22882,22882,22883,0,3,3
22883,22883,22884,3,2,-1
22884,22884,22885,2,4,2
22885,22885,22886,4,0,-4
22886,22886,22887,0,5,5
22887,22887,22888,5,1,-4
22888,22888,22889,1,6,5
22889,22889,22890,6,9,3
22890,22890,22891,9,7,-2
22891,22891,22892,7,1,-6
22892,22892,22893,1,8,7
22893,22893,22894,8,3,-5
22894,22894,22895,3,9,6
22895,22895,22896,9,1,-8
22896,22896,22897,1,0,-1
22897,22897,22898,0,9,9
22898,22898,22899,9,1,-8
22899,22899,22900,1,2,1
22900,22900,22901,2,2,0
22901,22901,22902,2,9,7
22902,22902,22903,9,3,-6
22903,22903,22904,3,6,3
22904,22904,22905,6,4,-2
22905,22905,22906,4,3,-1
22906,22906,22907,3,5,2
22907,22907,22908,5,6,1
22908,22908,22909,6,6,0
22909,22909,22910,6,0,-6
22910,22910,22911,0,7,7
22911,22911,22912,7,0,-7
22912,22912,22913,0,8,8
22913,22913,22914,8,1,-7
22914,22914,22915,1,9,8
22915,22915,22916,9,1,-8
22916,22916,22917,1,0,-1
22917,22917,22918,0,5,5
22918,22918,22919,5,8,3
22919,22919,22920,8,5,-3
22920,22920,22921,5,7,2
22921,22921,22922,7,2,-5
22922,22922,22923,2,8,6
22923,22923,22924,8,8,0
22924,22924,22925,8,9,1
22925,22925,22926,9,1,-8
22926,22926,22927,1,9,8
22927,22927,22928,9,1,-8
22928,22928,22929,1,0,-1
22929,22929,22930,0,2,2
22930,22930,22931,2,1,-1
22931,22931,22932,1,0,-1
22932,22932,22933,0,4,4
22933,22933,22934,4,8,4
22934,22934,22935,8,5,-3
22935,22935,22936,5,6,1
22936,22936,22937,6,1,-5
22937,22937,22938,1,0,-1
22938,22938,22939,0,6,6
22939,22939,22940,6,6,0
22940,22940,22941,6,7,1
22941,22941,22942,7,5,-2
22942,22942,22943,5,3,-2
22943,22943,22944,3,6,3
22944,22944,22945,6,2,-4
22945,22945,22946,2,3,1
22946,22946,22947,3,9,6
22947,22947,22948,9,9,0
22948,22948,22949,9,0,-9
22949,22949,22950,0,7,7
22950,22950,22951,7,5,-2
22951,22951,22952,5,1,-4
22952,22952,22953,1,6,5
22953,22953,22954,6,0,-6
22954,22954,22955,0,7,7
22955,22955,22956,7,1,-6
22956,22956,22957,1,3,2
22957,22957,22958,3,2,-1
22958,22958,22959,2,9,7
22959,22959,22960,9,4,-5
22960,22960,22961,4,9,5
22961,22961,22962,9,6,-3
22962,22962,22963,6,3,-3
22963,22963,22964,3,3,0
22964,22964,22965,3,8,5
22965,22965,22966,8,8,0
22966,22966,22967,8,9,1
22967,22967,22968,9,4,-5
22968,22968,22969,4,6,2
22969,22969,22970,6,4,-2
22970,22970,22971,4,7,3
22971,22971,22972,7,1,-6
22972,22972,22973,1,5,4
22973,22973,22974,5,4,-1
22974,22974,22975,4,6,2
22975,22975,22976,6,8,2
22976,22976,22977,8,3,-5
22977,22977,22978,3,0,-3
22978,22978,22979,0,5,5
22979,22979,22980,5,4,-1
22980,22980,22981,4,0,-4
22981,22981,22982,0,6,6
22982,22982,22983,6,5,-1
22983,22983,22984,5,7,2
22984,22984,22985,7,4,-3
22985,22985,22986,4,6,2
22986,22986,22987,6,0,-6
22987,22987,22988,0,4,4
22988,22988,22989,4,3,-1
22989,22989,22990,3,2,-1
22990,22990,22991,2,4,2
22991,22991,22992,4,4,0
22992,22992,22993,4,7,3
22993,22993,22994,7,2,-5
22994,22994,22995,2,7,5
22995,22995,22996,7,3,-4
22996,22996,22997,3,4,1
22997,22997,22998,4,2,-2
22998,22998,22999,2,3,1
22999,22999,23000,3,7,4
23000,23000,23001,7,2,-5
23001,23001,23002,2,7,5
23002,23002,23003,7,1,-6
23003,23003,23004,1,8,7
23004,23004,23005,8,5,-3
23005,23005,23006,5,5,0
23006,23006,23007,5,5,0
23007,23007,23008,5,8,3
23008,23008,23009,8,0,-8
23009,23009,23010,0,7,7
23010,23010,23011,7,5,-2
23011,23011,23012,5,1,-4
23012,23012,23013,1,0,-1
23013,23013,23014,0,4,4
23014,23014,23015,4,8,4
23015,23015,23016,8,9,1
23016,23016,23017,9,4,-5
23017,23017,23018,4,2,-2
23018,23018,23019,2,6,4
23019,23019,23020,6,2,-4
23020,23020,23021,2,7,5
23021,23021,23022,7,3,-4
23022,23022,23023,3,0,-3
23023,23023,23024,0,3,3
23024,23024,23025,3,2,-1
23025,23025,23026,2,2,0
23026,23026,23027,2,9,7
23027,23027,23028,9,2,-7
23028,23028,23029,2,3,1
23029,23029,23030,3,1,-2
23030,23030,23031,1,4,3
23031,23031,23032,4,0,-4
23032,23032,23033,0,4,4
23033,23033,23034,4,1,-3
23034,23034,23035,1,8,7
23035,23035,23036,8,1,-7
23036,23036,23037,1,1,0
23037,23037,23038,1,2,1
23038,23038,23039,2,2,0
23039,23039,23040,2,2,0
23040,23040,23041,2,2,0
23041,23041,23042,2,9,7
23042,23042,23043,9,3,-6
23043,23043,23044,3,0,-3
23044,23044,23045,0,1,1
23045,23045,23046,1,3,2
23046,23046,23047,3,3,0
23047,23047,23048,3,8,5
23048,23048,23049,8,6,-2
23049,23049,23050,6,6,0
23050,23050,23051,6,7,1
23051,23051,23052,7,8,1
23052,23052,23053,8,3,-5
23053,23053,23054,3,7,4
23054,23054,23055,7,4,-3
23055,23055,23056,4,1,-3
23056,23056,23057,1,9,8
23057,23057,23058,9,2,-7
23058,23058,23059,2,1,-1
23059,23059,23060,1,0,-1
23060,23060,23061,0,9,9
23061,23061,23062,9,9,0
23062,23062,23063,9,8,-1
23063,23063,23064,8,8,0
23064,23064,23065,8,5,-3
23065,23065,23066,5,5,0
23066,23066,23067,5,0,-5
23067,23067,23068,0,7,7
23068,23068,23069,7,2,-5
23069,23069,23070,2,7,5
23070,23070,23071,7,8,1
23071,23071,23072,8,6,-2
23072,23072,23073,6,6,0
23073,23073,23074,6,7,1
23074,23074,23075,7,6,-1
23075,23075,23076,6,3,-3
23076,23076,23077,3,8,5
23077,23077,23078,8,8,0
23078,23078,23079,8,2,-6
23079,23079,23080,2,2,0
23080,23080,23081,2,8,6
23081,23081,23082,8,2,-6
23082,23082,23083,2,4,2
23083,23083,23084,4,9,5
23084,23084,23085,9,4,-5
23085,23085,23086,4,8,4
23086,23086,23087,8,2,-6
23087,23087,23088,2,0,-2
23088,23088,23089,0,2,2
23089,23089,23090,2,9,7
23090,23090,23091,9,8,-1
23091,23091,23092,8,8,0
23092,23092,23093,8,0,-8
23093,23093,23094,0,7,7
23094,23094,23095,7,0,-7
23095,23095,23096,0,4,4
23096,23096,23097,4,1,-3
23097,23097,23098,1,6,5
23098,23098,23099,6,2,-4
23099,23099,23100,2,9,7
23100,23100,23101,9,3,-6
23101,23101,23102,3,9,6
23102,23102,23103,9,4,-5
23103,23103,23104,4,0,-4
23104,23104,23105,0,5,5
23105,23105,23106,5,2,-3
23106,23106,23107,2,6,4
23107,23107,23108,6,0,-6
23108,23108,23109,0,8,8
23109,23109,23110,8,6,-2
23110,23110,23111,6,9,3
23111,23111,23112,9,8,-1
23112,23112,23113,8,0,-8
23113,23113,23114,0,2,2
23114,23114,23115,2,1,-1
23115,23115,23116,1,3,2
23116,23116,23117,3,2,-1
23117,23117,23118,2,1,-1
23118,23118,23119,1,3,2
23119,23119,23120,3,0,-3
23120,23120,23121,0,4,4
23121,23121,23122,4,4,0
23122,23122,23123,4,5,1
23123,23123,23124,5,0,-5
23124,23124,23125,0,6,6
23125,23125,23126,6,6,0
23126,23126,23127,6,7,1
23127,23127,23128,7,9,2
23128,23128,23129,9,8,-1
23129,23129,23130,8,3,-5
23130,23130,23131,3,0,-3
23131,23131,23132,0,1,1
23132,23132,23133,1,1,0
23133,23133,23134,1,1,0
23134,23134,23135,1,4,3
23135,23135,23136,4,0,-4
23136,23136,23137,0,5,5
23137,23137,23138,5,2,-3
23138,23138,23139,2,6,4
23139,23139,23140,6,7,1
23140,23140,23141,7,7,0
23141,23141,23142,7,1,-6
23142,23142,23143,1,8,7
23143,23143,23144,8,3,-5
23144,23144,23145,3,9,6
23145,23145,23146,9,5,-4
23146,23146,23147,5,8,3
23147,23147,23148,8,6,-2
23148,23148,23149,6,7,1
23149,23149,23150,7,4,-3
23150,23150,23151,4,4,0
23151,23151,23152,4,4,0
23152,23152,23153,4,7,3
23153,23153,23154,7,0,-7
23154,23154,23155,0,7,7
23155,23155,23156,7,3,-4
23156,23156,23157,3,3,0
23157,23157,23158,3,5,2
23158,23158,23159,5,9,4
23159,23159,23160,9,1,-8
23160,23160,23161,1,8,7
23161,23161,23162,8,2,-6
23162,23162,23163,2,8,6
23163,23163,23164,8,7,-1
23164,23164,23165,7,3,-4
23165,23165,23166,3,9,6
23166,23166,23167,9,1,-8
23167,23167,23168,1,6,5
23168,23168,23169,6,5,-1
23169,23169,23170,5,9,4
23170,23170,23171,9,2,-7
23171,23171,23172,2,0,-2
23172,23172,23173,0,7,7
23173,23173,23174,7,4,-3
23174,23174,23175,4,4,0
23175,23175,23176,4,1,-3
23176,23176,23177,1,2,1
23177,23177,23178,2,7,5
23178,23178,23179,7,6,-1
23179,23179,23180,6,8,2
23180,23180,23181,8,1,-7
23181,23181,23182,1,1,0
23182,23182,23183,1,5,4
23183,23183,23184,5,8,3
23184,23184,23185,8,2,-6
23185,23185,23186,2,6,4
23186,23186,23187,6,4,-2
23187,23187,23188,4,4,0
23188,23188,23189,4,5,1
23189,23189,23190,5,8,3
23190,23190,23191,8,5,-3
23191,23191,23192,5,7,2
23192,23192,23193,7,8,1
23193,23193,23194,8,2,-6
23194,23194,23195,2,6,4
23195,23195,23196,6,4,-2
23196,23196,23197,4,4,0
23197,23197,23198,4,6,2
23198,23198,23199,6,4,-2
23199,23199,23200,4,5,1
23200,23200,23201,5,4,-1
23201,23201,23202,4,3,-1
23202,23202,23203,3,1,-2
23203,23203,23204,1,1,0
23204,23204,23205,1,8,7
23205,23205,23206,8,3,-5
23206,23206,23207,3,7,4
23207,23207,23208,7,4,-3
23208,23208,23209,4,5,1
23209,23209,23210,5,0,-5
23210,23210,23211,0,5,5
23211,23211,23212,5,9,4
23212,23212,23213,9,1,-8
23213,23213,23214,1,1,0
23214,23214,23215,1,8,7
23215,23215,23216,8,2,-6
23216,23216,23217,2,9,7
23217,23217,23218,9,3,-6
23218,23218,23219,3,1,-2
23219,23219,23220,1,7,6
23220,23220,23221,7,3,-4
23221,23221,23222,3,2,-1
23222,23222,23223,2,6,4
23223,23223,23224,6,9,3
23224,23224,23225,9,3,-6
23225,23225,23226,3,5,2
23226,23226,23227,5,3,-2
23227,23227,23228,3,6,3
23228,23228,23229,6,2,-4
23229,23229,23230,2,7,5
23230,23230,23231,7,2,-5
23231,23231,23232,2,8,6
23232,23232,23233,8,6,-2
23233,23233,23234,6,9,3
23234,23234,23235,9,5,-4
23235,23235,23236,5,6,1
23236,23236,23237,6,5,-1
23237,23237,23238,5,1,-4
23238,23238,23239,1,3,2
23239,23239,23240,3,1,-2
23240,23240,23241,1,3,2
23241,23241,23242,3,3,0
23242,23242,23243,3,8,5
23243,23243,23244,8,6,-2
23244,23244,23245,6,1,-5
23245,23245,23246,1,7,6
23246,23246,23247,7,6,-1
23247,23247,23248,6,7,1
23248,23248,23249,7,5,-2
23249,23249,23250,5,0,-5
23250,23250,23251,0,6,6
23251,23251,23252,6,5,-1
23252,23252,23253,5,8,3
23253,23253,23254,8,1,-7
23254,23254,23255,1,1,0
23255,23255,23256,1,6,5
23256,23256,23257,6,9,3
23257,23257,23258,9,6,-3
23258,23258,23259,6,7,1
23259,23259,23260,7,7,0
23260,23260,23261,7,6,-1
23261,23261,23262,6,9,3
23262,23262,23263,9,8,-1
23263,23263,23264,8,5,-3
23264,23264,23265,5,3,-2
23265,23265,23266,3,9,6
23266,23266,23267,9,7,-2
23267,23267,23268,7,2,-5
23268,23268,23269,2,4,2
23269,23269,23270,4,4,0
23270,23270,23271,4,7,3
23271,23271,23272,7,4,-3
23272,23272,23273,4,0,-4
23273,23273,23274,0,4,4
23274,23274,23275,4,9,5
23275,23275,23276,9,4,-5
23276,23276,23277,4,0,-4
23277,23277,23278,0,9,9
23278,23278,23279,9,0,-9
23279,23279,23280,0,1,1
23280,23280,23281,1,3,2
23281,23281,23282,3,8,5
23282,23282,23283,8,7,-1
23283,23283,23284,7,6,-1
23284,23284,23285,6,9,3
23285,23285,23286,9,4,-5
23286,23286,23287,4,3,-1
23287,23287,23288,3,8,5
23288,23288,23289,8,0,-8
23289,23289,23290,0,1,1
23290,23290,23291,1,1,0
23291,23291,23292,1,7,6
23292,23292,23293,7,0,-7
23293,23293,23294,0,3,3
23294,23294,23295,3,1,-2
23295,23295,23296,1,8,7
23296,23296,23297,8,0,-8
23297,23297,23298,0,3,3
23298,23298,23299,3,4,1
23299,23299,23300,4,8,4
23300,23300,23301,8,0,-8
23301,23301,23302,0,1,1
23302,23302,23303,1,1,0
23303,23303,23304,1,3,2
23304,23304,23305,3,0,-3
23305,23305,23306,0,4,4
23306,23306,23307,4,4,0
23307,23307,23308,4,1,-3
23308,23308,23309,1,7,6
23309,23309,23310,7,2,-5
23310,23310,23311,2,9,7
23311,23311,23312,9,5,-4
23312,23312,23313,5,2,-3
23313,23313,23314,2,9,7
23314,23314,23315,9,0,-9
23315,23315,23316,0,8,8
23316,23316,23317,8,6,-2
23317,23317,23318,6,1,-5
23318,23318,23319,1,2,1
23319,23319,23320,2,3,1
23320,23320,23321,3,6,3
23321,23321,23322,6,3,-3
23322,23322,23323,3,2,-1
23323,23323,23324,2,5,3
23324,23324,23325,5,2,-3
23325,23325,23326,2,4,2
23326,23326,23327,4,9,5
23327,23327,23328,9,8,-1
23328,23328,23329,8,9,1
23329,23329,23330,9,2,-7
23330,23330,23331,2,0,-2
23331,23331,23332,0,5,5
23332,23332,23333,5,1,-4
23333,23333,23334,1,7,6
23334,23334,23335,7,2,-5
23335,23335,23336,2,5,3
23336,23336,23337,5,3,-2
23337,23337,23338,3,3,0
23338,23338,23339,3,4,1
23339,23339,23340,4,1,-3
23340,23340,23341,1,5,4
23341,23341,23342,5,1,-4
23342,23342,23343,1,6,5
23343,23343,23344,6,3,-3
23344,23344,23345,3,7,4
23345,23345,23346,7,6,-1
23346,23346,23347,6,8,2
23347,23347,23348,8,1,-7
23348,23348,23349,1,9,8
23349,23349,23350,9,8,-1
23350,23350,23351,8,0,-8
23351,23351,23352,0,7,7
23352,23352,23353,7,1,-6
23353,23353,23354,1,6,5
23354,23354,23355,6,2,-4
23355,23355,23356,2,6,4
23356,23356,23357,6,3,-3
23357,23357,23358,3,6,3
23358,23358,23359,6,4,-2
23359,23359,23360,4,7,3
23360,23360,23361,7,5,-2
23361,23361,23362,5,0,-5
23362,23362,23363,0,6,6
23363,23363,23364,6,2,-4
23364,23364,23365,2,9,7
23365,23365,23366,9,9,0
23366,23366,23367,9,0,-9
23367,23367,23368,0,8,8
23368,23368,23369,8,1,-7
23369,23369,23370,1,2,1
23370,23370,23371,2,2,0
23371,23371,23372,2,0,-2
23372,23372,23373,0,3,3
23373,23373,23374,3,9,6
23374,23374,23375,9,4,-5
23375,23375,23376,4,8,4
23376,23376,23377,8,5,-3
23377,23377,23378,5,0,-5
23378,23378,23379,0,6,6
23379,23379,23380,6,0,-6
23380,23380,23381,0,7,7
23381,23381,23382,7,1,-6
23382,23382,23383,1,8,7
23383,23383,23384,8,5,-3
23384,23384,23385,5,5,0
23385,23385,23386,5,7,2
23386,23386,23387,7,7,0
23387,23387,23388,7,7,0
23388,23388,23389,7,0,-7
23389,23389,23390,0,1,1
23390,23390,23391,1,8,7
23391,23391,23392,8,5,-3
23392,23392,23393,5,4,-1
23393,23393,23394,4,6,2
23394,23394,23395,6,0,-6
23395,23395,23396,0,1,1
23396,23396,23397,1,2,1
23397,23397,23398,2,8,6
23398,23398,23399,8,1,-7
23399,23399,23400,1,8,7
23400,23400,23401,8,0,-8
23401,23401,23402,0,7,7
23402,23402,23403,7,2,-5
23403,23403,23404,2,1,-1
23404,23404,23405,1,8,7
23405,23405,23406,8,4,-4
23406,23406,23407,4,5,1
23407,23407,23408,5,8,3
23408,23408,23409,8,4,-4
23409,23409,23410,4,2,-2
23410,23410,23411,2,4,2
23411,23411,23412,4,3,-1
23412,23412,23413,3,1,-2
23413,23413,23414,1,8,7
23414,23414,23415,8,6,-2
23415,23415,23416,6,6,0
23416,23416,23417,6,1,-5
23417,23417,23418,1,5,4
23418,23418,23419,5,3,-2
23419,23419,23420,3,9,6
23420,23420,23421,9,6,-3
23421,23421,23422,6,8,2
23422,23422,23423,8,9,1
23423,23423,23424,9,5,-4
23424,23424,23425,5,3,-2
23425,23425,23426,3,8,5
23426,23426,23427,8,7,-1
23427,23427,23428,7,8,1
23428,23428,23429,8,4,-4
23429,23429,23430,4,7,3
23430,23430,23431,7,9,2
23431,23431,23432,9,4,-5
23432,23432,23433,4,7,3
23433,23433,23434,7,5,-2
23434,23434,23435,5,4,-1
23435,23435,23436,4,8,4
23436,23436,23437,8,8,0
23437,23437,23438,8,5,-3
23438,23438,23439,5,3,-2
23439,23439,23440,3,8,5
23440,23440,23441,8,2,-6
23441,23441,23442,2,7,5
23442,23442,23443,7,7,0
23443,23443,23444,7,1,-6
23444,23444,23445,1,7,6
23445,23445,23446,7,9,2
23446,23446,23447,9,9,0
23447,23447,23448,9,8,-1
23448,23448,23449,8,5,-3
23449,23449,23450,5,6,1
23450,23450,23451,6,7,1
23451,23451,23452,7,5,-2
23452,23452,23453,5,6,1
23453,23453,23454,6,0,-6
23454,23454,23455,0,5,5
23455,23455,23456,5,8,3
23456,23456,23457,8,2,-6
23457,23457,23458,2,8,6
23458,23458,23459,8,4,-4
23459,23459,23460,4,2,-2
23460,23460,23461,2,8,6
23461,23461,23462,8,1,-7
23462,23462,23463,1,9,8
23463,23463,23464,9,0,-9
23464,23464,23465,0,6,6
23465,23465,23466,6,8,2
23466,23466,23467,8,9,1
23467,23467,23468,9,2,-7
23468,23468,23469,2,7,5
23469,23469,23470,7,1,-6
23470,23470,23471,1,6,5
23471,23471,23472,6,2,-4
23472,23472,23473,2,1,-1
23473,23473,23474,1,4,3
23474,23474,23475,4,6,2
23475,23475,23476,6,6,0
23476,23476,23477,6,1,-5
23477,23477,23478,1,4,3
23478,23478,23479,4,7,3
23479,23479,23480,7,9,2
23480,23480,23481,9,2,-7
23481,23481,23482,2,3,1
23482,23482,23483,3,3,0
23483,23483,23484,3,4,1
23484,23484,23485,4,6,2
23485,23485,23486,6,4,-2
23486,23486,23487,4,6,2
23487,23487,23488,6,3,-3
23488,23488,23489,3,6,3
23489,23489,23490,6,3,-3
23490,23490,23491,3,2,-1
23491,23491,23492,2,1,-1
23492,23492,23493,1,1,0
23493,23493,23494,1,2,1
23494,23494,23495,2,0,-2
23495,23495,23496,0,5,5
23496,23496,23497,5,5,0
23497,23497,23498,5,1,-4
23498,23498,23499,1,0,-1
23499,23499,23500,0,6,6
23500,23500,23501,6,1,-5
23501,23501,23502,1,9,8
23502,23502,23503,9,2,-7
23503,23503,23504,2,0,-2
23504,23504,23505,0,1,1
23505,23505,23506,1,0,-1
23506,23506,23507,0,7,7
23507,23507,23508,7,5,-2
23508,23508,23509,5,8,3
23509,23509,23510,8,8,0
23510,23510,23511,8,1,-7
23511,23511,23512,1,9,8
23512,23512,23513,9,4,-5
23513,23513,23514,4,5,1
23514,23514,23515,5,9,4
23515,23515,23516,9,5,-4
23516,23516,23517,5,3,-2
23517,23517,23518,3,5,2
23518,23518,23519,5,9,4
23519,23519,23520,9,2,-7
23520,23520,23521,2,0,-2
23521,23521,23522,0,8,8
23522,23522,23523,8,1,-7
23523,23523,23524,1,8,7
23524,23524,23525,8,2,-6
23525,23525,23526,2,7,5
23526,23526,23527,7,3,-4
23527,23527,23528,3,4,1
23528,23528,23529,4,4,0
23529,23529,23530,4,1,-3
23530,23530,23531,1,5,4
23531,23531,23532,5,1,-4
23532,23532,23533,1,6,5
23533,23533,23534,6,7,1
23534,23534,23535,7,7,0
23535,23535,23536,7,0,-7
23536,23536,23537,0,8,8
23537,23537,23538,8,4,-4
23538,23538,23539,4,9,5
23539,23539,23540,9,7,-2
23540,23540,23541,7,0,-7
23541,23541,23542,0,9,9
23542,23542,23543,9,1,-8
23543,23543,23544,1,5,4
23544,23544,23545,5,2,-3
23545,23545,23546,2,5,3
23546,23546,23547,5,3,-2
23547,23547,23548,3,9,6
23548,23548,23549,9,4,-5
23549,23549,23550,4,5,1
23550,23550,23551,5,7,2
23551,23551,23552,7,9,2
23552,23552,23553,9,8,-1
23553,23553,23554,8,1,-7
23554,23554,23555,1,9,8
23555,23555,23556,9,3,-6
23556,23556,23557,3,0,-3
23557,23557,23558,0,6,6
23558,23558,23559,6,1,-5
23559,23559,23560,1,8,7
23560,23560,23561,8,2,-6
23561,23561,23562,2,8,6
23562,23562,23563,8,3,-5
23563,23563,23564,3,2,-1
23564,23564,23565,2,4,2
23565,23565,23566,4,6,2
23566,23566,23567,6,5,-1
23567,23567,23568,5,5,0
23568,23568,23569,5,6,1
23569,23569,23570,6,7,1
23570,23570,23571,7,7,0
23571,23571,23572,7,3,-4
23572,23572,23573,3,8,5
23573,23573,23574,8,9,1
23574,23574,23575,9,9,0
23575,23575,23576,9,1,-8
23576,23576,23577,1,6,5
23577,23577,23578,6,2,-4
23578,23578,23579,2,0,-2
23579,23579,23580,0,4,4
23580,23580,23581,4,3,-1
23581,23581,23582,3,8,5
23582,23582,23583,8,4,-4
23583,23583,23584,4,2,-2
23584,23584,23585,2,1,-1
23585,23585,23586,1,0,-1
23586,23586,23587,0,4,4
23587,23587,23588,4,7,3
23588,23588,23589,7,0,-7
23589,23589,23590,0,7,7
23590,23590,23591,7,8,1
23591,23591,23592,8,4,-4
23592,23592,23593,4,6,2
23593,23593,23594,6,6,0
23594,23594,23595,6,4,-2
23595,23595,23596,4,4,0
23596,23596,23597,4,5,1
23597,23597,23598,5,0,-5
23598,23598,23599,0,4,4
23599,23599,23600,4,6,2
23600,23600,23601,6,0,-6
23601,23601,23602,0,8,8
23602,23602,23603,8,7,-1
23603,23603,23604,7,1,-6
23604,23604,23605,1,8,7
23605,23605,23606,8,0,-8
23606,23606,23607,0,7,7
23607,23607,23608,7,4,-3
23608,23608,23609,4,7,3
23609,23609,23610,7,2,-5
23610,23610,23611,2,9,7
23611,23611,23612,9,1,-8
23612,23612,23613,1,0,-1
23613,23613,23614,0,1,1
23614,23614,23615,1,4,3
23615,23615,23616,4,0,-4
23616,23616,23617,0,9,9
23617,23617,23618,9,4,-5
23618,23618,23619,4,9,5
23619,23619,23620,9,5,-4
23620,23620,23621,5,7,2
23621,23621,23622,7,6,-1
23622,23622,23623,6,4,-2
23623,23623,23624,4,9,5
23624,23624,23625,9,2,-7
23625,23625,23626,2,6,4
23626,23626,23627,6,0,-6
23627,23627,23628,0,6,6
23628,23628,23629,6,5,-1
23629,23629,23630,5,5,0
23630,23630,23631,5,8,3
23631,23631,23632,8,5,-3
23632,23632,23633,5,5,0
23633,23633,23634,5,3,-2
23634,23634,23635,3,9,6
23635,23635,23636,9,4,-5
23636,23636,23637,4,8,4
23637,23637,23638,8,9,1
23638,23638,23639,9,8,-1
23639,23639,23640,8,5,-3
23640,23640,23641,5,4,-1
23641,23641,23642,4,2,-2
23642,23642,23643,2,0,-2
23643,23643,23644,0,4,4
23644,23644,23645,4,7,3
23645,23645,23646,7,6,-1
23646,23646,23647,6,1,-5
23647,23647,23648,1,4,3
23648,23648,23649,4,3,-1
23649,23649,23650,3,8,5
23650,23650,23651,8,5,-3
23651,23651,23652,5,2,-3
23652,23652,23653,2,6,4
23653,23653,23654,6,6,0
23654,23654,23655,6,5,-1
23655,23655,23656,5,1,-4
23656,23656,23657,1,3,2
23657,23657,23658,3,4,1
23658,23658,23659,4,8,4
23659,23659,23660,8,1,-7
23660,23660,23661,1,7,6
23661,23661,23662,7,0,-7
23662,23662,23663,0,3,3
23663,23663,23664,3,4,1
23664,23664,23665,4,1,-3
23665,23665,23666,1,7,6
23666,23666,23667,7,6,-1
23667,23667,23668,6,5,-1
23668,23668,23669,5,8,3
23669,23669,23670,8,4,-4
23670,23670,23671,4,5,1
23671,23671,23672,5,3,-2
23672,23672,23673,3,9,6
23673,23673,23674,9,8,-1
23674,23674,23675,8,2,-6
23675,23675,23676,2,5,3
23676,23676,23677,5,2,-3
23677,23677,23678,2,7,5
23678,23678,23679,7,0,-7
23679,23679,23680,0,8,8
23680,23680,23681,8,9,1
23681,23681,23682,9,9,0
23682,23682,23683,9,2,-7
23683,23683,23684,2,7,5
23684,23684,23685,7,4,-3
23685,23685,23686,4,7,3
23686,23686,23687,7,6,-1
23687,23687,23688,6,6,0
23688,23688,23689,6,5,-1
23689,23689,23690,5,5,0
23690,23690,23691,5,2,-3
23691,23691,23692,2,4,2
23692,23692,23693,4,1,-3
23693,23693,23694,1,6,5
23694,23694,23695,6,3,-3
23695,23695,23696,3,4,1
23696,23696,23697,4,6,2
23697,23697,23698,6,7,1
23698,23698,23699,7,6,-1
23699,23699,23700,6,3,-3
23700,23700,23701,3,2,-1
23701,23701,23702,2,8,6
23702,23702,23703,8,1,-7
23703,23703,23704,1,7,6
23704,23704,23705,7,2,-5
23705,23705,23706,2,6,4
23706,23706,23707,6,6,0
23707,23707,23708,6,7,1
23708,23708,23709,7,0,-7
23709,23709,23710,0,9,9
23710,23710,23711,9,7,-2
23711,23711,23712,7,3,-4
23712,23712,23713,3,4,1
23713,23713,23714,4,4,0
23714,23714,23715,4,7,3
23715,23715,23716,7,2,-5
23716,23716,23717,2,8,6
23717,23717,23718,8,2,-6
23718,23718,23719,2,9,7
23719,23719,23720,9,6,-3
23720,23720,23721,6,2,-4
23721,23721,23722,2,5,3
23722,23722,23723,5,9,4
23723,23723,23724,9,3,-6
23724,23724,23725,3,5,2
23725,23725,23726,5,7,2
23726,23726,23727,7,1,-6
23727,23727,23728,1,0,-1
23728,23728,23729,0,8,8
23729,23729,23730,8,3,-5
23730,23730,23731,3,3,0
23731,23731,23732,3,9,6
23732,23732,23733,9,5,-4
23733,23733,23734,5,5,0
23734,23734,23735,5,6,1
23735,23735,23736,6,5,-1
23736,23736,23737,5,8,3
23737,23737,23738,8,9,1
23738,23738,23739,9,0,-9
23739,23739,23740,0,1,1
23740,23740,23741,1,0,-1
23741,23741,23742,0,6,6
23742,23742,23743,6,9,3
23743,23743,23744,9,9,0
23744,23744,23745,9,9,0
23745,23745,23746,9,5,-4
23746,23746,23747,5,3,-2
23747,23747,23748,3,9,6
23748,23748,23749,9,1,-8
23749,23749,23750,1,8,7
23750,23750,23751,8,1,-7
23751,23751,23752,1,7,6
23752,23752,23753,7,0,-7
23753,23753,23754,0,0,0
23754,23754,23755,0,1,1
23755,23755,23756,1,1,0
23756,23756,23757,1,2,1
23757,23757,23758,2,6,4
23758,23758,23759,6,3,-3
23759,23759,23760,3,7,4
23760,23760,23761,7,4,-3
23761,23761,23762,4,1,-3
23762,23762,23763,1,5,4
23763,23763,23764,5,2,-3
23764,23764,23765,2,6,4
23765,23765,23766,6,6,0
23766,23766,23767,6,7,1
23767,23767,23768,7,8,1
23768,23768,23769,8,8,0
23769,23769,23770,8,2,-6
23770,23770,23771,2,9,7
23771,23771,23772,9,9,0
23772,23772,23773,9,0,-9
23773,23773,23774,0,6,6
23774,23774,23775,6,1,-5
23775,23775,23776,1,2,1
23776,23776,23777,2,2,0
23777,23777,23778,2,3,1
23778,23778,23779,3,3,0
23779,23779,23780,3,6,3
23780,23780,23781,6,4,-2
23781,23781,23782,4,7,3
23782,23782,23783,7,5,-2
23783,23783,23784,5,7,2
23784,23784,23785,7,6,-1
23785,23785,23786,6,0,-6
23786,23786,23787,0,7,7
23787,23787,23788,7,1,-6
23788,23788,23789,1,8,7
23789,23789,23790,8,6,-2
23790,23790,23791,6,9,3
23791,23791,23792,9,5,-4
23792,23792,23793,5,0,-5
23793,23793,23794,0,2,2
23794,23794,23795,2,1,-1
23795,23795,23796,1,3,2
23796,23796,23797,3,2,-1
23797,23797,23798,2,7,5
23798,23798,23799,7,3,-4
23799,23799,23800,3,2,-1
23800,23800,23801,2,4,2
23801,23801,23802,4,7,3
23802,23802,23803,7,7,0
23803,23803,23804,7,8,1
23804,23804,23805,8,8,0
23805,23805,23806,8,5,-3
23806,23806,23807,5,9,4
23807,23807,23808,9,5,-4
23808,23808,23809,5,0,-5
23809,23809,23810,0,3,3
23810,23810,23811,3,7,4
23811,23811,23812,7,3,-4
23812,23812,23813,3,0,-3
23813,23813,23814,0,2,2
23814,23814,23815,2,7,5
23815,23815,23816,7,9,2
23816,23816,23817,9,8,-1
23817,23817,23818,8,1,-7
23818,23818,23819,1,3,2
23819,23819,23820,3,3,0
23820,23820,23821,3,0,-3
23821,23821,23822,0,1,1
23822,23822,23823,1,0,-1
23823,23823,23824,0,5,5
23824,23824,23825,5,5,0
23825,23825,23826,5,2,-3
23826,23826,23827,2,5,3
23827,23827,23828,5,0,-5
23828,23828,23829,0,3,3
23829,23829,23830,3,6,3
23830,23830,23831,6,8,2
23831,23831,23832,8,5,-3
23832,23832,23833,5,8,3
23833,23833,23834,8,4,-4
23834,23834,23835,4,1,-3
23835,23835,23836,1,5,4
23836,23836,23837,5,4,-1
23837,23837,23838,4,9,5
23838,23838,23839,9,6,-3
23839,23839,23840,6,7,1
23840,23840,23841,7,1,-6
23841,23841,23842,1,0,-1
23842,23842,23843,0,8,8
23843,23843,23844,8,1,-7
23844,23844,23845,1,0,-1
23845,23845,23846,0,2,2
23846,23846,23847,2,2,0
23847,23847,23848,2,8,6
23848,23848,23849,8,7,-1
23849,23849,23850,7,6,-1
23850,23850,23851,6,3,-3
23851,23851,23852,3,1,-2
23852,23852,23853,1,9,8
23853,23853,23854,9,1,-8
23854,23854,23855,1,4,3
23855,23855,23856,4,0,-4
23856,23856,23857,0,1,1
23857,23857,23858,1,5,4
23858,23858,23859,5,2,-3
23859,23859,23860,2,3,1
23860,23860,23861,3,5,2
23861,23861,23862,5,1,-4
23862,23862,23863,1,9,8
23863,23863,23864,9,9,0
23864,23864,23865,9,8,-1
23865,23865,23866,8,3,-5
23866,23866,23867,3,9,6
23867,23867,23868,9,9,0
23868,23868,23869,9,5,-4
23869,23869,23870,5,5,0
23870,23870,23871,5,4,-1
23871,23871,23872,4,1,-3
23872,23872,23873,1,3,2
23873,23873,23874,3,5,2
23874,23874,23875,5,0,-5
23875,23875,23876,0,9,9
23876,23876,23877,9,3,-6
23877,23877,23878,3,4,1
23878,23878,23879,4,3,-1
23879,23879,23880,3,9,6
23880,23880,23881,9,4,-5
23881,23881,23882,4,0,-4
23882,23882,23883,0,7,7
23883,23883,23884,7,0,-7
23884,23884,23885,0,1,1
23885,23885,23886,1,1,0
23886,23886,23887,1,2,1
23887,23887,23888,2,3,1
23888,23888,23889,3,1,-2
23889,23889,23890,1,8,7
23890,23890,23891,8,0,-8
23891,23891,23892,0,1,1
23892,23892,23893,1,6,5
23893,23893,23894,6,2,-4
23894,23894,23895,2,2,0
23895,23895,23896,2,4,2
23896,23896,23897,4,3,-1
23897,23897,23898,3,6,3
23898,23898,23899,6,8,2
23899,23899,23900,8,6,-2
23900,23900,23901,6,9,3
23901,23901,23902,9,7,-2
23902,23902,23903,7,5,-2
23903,23903,23904,5,4,-1
23904,23904,23905,4,6,2
23905,23905,23906,6,5,-1
23906,23906,23907,5,6,1
23907,23907,23908,6,1,-5
23908,23908,23909,1,7,6
23909,23909,23910,7,1,-6
23910,23910,23911,1,1,0
23911,23911,23912,1,5,4
23912,23912,23913,5,4,-1
23913,23913,23914,4,0,-4
23914,23914,23915,0,6,6
23915,23915,23916,6,2,-4
23916,23916,23917,2,2,0
23917,23917,23918,2,5,3
23918,23918,23919,5,9,4
23919,23919,23920,9,5,-4
23920,23920,23921,5,1,-4
23921,23921,23922,1,6,5
23922,23922,23923,6,5,-1
23923,23923,23924,5,6,1
23924,23924,23925,6,5,-1
23925,23925,23926,5,0,-5
23926,23926,23927,0,5,5
23927,23927,23928,5,5,0
23928,23928,23929,5,3,-2
23929,23929,23930,3,8,5
23930,23930,23931,8,1,-7
23931,23931,23932,1,7,6
23932,23932,23933,7,4,-3
23933,23933,23934,4,2,-2
23934,23934,23935,2,8,6
23935,23935,23936,8,4,-4
23936,23936,23937,4,6,2
23937,23937,23938,6,5,-1
23938,23938,23939,5,3,-2
23939,23939,23940,3,0,-3
23940,23940,23941,0,7,7
23941,23941,23942,7,2,-5
23942,23942,23943,2,0,-2
23943,23943,23944,0,9,9
23944,23944,23945,9,9,0
23945,23945,23946,9,7,-2
23946,23946,23947,7,5,-2
23947,23947,23948,5,8,3
23948,23948,23949,8,6,-2
23949,23949,23950,6,9,3
23950,23950,23951,9,7,-2
23951,23951,23952,7,2,-5
23952,23952,23953,2,1,-1
23953,23953,23954,1,1,0
23954,23954,23955,1,3,2
23955,23955,23956,3,4,1
23956,23956,23957,4,2,-2
23957,23957,23958,2,6,4
23958,23958,23959,6,6,0
23959,23959,23960,6,1,-5
23960,23960,23961,1,2,1
23961,23961,23962,2,3,1
23962,23962,23963,3,6,3
23963,23963,23964,6,8,2
23964,23964,23965,8,7,-1
23965,23965,23966,7,8,1
23966,23966,23967,8,8,0
23967,23967,23968,8,7,-1
23968,23968,23969,7,7,0
23969,23969,23970,7,1,-6
23970,23970,23971,1,0,-1
23971,23971,23972,0,5,5
23972,23972,23973,5,1,-4
23973,23973,23974,1,4,3
23974,23974,23975,4,2,-2
23975,23975,23976,2,9,7
23976,23976,23977,9,3,-6
23977,23977,23978,3,7,4
23978,23978,23979,7,4,-3
23979,23979,23980,4,0,-4
23980,23980,23981,0,5,5
23981,23981,23982,5,2,-3
23982,23982,23983,2,6,4
23983,23983,23984,6,1,-5
23984,23984,23985,1,7,6
23985,23985,23986,7,3,-4
23986,23986,23987,3,8,5
23987,23987,23988,8,0,-8
23988,23988,23989,0,9,9
23989,23989,23990,9,9,0
23990,23990,23991,9,0,-9
23991,23991,23992,0,4,4
23992,23992,23993,4,1,-3
23993,23993,23994,1,2,1
23994,23994,23995,2,2,0
23995,23995,23996,2,5,3
23996,23996,23997,5,3,-2
23997,23997,23998,3,9,6
23998,23998,23999,9,4,-5
23999,23999,24000,4,8,4
24000,24000,24001,8,5,-3
24001,24001,24002,5,8,3
24002,24002,24003,8,6,-2
24003,24003,24004,6,5,-1
24004,24004,24005,5,7,2
24005,24005,24006,7,9,2
24006,24006,24007,9,8,-1
24007,24007,24008,8,7,-1
24008,24008,24009,7,9,2
24009,24009,24010,9,2,-7
24010,24010,24011,2,0,-2
24011,24011,24012,0,2,2
24012,24012,24013,2,1,-1
24013,24013,24014,1,2,1
24014,24014,24015,2,2,0
24015,24015,24016,2,6,4
24016,24016,24017,6,3,-3
24017,24017,24018,3,4,1
24018,24018,24019,4,4,0
24019,24019,24020,4,1,-3
24020,24020,24021,1,5,4
24021,24021,24022,5,7,2
24022,24022,24023,7,6,-1
24023,24023,24024,6,0,-6
24024,24024,24025,0,7,7
24025,24025,24026,7,8,1
24026,24026,24027,8,8,0
24027,24027,24028,8,3,-5
24028,24028,24029,3,9,6
24029,24029,24030,9,6,-3
24030,24030,24031,6,6,0
24031,24031,24032,6,4,-2
24032,24032,24033,4,4,0
24033,24033,24034,4,0,-4
24034,24034,24035,0,2,2
24035,24035,24036,2,2,0
24036,24036,24037,2,6,4
24037,24037,24038,6,1,-5
24038,24038,24039,1,4,3
24039,24039,24040,4,7,3
24040,24040,24041,7,7,0
24041,24041,24042,7,3,-4
24042,24042,24043,3,5,2
24043,24043,24044,5,7,2
24044,24044,24045,7,5,-2
24045,24045,24046,5,8,3
24046,24046,24047,8,4,-4
24047,24047,24048,4,8,4
24048,24048,24049,8,7,-1
24049,24049,24050,7,2,-5
24050,24050,24051,2,8,6
24051,24051,24052,8,4,-4
24052,24052,24053,4,9,5
24053,24053,24054,9,9,0
24054,24054,24055,9,2,-7
24055,24055,24056,2,5,3
24056,24056,24057,5,9,4
24057,24057,24058,9,6,-3
24058,24058,24059,6,3,-3
24059,24059,24060,3,2,-1
24060,24060,24061,2,9,7
24061,24061,24062,9,9,0
24062,24062,24063,9,3,-6
24063,24063,24064,3,7,4
24064,24064,24065,7,8,1
24065,24065,24066,8,3,-5
24066,24066,24067,3,2,-1
24067,24067,24068,2,5,3
24068,24068,24069,5,0,-5
24069,24069,24070,0,1,1
24070,24070,24071,1,9,8
24071,24071,24072,9,0,-9
24072,24072,24073,0,8,8
24073,24073,24074,8,6,-2
24074,24074,24075,6,0,-6
24075,24075,24076,0,4,4
24076,24076,24077,4,5,1
24077,24077,24078,5,0,-5
24078,24078,24079,0,6,6
24079,24079,24080,6,1,-5
24080,24080,24081,1,0,-1
24081,24081,24082,0,9,9
24082,24082,24083,9,1,-8
24083,24083,24084,1,4,3
24084,24084,24085,4,0,-4
24085,24085,24086,0,1,1
24086,24086,24087,1,4,3
24087,24087,24088,4,7,3
24088,24088,24089,7,2,-5
24089,24089,24090,2,1,-1
24090,24090,24091,1,6,5
24091,24091,24092,6,9,3
24092,24092,24093,9,5,-4
24093,24093,24094,5,7,2
24094,24094,24095,7,3,-4
24095,24095,24096,3,2,-1
24096,24096,24097,2,5,3
24097,24097,24098,5,2,-3
24098,24098,24099,2,3,1
24099,24099,24100,3,5,2
24100,24100,24101,5,8,3
24101,24101,24102,8,1,-7
24102,24102,24103,1,0,-1
24103,24103,24104,0,3,3
24104,24104,24105,3,0,-3
24105,24105,24106,0,5,5
24106,24106,24107,5,5,0
24107,24107,24108,5,8,3
24108,24108,24109,8,4,-4
24109,24109,24110,4,8,4
24110,24110,24111,8,3,-5
24111,24111,24112,3,8,5
24112,24112,24113,8,4,-4
24113,24113,24114,4,4,0
24114,24114,24115,4,1,-3
24115,24115,24116,1,2,1
24116,24116,24117,2,5,3
24117,24117,24118,5,2,-3
24118,24118,24119,2,3,1
24119,24119,24120,3,4,1
24120,24120,24121,4,0,-4
24121,24121,24122,0,1,1
24122,24122,24123,1,8,7
24123,24123,24124,8,2,-6
24124,24124,24125,2,3,1
24125,24125,24126,3,1,-2
24126,24126,24127,1,6,5
24127,24127,24128,6,5,-1
24128,24128,24129,5,2,-3
24129,24129,24130,2,8,6
24130,24130,24131,8,7,-1
24131,24131,24132,7,3,-4
24132,24132,24133,3,1,-2
24133,24133,24134,1,8,7
24134,24134,24135,8,1,-7
24135,24135,24136,1,1,0
24136,24136,24137,1,8,7
24137,24137,24138,8,7,-1
24138,24138,24139,7,1,-6
24139,24139,24140,1,7,6
24140,24140,24141,7,7,0
24141,24141,24142,7,3,-4
24142,24142,24143,3,1,-2
24143,24143,24144,1,3,2
24144,24144,24145,3,3,0
24145,24145,24146,3,6,3
24146,24146,24147,6,8,2
24147,24147,24148,8,0,-8
24148,24148,24149,0,5,5
24149,24149,24150,5,8,3
24150,24150,24151,8,0,-8
24151,24151,24152,0,2,2
24152,24152,24153,2,9,7
24153,24153,24154,9,4,-5
24154,24154,24155,4,7,3
24155,24155,24156,7,9,2
24156,24156,24157,9,6,-3
24157,24157,24158,6,6,0
24158,24158,24159,6,7,1
24159,24159,24160,7,8,1
24160,24160,24161,8,4,-4
24161,24161,24162,4,6,2
24162,24162,24163,6,1,-5
24163,24163,24164,1,9,8
24164,24164,24165,9,6,-3
24165,24165,24166,6,5,-1
24166,24166,24167,5,8,3
24167,24167,24168,8,1,-7
24168,24168,24169,1,4,3
24169,24169,24170,4,5,1
24170,24170,24171,5,7,2
24171,24171,24172,7,7,0
24172,24172,24173,7,5,-2
24173,24173,24174,5,4,-1
24174,24174,24175,4,1,-3
24175,24175,24176,1,3,2
24176,24176,24177,3,2,-1
24177,24177,24178,2,9,7
24178,24178,24179,9,6,-3
24179,24179,24180,6,5,-1
24180,24180,24181,5,7,2
24181,24181,24182,7,2,-5
24182,24182,24183,2,1,-1
24183,24183,24184,1,6,5
24184,24184,24185,6,9,3
24185,24185,24186,9,7,-2
24186,24186,24187,7,8,1
24187,24187,24188,8,0,-8
24188,24188,24189,0,0,0
24189,24189,24190,0,8,8
24190,24190,24191,8,6,-2
24191,24191,24192,6,4,-2
24192,24192,24193,4,9,5
24193,24193,24194,9,9,0
24194,24194,24195,9,4,-5
24195,24195,24196,4,3,-1
24196,24196,24197,3,9,6
24197,24197,24198,9,2,-7
24198,24198,24199,2,9,7
24199,24199,24200,9,7,-2
24200,24200,24201,7,6,-1
24201,24201,24202,6,5,-1
24202,24202,24203,5,2,-3
24203,24203,24204,2,3,1
24204,24204,24205,3,3,0
24205,24205,24206,3,2,-1
24206,24206,24207,2,7,5
24207,24207,24208,7,1,-6
24208,24208,24209,1,1,0
24209,24209,24210,1,9,8
24210,24210,24211,9,9,0
24211,24211,24212,9,0,-9
24212,24212,24213,0,2,2
24213,24213,24214,2,6,4
24214,24214,24215,6,2,-4
24215,24215,24216,2,1,-1
24216,24216,24217,1,5,4
24217,24217,24218,5,3,-2
24218,24218,24219,3,3,0
24219,24219,24220,3,6,3
24220,24220,24221,6,7,1
24221,24221,24222,7,1,-6
24222,24222,24223,1,8,7
24223,24223,24224,8,6,-2
24224,24224,24225,6,0,-6
24225,24225,24226,0,2,2
24226,24226,24227,2,1,-1
24227,24227,24228,1,7,6
24228,24228,24229,7,2,-5
24229,24229,24230,2,9,7
24230,24230,24231,9,3,-6
24231,24231,24232,3,5,2
24232,24232,24233,5,4,-1
24233,24233,24234,4,8,4
24234,24234,24235,8,5,-3
24235,24235,24236,5,7,2
24236,24236,24237,7,6,-1
24237,24237,24238,6,2,-4
24238,24238,24239,2,7,5
24239,24239,24240,7,8,1
24240,24240,24241,8,8,0
24241,24241,24242,8,6,-2
24242,24242,24243,6,9,3
24243,24243,24244,9,4,-5
24244,24244,24245,4,0,-4
24245,24245,24246,0,9,9
24246,24246,24247,9,1,-8
24247,24247,24248,1,3,2
24248,24248,24249,3,2,-1
24249,24249,24250,2,5,3
24250,24250,24251,5,3,-2
24251,24251,24252,3,5,2
24252,24252,24253,5,4,-1
24253,24253,24254,4,7,3
24254,24254,24255,7,5,-2
24255,24255,24256,5,8,3
24256,24256,24257,8,6,-2
24257,24257,24258,6,4,-2
24258,24258,24259,4,7,3
24259,24259,24260,7,7,0
24260,24260,24261,7,8,1
24261,24261,24262,8,4,-4
24262,24262,24263,4,9,5
24263,24263,24264,9,3,-6
24264,24264,24265,3,0,-3
24265,24265,24266,0,6,6
24266,24266,24267,6,1,-5
24267,24267,24268,1,0,-1
24268,24268,24269,0,2,2
24269,24269,24270,2,9,7
24270,24270,24271,9,3,-6
24271,24271,24272,3,4,1
24272,24272,24273,4,4,0
24273,24273,24274,4,4,0
24274,24274,24275,4,5,1
24275,24275,24276,5,0,-5
24276,24276,24277,0,6,6
24277,24277,24278,6,3,-3
24278,24278,24279,3,1,-2
24279,24279,24280,1,7,6
24280,24280,24281,7,3,-4
24281,24281,24282,3,4,1
24282,24282,24283,4,5,1
24283,24283,24284,5,3,-2
24284,24284,24285,3,9,6
24285,24285,24286,9,6,-3
24286,24286,24287,6,4,-2
24287,24287,24288,4,1,-3
24288,24288,24289,1,1,0
24289,24289,24290,1,2,1
24290,24290,24291,2,7,5
24291,24291,24292,7,4,-3
24292,24292,24293,4,1,-3
24293,24293,24294,1,3,2
24294,24294,24295,3,4,1
24295,24295,24296,4,4,0
24296,24296,24297,4,8,4
24297,24297,24298,8,4,-4
24298,24298,24299,4,3,-1
24299,24299,24300,3,9,6
24300,24300,24301,9,8,-1
24301,24301,24302,8,4,-4
24302,24302,24303,4,2,-2
24303,24303,24304,2,6,4
24304,24304,24305,6,9,3
24305,24305,24306,9,1,-8
24306,24306,24307,1,3,2
24307,24307,24308,3,0,-3
24308,24308,24309,0,8,8
24309,24309,24310,8,5,-3
24310,24310,24311,5,8,3
24311,24311,24312,8,8,0
24312,24312,24313,8,9,1
24313,24313,24314,9,7,-2
24314,24314,24315,7,7,0
24315,24315,24316,7,4,-3
24316,24316,24317,4,5,1
24317,24317,24318,5,5,0
24318,24318,24319,5,9,4
24319,24319,24320,9,0,-9
24320,24320,24321,0,2,2
24321,24321,24322,2,1,-1
24322,24322,24323,1,5,4
24323,24323,24324,5,5,0
24324,24324,24325,5,7,2
24325,24325,24326,7,3,-4
24326,24326,24327,3,4,1
24327,24327,24328,4,1,-3
24328,24328,24329,1,1,0
24329,24329,24330,1,5,4
24330,24330,24331,5,2,-3
24331,24331,24332,2,5,3
24332,24332,24333,5,3,-2
24333,24333,24334,3,4,1
24334,24334,24335,4,5,1
24335,24335,24336,5,3,-2
24336,24336,24337,3,9,6
24337,24337,24338,9,3,-6
24338,24338,24339,3,1,-2
24339,24339,24340,1,4,3
24340,24340,24341,4,1,-3
24341,24341,24342,1,6,5
24342,24342,24343,6,0,-6
24343,24343,24344,0,8,8
24344,24344,24345,8,0,-8
24345,24345,24346,0,0,0
24346,24346,24347,0,2,2
24347,24347,24348,2,0,-2
24348,24348,24349,0,8,8
24349,24349,24350,8,3,-5
24350,24350,24351,3,7,4
24351,24351,24352,7,1,-6
24352,24352,24353,1,5,4
24353,24353,24354,5,3,-2
24354,24354,24355,3,1,-2
24355,24355,24356,1,3,2
24356,24356,24357,3,1,-2
24357,24357,24358,1,3,2
24358,24358,24359,3,8,5
24359,24359,24360,8,2,-6
24360,24360,24361,2,5,3
24361,24361,24362,5,7,2
24362,24362,24363,7,6,-1
24363,24363,24364,6,7,1
24364,24364,24365,7,4,-3
24365,24365,24366,4,1,-3
24366,24366,24367,1,0,-1
24367,24367,24368,0,1,1
24368,24368,24369,1,3,2
24369,24369,24370,3,8,5
24370,24370,24371,8,0,-8
24371,24371,24372,0,7,7
24372,24372,24373,7,3,-4
24373,24373,24374,3,5,2
24374,24374,24375,5,7,2
24375,24375,24376,7,1,-6
24376,24376,24377,1,6,5
24377,24377,24378,6,4,-2
24378,24378,24379,4,9,5
24379,24379,24380,9,6,-3
24380,24380,24381,6,2,-4
24381,24381,24382,2,7,5
24382,24382,24383,7,6,-1
24383,24383,24384,6,7,1
24384,24384,24385,7,6,-1
24385,24385,24386,6,3,-3
24386,24386,24387,3,9,6
24387,24387,24388,9,0,-9
24388,24388,24389,0,0,0
24389,24389,24390,0,2,2
24390,24390,24391,2,4,2
24391,24391,24392,4,6,2
24392,24392,24393,6,0,-6
24393,24393,24394,0,5,5
24394,24394,24395,5,6,1
24395,24395,24396,6,8,2
24396,24396,24397,8,1,-7
24397,24397,24398,1,9,8
24398,24398,24399,9,0,-9
24399,24399,24400,0,3,3
24400,24400,24401,3,9,6
24401,24401,24402,9,5,-4
24402,24402,24403,5,5,0
24403,24403,24404,5,8,3
24404,24404,24405,8,1,-7
24405,24405,24406,1,2,1
24406,24406,24407,2,3,1
24407,24407,24408,3,5,2
24408,24408,24409,5,7,2
24409,24409,24410,7,8,1
24410,24410,24411,8,6,-2
24411,24411,24412,6,7,1
24412,24412,24413,7,9,2
24413,24413,24414,9,3,-6
24414,24414,24415,3,7,4
24415,24415,24416,7,8,1
24416,24416,24417,8,3,-5
24417,24417,24418,3,2,-1
24418,24418,24419,2,0,-2
24419,24419,24420,0,9,9
24420,24420,24421,9,5,-4
24421,24421,24422,5,8,3
24422,24422,24423,8,6,-2
24423,24423,24424,6,1,-5
24424,24424,24425,1,2,1
24425,24425,24426,2,5,3
24426,24426,24427,5,2,-3
24427,24427,24428,2,6,4
24428,24428,24429,6,0,-6
24429,24429,24430,0,2,2
24430,24430,24431,2,1,-1
24431,24431,24432,1,4,3
24432,24432,24433,4,2,-2
24433,24433,24434,2,7,5
24434,24434,24435,7,3,-4
24435,24435,24436,3,1,-2
24436,24436,24437,1,4,3
24437,24437,24438,4,6,2
24438,24438,24439,6,5,-1
24439,24439,24440,5,0,-5
24440,24440,24441,0,6,6
24441,24441,24442,6,3,-3
24442,24442,24443,3,7,4
24443,24443,24444,7,0,-7
24444,24444,24445,0,0,0
24445,24445,24446,0,3,3
24446,24446,24447,3,1,-2
24447,24447,24448,1,3,2
24448,24448,24449,3,2,-1
24449,24449,24450,2,2,0
24450,24450,24451,2,3,1
24451,24451,24452,3,3,0
24452,24452,24453,3,6,3
24453,24453,24454,6,9,3
24454,24454,24455,9,7,-2
24455,24455,24456,7,4,-3
24456,24456,24457,4,8,4
24457,24457,24458,8,6,-2
24458,24458,24459,6,9,3
24459,24459,24460,9,8,-1
24460,24460,24461,8,1,-7
24461,24461,24462,1,2,1
24462,24462,24463,2,0,-2
24463,24463,24464,0,7,7
24464,24464,24465,7,1,-6
24465,24465,24466,1,1,0
24466,24466,24467,1,2,1
24467,24467,24468,2,9,7
24468,24468,24469,9,3,-6
24469,24469,24470,3,1,-2
24470,24470,24471,1,4,3
24471,24471,24472,4,4,0
24472,24472,24473,4,5,1
24473,24473,24474,5,6,1
24474,24474,24475,6,6,0
24475,24475,24476,6,0,-6
24476,24476,24477,0,7,7
24477,24477,24478,7,9,2
24478,24478,24479,9,8,-1
24479,24479,24480,8,0,-8
24480,24480,24481,0,3,3
24481,24481,24482,3,9,6
24482,24482,24483,9,1,-8
24483,24483,24484,1,2,1
24484,24484,24485,2,2,0
24485,24485,24486,2,6,4
24486,24486,24487,6,1,-5
24487,24487,24488,1,6,5
24488,24488,24489,6,9,3
24489,24489,24490,9,5,-4
24490,24490,24491,5,2,-3
24491,24491,24492,2,5,3
24492,24492,24493,5,4,-1
24493,24493,24494,4,9,5
24494,24494,24495,9,0,-9
24495,24495,24496,0,9,9
24496,24496,24497,9,9,0
24497,24497,24498,9,8,-1
24498,24498,24499,8,9,1
24499,24499,24500,9,7,-2
24500,24500,24501,7,3,-4
24501,24501,24502,3,7,4
24502,24502,24503,7,7,0
24503,24503,24504,7,5,-2
24504,24504,24505,5,7,2
24505,24505,24506,7,4,-3
24506,24506,24507,4,9,5
24507,24507,24508,9,9,0
24508,24508,24509,9,1,-8
24509,24509,24510,1,0,-1
24510,24510,24511,0,4,4
24511,24511,24512,4,3,-1
24512,24512,24513,3,2,-1
24513,24513,24514,2,4,2
24514,24514,24515,4,7,3
24515,24515,24516,7,5,-2
24516,24516,24517,5,2,-3
24517,24517,24518,2,7,5
24518,24518,24519,7,5,-2
24519,24519,24520,5,2,-3
24520,24520,24521,2,8,6
24521,24521,24522,8,6,-2
24522,24522,24523,6,6,0
24523,24523,24524,6,3,-3
24524,24524,24525,3,0,-3
24525,24525,24526,0,6,6
24526,24526,24527,6,4,-2
24527,24527,24528,4,3,-1
24528,24528,24529,3,0,-3
24529,24529,24530,0,4,4
24530,24530,24531,4,3,-1
24531,24531,24532,3,3,0
24532,24532,24533,3,8,5
24533,24533,24534,8,8,0
24534,24534,24535,8,1,-7
24535,24535,24536,1,1,0
24536,24536,24537,1,0,-1
24537,24537,24538,0,9,9
24538,24538,24539,9,3,-6
24539,24539,24540,3,7,4
24540,24540,24541,7,0,-7
24541,24541,24542,0,4,4
24542,24542,24543,4,4,0
24543,24543,24544,4,7,3
24544,24544,24545,7,7,0
24545,24545,24546,7,2,-5
24546,24546,24547,2,4,2
24547,24547,24548,4,7,3
24548,24548,24549,7,9,2
24549,24549,24550,9,7,-2
24550,24550,24551,7,2,-5
24551,24551,24552,2,2,0
24552,24552,24553,2,9,7
24553,24553,24554,9,6,-3
24554,24554,24555,6,1,-5
24555,24555,24556,1,9,8
24556,24556,24557,9,2,-7
24557,24557,24558,2,8,6
24558,24558,24559,8,5,-3
24559,24559,24560,5,3,-2
24560,24560,24561,3,7,4
24561,24561,24562,7,8,1
24562,24562,24563,8,1,-7
24563,24563,24564,1,1,0
24564,24564,24565,1,7,6
24565,24565,24566,7,9,2
24566,24566,24567,9,1,-8
24567,24567,24568,1,7,6
24568,24568,24569,7,6,-1
24569,24569,24570,6,2,-4
24570,24570,24571,2,7,5
24571,24571,24572,7,7,0
24572,24572,24573,7,3,-4
24573,24573,24574,3,5,2
24574,24574,24575,5,3,-2
24575,24575,24576,3,6,3
24576,24576,24577,6,6,0
24577,24577,24578,6,8,2
24578,24578,24579,8,5,-3
24579,24579,24580,5,1,-4
24580,24580,24581,1,6,5
24581,24581,24582,6,2,-4
24582,24582,24583,2,7,5
24583,24583,24584,7,3,-4
24584,24584,24585,3,6,3
24585,24585,24586,6,8,2
24586,24586,24587,8,8,0
24587,24587,24588,8,9,1
24588,24588,24589,9,8,-1
24589,24589,24590,8,4,-4
24590,24590,24591,4,2,-2
24591,24591,24592,2,6,4
24592,24592,24593,6,9,3
24593,24593,24594,9,9,0
24594,24594,24595,9,5,-4
24595,24595,24596,5,9,4
24596,24596,24597,9,3,-6
24597,24597,24598,3,8,5
24598,24598,24599,8,7,-1
24599,24599,24600,7,8,1
24600,24600,24601,8,4,-4
24601,24601,24602,4,2,-2
24602,24602,24603,2,3,1
24603,24603,24604,3,4,1
24604,24604,24605,4,0,-4
24605,24605,24606,0,1,1
24606,24606,24607,1,4,3
24607,24607,24608,4,5,1
24608,24608,24609,5,6,1
24609,24609,24610,6,3,-3
24610,24610,24611,3,6,3
24611,24611,24612,6,2,-4
24612,24612,24613,2,9,7
24613,24613,24614,9,5,-4
24614,24614,24615,5,0,-5
24615,24615,24616,0,6,6
24616,24616,24617,6,1,-5
24617,24617,24618,1,2,1
24618,24618,24619,2,1,-1
24619,24619,24620,1,9,8
24620,24620,24621,9,3,-6
24621,24621,24622,3,6,3
24622,24622,24623,6,2,-4
24623,24623,24624,2,1,-1
24624,24624,24625,1,1,0
24625,24625,24626,1,1,0
24626,24626,24627,1,0,-1
24627,24627,24628,0,1,1
24628,24628,24629,1,0,-1
24629,24629,24630,0,5,5
24630,24630,24631,5,1,-4
24631,24631,24632,1,2,1
24632,24632,24633,2,2,0
24633,24633,24634,2,1,-1
24634,24634,24635,1,3,2
24635,24635,24636,3,0,-3
24636,24636,24637,0,4,4
24637,24637,24638,4,6,2
24638,24638,24639,6,7,1
24639,24639,24640,7,0,-7
24640,24640,24641,0,8,8
24641,24641,24642,8,4,-4
24642,24642,24643,4,9,5
24643,24643,24644,9,7,-2
24644,24644,24645,7,0,-7
24645,24645,24646,0,8,8
24646,24646,24647,8,1,-7
24647,24647,24648,1,4,3
24648,24648,24649,4,2,-2
24649,24649,24650,2,5,3
24650,24650,24651,5,3,-2
24651,24651,24652,3,7,4
24652,24652,24653,7,4,-3
24653,24653,24654,4,8,4
24654,24654,24655,8,7,-1
24655,24655,24656,7,6,-1
24656,24656,24657,6,8,2
24657,24657,24658,8,8,0
24658,24658,24659,8,9,1
24659,24659,24660,9,5,-4
24660,24660,24661,5,0,-5
24661,24661,24662,0,7,7
24662,24662,24663,7,1,-6
24663,24663,24664,1,8,7
24664,24664,24665,8,2,-6
24665,24665,24666,2,5,3
24666,24666,24667,5,3,-2
24667,24667,24668,3,4,1
24668,24668,24669,4,4,0
24669,24669,24670,4,7,3
24670,24670,24671,7,5,-2
24671,24671,24672,5,3,-2
24672,24672,24673,3,6,3
24673,24673,24674,6,2,-4
24674,24674,24675,2,7,5
24675,24675,24676,7,0,-7
24676,24676,24677,0,8,8
24677,24677,24678,8,1,-7
24678,24678,24679,1,8,7
24679,24679,24680,8,3,-5
24680,24680,24681,3,0,-3
24681,24681,24682,0,7,7
24682,24682,24683,7,5,-2
24683,24683,24684,5,9,4
24684,24684,24685,9,6,-3
24685,24685,24686,6,8,2
24686,24686,24687,8,6,-2
24687,24687,24688,6,1,-5
24688,24688,24689,1,0,-1
24689,24689,24690,0,2,2
24690,24690,24691,2,8,6
24691,24691,24692,8,7,-1
24692,24692,24693,7,0,-7
24693,24693,24694,0,9,9
24694,24694,24695,9,2,-7
24695,24695,24696,2,0,-2
24696,24696,24697,0,3,3
24697,24697,24698,3,0,-3
24698,24698,24699,0,7,7
24699,24699,24700,7,7,0
24700,24700,24701,7,9,2
24701,24701,24702,9,7,-2
24702,24702,24703,7,4,-3
24703,24703,24704,4,9,5
24704,24704,24705,9,7,-2
24705,24705,24706,7,0,-7
24706,24706,24707,0,1,1
24707,24707,24708,1,5,4
24708,24708,24709,5,7,2
24709,24709,24710,7,1,-6
24710,24710,24711,1,1,0
24711,24711,24712,1,9,8
24712,24712,24713,9,4,-5
24713,24713,24714,4,1,-3
24714,24714,24715,1,0,-1
24715,24715,24716,0,5,5
24716,24716,24717,5,0,-5
24717,24717,24718,0,5,5
24718,24718,24719,5,4,-1
24719,24719,24720,4,8,4
24720,24720,24721,8,1,-7
24721,24721,24722,1,2,1
24722,24722,24723,2,7,5
24723,24723,24724,7,2,-5
24724,24724,24725,2,5,3
24725,24725,24726,5,6,1
24726,24726,24727,6,7,1
24727,24727,24728,7,2,-5
24728,24728,24729,2,1,-1
24729,24729,24730,1,5,4
24730,24730,24731,5,3,-2
24731,24731,24732,3,2,-1
24732,24732,24733,2,3,1
24733,24733,24734,3,4,1
24734,24734,24735,4,3,-1
24735,24735,24736,3,9,6
24736,24736,24737,9,1,-8
24737,24737,24738,1,1,0
24738,24738,24739,1,6,5
24739,24739,24740,6,8,2
24740,24740,24741,8,9,1
24741,24741,24742,9,7,-2
24742,24742,24743,7,7,0
24743,24743,24744,7,4,-3
24744,24744,24745,4,4,0
24745,24745,24746,4,2,-2
24746,24746,24747,2,3,1
24747,24747,24748,3,3,0
24748,24748,24749,3,0,-3
24749,24749,24750,0,6,6
24750,24750,24751,6,2,-4
24751,24751,24752,2,2,0
24752,24752,24753,2,6,4
24753,24753,24754,6,6,0
24754,24754,24755,6,0,-6
24755,24755,24756,0,9,9
24756,24756,24757,9,8,-1
24757,24757,24758,8,4,-4
24758,24758,24759,4,9,5
24759,24759,24760,9,8,-1
24760,24760,24761,8,4,-4
24761,24761,24762,4,1,-3
24762,24762,24763,1,3,2
24763,24763,24764,3,6,3
24764,24764,24765,6,5,-1
24765,24765,24766,5,4,-1
24766,24766,24767,4,4,0
24767,24767,24768,4,8,4
24768,24768,24769,8,8,0
24769,24769,24770,8,3,-5
24770,24770,24771,3,1,-2
24771,24771,24772,1,3,2
24772,24772,24773,3,5,2
24773,24773,24774,5,6,1
24774,24774,24775,6,9,3
24775,24775,24776,9,0,-9
24776,24776,24777,0,0,0
24777,24777,24778,0,5,5
24778,24778,24779,5,6,1
24779,24779,24780,6,3,-3
24780,24780,24781,3,4,1
24781,24781,24782,4,1,-3
24782,24782,24783,1,3,2
24783,24783,24784,3,3,0
24784,24784,24785,3,6,3
24785,24785,24786,6,2,-4
24786,24786,24787,2,3,1
24787,24787,24788,3,7,4
24788,24788,24789,7,3,-4
24789,24789,24790,3,2,-1
24790,24790,24791,2,8,6
24791,24791,24792,8,5,-3
24792,24792,24793,5,1,-4
24793,24793,24794,1,2,1
24794,24794,24795,2,4,2
24795,24795,24796,4,2,-2
24796,24796,24797,2,7,5
24797,24797,24798,7,4,-3
24798,24798,24799,4,5,1
24799,24799,24800,5,1,-4
24800,24800,24801,1,7,6
24801,24801,24802,7,6,-1
24802,24802,24803,6,2,-4
24803,24803,24804,2,6,4
24804,24804,24805,6,2,-4
24805,24805,24806,2,8,6
24806,24806,24807,8,0,-8
24807,24807,24808,0,1,1
24808,24808,24809,1,0,-1
24809,24809,24810,0,4,4
24810,24810,24811,4,1,-3
24811,24811,24812,1,5,4
24812,24812,24813,5,7,2
24813,24813,24814,7,1,-6
24814,24814,24815,1,7,6
24815,24815,24816,7,7,0
24816,24816,24817,7,9,2
24817,24817,24818,9,7,-2
24818,24818,24819,7,5,-2
24819,24819,24820,5,5,0
24820,24820,24821,5,9,4
24821,24821,24822,9,4,-5
24822,24822,24823,4,8,4
24823,24823,24824,8,1,-7
24824,24824,24825,1,9,8
24825,24825,24826,9,8,-1
24826,24826,24827,8,6,-2
24827,24827,24828,6,0,-6
24828,24828,24829,0,8,8
24829,24829,24830,8,7,-1
24830,24830,24831,7,8,1
24831,24831,24832,8,6,-2
24832,24832,24833,6,2,-4
24833,24833,24834,2,1,-1
24834,24834,24835,1,3,2
24835,24835,24836,3,2,-1
24836,24836,24837,2,6,4
24837,24837,24838,6,1,-5
24838,24838,24839,1,1,0
24839,24839,24840,1,0,-1
24840,24840,24841,0,2,2
24841,24841,24842,2,0,-2
24842,24842,24843,0,9,9
24843,24843,24844,9,2,-7
24844,24844,24845,2,8,6
24845,24845,24846,8,0,-8
24846,24846,24847,0,5,5
24847,24847,24848,5,1,-4
24848,24848,24849,1,2,1
24849,24849,24850,2,3,1
24850,24850,24851,3,6,3
24851,24851,24852,6,8,2
24852,24852,24853,8,2,-6
24853,24853,24854,2,5,3
24854,24854,24855,5,4,-1
24855,24855,24856,4,0,-4
24856,24856,24857,0,8,8
24857,24857,24858,8,0,-8
24858,24858,24859,0,5,5
24859,24859,24860,5,9,4
24860,24860,24861,9,0,-9
24861,24861,24862,0,2,2
24862,24862,24863,2,1,-1
24863,24863,24864,1,5,4
24864,24864,24865,5,2,-3
24865,24865,24866,2,4,2
24866,24866,24867,4,3,-1
24867,24867,24868,3,3,0
24868,24868,24869,3,4,1
24869,24869,24870,4,3,-1
24870,24870,24871,3,6,3
24871,24871,24872,6,0,-6
24872,24872,24873,0,7,7
24873,24873,24874,7,4,-3
24874,24874,24875,4,8,4
24875,24875,24876,8,2,-6
24876,24876,24877,2,0,-2
24877,24877,24878,0,7,7
24878,24878,24879,7,1,-6
24879,24879,24880,1,4,3
24880,24880,24881,4,2,-2
24881,24881,24882,2,7,5
24882,24882,24883,7,3,-4
24883,24883,24884,3,7,4
24884,24884,24885,7,4,-3
24885,24885,24886,4,3,-1
24886,24886,24887,3,5,2
24887,24887,24888,5,1,-4
24888,24888,24889,1,8,7
24889,24889,24890,8,5,-3
24890,24890,24891,5,9,4
24891,24891,24892,9,0,-9
24892,24892,24893,0,0,0
24893,24893,24894,0,4,4
24894,24894,24895,4,1,-3
24895,24895,24896,1,0,-1
24896,24896,24897,0,2,2
24897,24897,24898,2,9,7
24898,24898,24899,9,3,-6
24899,24899,24900,3,1,-2
24900,24900,24901,1,4,3
24901,24901,24902,4,9,5
24902,24902,24903,9,5,-4
24903,24903,24904,5,1,-4
24904,24904,24905,1,6,5
24905,24905,24906,6,3,-3
24906,24906,24907,3,7,4
24907,24907,24908,7,5,-2
24908,24908,24909,5,8,3
24909,24909,24910,8,5,-3
24910,24910,24911,5,9,4
24911,24911,24912,9,4,-5
24912,24912,24913,4,0,-4
24913,24913,24914,0,9,9
24914,24914,24915,9,1,-8
24915,24915,24916,1,9,8
24916,24916,24917,9,7,-2
24917,24917,24918,7,1,-6
24918,24918,24919,1,9,8
24919,24919,24920,9,9,0
24920,24920,24921,9,5,-4
24921,24921,24922,5,4,-1
24922,24922,24923,4,1,-3
24923,24923,24924,1,1,0
24924,24924,24925,1,8,7
24925,24925,24926,8,8,0
24926,24926,24927,8,9,1
24927,24927,24928,9,7,-2
24928,24928,24929,7,4,-3
24929,24929,24930,4,1,-3
24930,24930,24931,1,3,2
24931,24931,24932,3,1,-2
24932,24932,24933,1,1,0
24933,24933,24934,1,6,5
24934,24934,24935,6,7,1
24935,24935,24936,7,9,2
24936,24936,24937,9,8,-1
24937,24937,24938,8,7,-1
24938,24938,24939,7,2,-5
24939,24939,24940,2,0,-2
24940,24940,24941,0,4,4
24941,24941,24942,4,9,5
24942,24942,24943,9,3,-6
24943,24943,24944,3,6,3
24944,24944,24945,6,6,0
24945,24945,24946,6,9,3
24946,24946,24947,9,9,0
24947,24947,24948,9,6,-3
24948,24948,24949,6,9,3
24949,24949,24950,9,8,-1
24950,24950,24951,8,5,-3
24951,24951,24952,5,0,-5
24952,24952,24953,0,8,8
24953,24953,24954,8,8,0
24954,24954,24955,8,6,-2
24955,24955,24956,6,9,3
24956,24956,24957,9,6,-3
24957,24957,24958,6,1,-5
24958,24958,24959,1,8,7
24959,24959,24960,8,5,-3
24960,24960,24961,5,2,-3
24961,24961,24962,2,0,-2
24962,24962,24963,0,6,6
24963,24963,24964,6,7,1
24964,24964,24965,7,3,-4
24965,24965,24966,3,1,-2
24966,24966,24967,1,9,8
24967,24967,24968,9,2,-7
24968,24968,24969,2,3,1
24969,24969,24970,3,1,-2
24970,24970,24971,1,2,1
24971,24971,24972,2,2,0
24972,24972,24973,2,1,-1
24973,24973,24974,1,1,0
24974,24974,24975,1,7,6
24975,24975,24976,7,4,-3
24976,24976,24977,4,4,0
24977,24977,24978,4,0,-4
24978,24978,24979,0,8,8
24979,24979,24980,8,4,-4
24980,24980,24981,4,8,4
24981,24981,24982,8,2,-6
24982,24982,24983,2,9,7
24983,24983,24984,9,7,-2
24984,24984,24985,7,0,-7
24985,24985,24986,0,4,4
24986,24986,24987,4,3,-1
24987,24987,24988,3,0,-3
24988,24988,24989,0,3,3
24989,24989,24990,3,7,4
24990,24990,24991,7,9,2
24991,24991,24992,9,4,-5
24992,24992,24993,4,0,-4
24993,24993,24994,0,7,7
24994,24994,24995,7,5,-2
24995,24995,24996,5,1,-4
24996,24996,24997,1,2,1
24997,24997,24998,2,9,7
24998,24998,24999,9,9,0
24999,24999,25000,9,3,-6
25000,25000,25001,3,4,1
25001,25001,25002,4,5,1
25002,25002,25003,5,1,-4
25003,25003,25004,1,2,1
25004,25004,25005,2,0,-2
25005,25005,25006,0,4,4
25006,25006,25007,4,3,-1
25007,25007,25008,3,8,5
25008,25008,25009,8,7,-1
25009,25009,25010,7,6,-1
25010,25010,25011,6,7,1
25011,25011,25012,7,8,1
25012,25012,25013,8,7,-1
25013,25013,25014,7,4,-3
25014,25014,25015,4,8,4
25015,25015,25016,8,8,0
25016,25016,25017,8,2,-6
25017,25017,25018,2,8,6
25018,25018,25019,8,9,1
25019,25019,25020,9,2,-7
25020,25020,25021,2,7,5
25021,25021,25022,7,0,-7
25022,25022,25023,0,5,5
25023,25023,25024,5,0,-5
25024,25024,25025,0,5,5
25025,25025,25026,5,7,2
25026,25026,25027,7,1,-6
25027,25027,25028,1,3,2
25028,25028,25029,3,2,-1
25029,25029,25030,2,6,4
25030,25030,25031,6,6,0
25031,25031,25032,6,3,-3
25032,25032,25033,3,3,0
25033,25033,25034,3,3,0
25034,25034,25035,3,6,3
25035,25035,25036,6,1,-5
25036,25036,25037,1,6,5
25037,25037,25038,6,2,-4
25038,25038,25039,2,0,-2
25039,25039,25040,0,3,3
25040,25040,25041,3,2,-1
25041,25041,25042,2,1,-1
25042,25042,25043,1,8,7
25043,25043,25044,8,9,1
25044,25044,25045,9,1,-8
25045,25045,25046,1,9,8
25046,25046,25047,9,6,-3
25047,25047,25048,6,4,-2
25048,25048,25049,4,1,-3
25049,25049,25050,1,4,3
25050,25050,25051,4,0,-4
25051,25051,25052,0,1,1
25052,25052,25053,1,4,3
25053,25053,25054,4,1,-3
25054,25054,25055,1,3,2
25055,25055,25056,3,4,1
25056,25056,25057,4,1,-3
25057,25057,25058,1,7,6
25058,25058,25059,7,6,-1
25059,25059,25060,6,7,1
25060,25060,25061,7,1,-6
25061,25061,25062,1,7,6
25062,25062,25063,7,9,2
25063,25063,25064,9,1,-8
25064,25064,25065,1,0,-1
25065,25065,25066,0,5,5
25066,25066,25067,5,1,-4
25067,25067,25068,1,6,5
25068,25068,25069,6,2,-4
25069,25069,25070,2,7,5
25070,25070,25071,7,3,-4
25071,25071,25072,3,8,5
25072,25072,25073,8,4,-4
25073,25073,25074,4,8,4
25074,25074,25075,8,5,-3
25075,25075,25076,5,6,1
25076,25076,25077,6,6,0
25077,25077,25078,6,3,-3
25078,25078,25079,3,7,4
25079,25079,25080,7,5,-2
25080,25080,25081,5,8,3
25081,25081,25082,8,0,-8
25082,25082,25083,0,9,9
25083,25083,25084,9,5,-4
25084,25084,25085,5,0,-5
25085,25085,25086,0,4,4
25086,25086,25087,4,1,-3
25087,25087,25088,1,2,1
25088,25088,25089,2,2,0
25089,25089,25090,2,6,4
25090,25090,25091,6,3,-3
25091,25091,25092,3,0,-3
25092,25092,25093,0,4,4
25093,25093,25094,4,3,-1
25094,25094,25095,3,7,4
25095,25095,25096,7,5,-2
25096,25096,25097,5,8,3
25097,25097,25098,8,6,-2
25098,25098,25099,6,9,3
25099,25099,25100,9,4,-5
25100,25100,25101,4,0,-4
25101,25101,25102,0,6,6
25102,25102,25103,6,1,-5
25103,25103,25104,1,6,5
25104,25104,25105,6,2,-4
25105,25105,25106,2,3,1
25106,25106,25107,3,3,0
25107,25107,25108,3,6,3
25108,25108,25109,6,4,-2
25109,25109,25110,4,7,3
25110,25110,25111,7,5,-2
25111,25111,25112,5,1,-4
25112,25112,25113,1,6,5
25113,25113,25114,6,4,-2
25114,25114,25115,4,7,3
25115,25115,25116,7,3,-4
25116,25116,25117,3,8,5
25117,25117,25118,8,1,-7
25118,25118,25119,1,9,8
25119,25119,25120,9,8,-1
25120,25120,25121,8,7,-1
25121,25121,25122,7,2,-5
25122,25122,25123,2,7,5
25123,25123,25124,7,1,-6
25124,25124,25125,1,7,6
25125,25125,25126,7,7,0
25126,25126,25127,7,3,-4
25127,25127,25128,3,7,4
25128,25128,25129,7,1,-6
25129,25129,25130,1,7,6
25130,25130,25131,7,8,1
25131,25131,25132,8,8,0
25132,25132,25133,8,7,-1
25133,25133,25134,7,9,2
25134,25134,25135,9,6,-3
25135,25135,25136,6,2,-4
25136,25136,25137,2,0,-2
25137,25137,25138,0,2,2
25138,25138,25139,2,2,0
25139,25139,25140,2,7,5
25140,25140,25141,7,6,-1
25141,25141,25142,6,6,0
25142,25142,25143,6,8,2
25143,25143,25144,8,5,-3
25144,25144,25145,5,3,-2
25145,25145,25146,3,8,5
25146,25146,25147,8,2,-6
25147,25147,25148,2,2,0
25148,25148,25149,2,8,6
25149,25149,25150,8,2,-6
25150,25150,25151,2,1,-1
25151,25151,25152,1,0,-1
25152,25152,25153,0,1,1
25153,25153,25154,1,4,3
25154,25154,25155,4,7,3
25155,25155,25156,7,2,-5
25156,25156,25157,2,2,0
25157,25157,25158,2,5,3
25158,25158,25159,5,0,-5
25159,25159,25160,0,7,7
25160,25160,25161,7,7,0
25161,25161,25162,7,4,-3
25162,25162,25163,4,1,-3
25163,25163,25164,1,3,2
25164,25164,25165,3,6,3
25165,25165,25166,6,0,-6
25166,25166,25167,0,0,0
25167,25167,25168,0,9,9
25168,25168,25169,9,4,-5
25169,25169,25170,4,4,0
25170,25170,25171,4,6,2
25171,25171,25172,6,3,-3
25172,25172,25173,3,4,1
25173,25173,25174,4,3,-1
25174,25174,25175,3,4,1
25175,25175,25176,4,4,0
25176,25176,25177,4,5,1
25177,25177,25178,5,5,0
25178,25178,25179,5,8,3
25179,25179,25180,8,4,-4
25180,25180,25181,4,0,-4
25181,25181,25182,0,4,4
25182,25182,25183,4,6,2
25183,25183,25184,6,4,-2
25184,25184,25185,4,2,-2
25185,25185,25186,2,8,6
25186,25186,25187,8,3,-5
25187,25187,25188,3,4,1
25188,25188,25189,4,1,-3
25189,25189,25190,1,5,4
25190,25190,25191,5,3,-2
25191,25191,25192,3,5,2
25192,25192,25193,5,6,1
25193,25193,25194,6,4,-2
25194,25194,25195,4,8,4
25195,25195,25196,8,1,-7
25196,25196,25197,1,4,3
25197,25197,25198,4,5,1
25198,25198,25199,5,0,-5
25199,25199,25200,0,7,7
25200,25200,25201,7,7,0
25201,25201,25202,7,1,-6
25202,25202,25203,1,5,4
25203,25203,25204,5,6,1
25204,25204,25205,6,8,2
25205,25205,25206,8,0,-8
25206,25206,25207,0,8,8
25207,25207,25208,8,3,-5
25208,25208,25209,3,3,0
25209,25209,25210,3,3,0
25210,25210,25211,3,7,4
25211,25211,25212,7,9,2
25212,25212,25213,9,8,-1
25213,25213,25214,8,0,-8
25214,25214,25215,0,9,9
25215,25215,25216,9,9,0
25216,25216,25217,9,2,-7
25217,25217,25218,2,4,2
25218,25218,25219,4,6,2
25219,25219,25220,6,2,-4
25220,25220,25221,2,2,0
25221,25221,25222,2,3,1
25222,25222,25223,3,5,2
25223,25223,25224,5,9,4
25224,25224,25225,9,3,-6
25225,25225,25226,3,6,3
25226,25226,25227,6,1,-5
25227,25227,25228,1,8,7
25228,25228,25229,8,7,-1
25229,25229,25230,7,1,-6
25230,25230,25231,1,3,2
25231,25231,25232,3,8,5
25232,25232,25233,8,9,1
25233,25233,25234,9,4,-5
25234,25234,25235,4,1,-3
25235,25235,25236,1,8,7
25236,25236,25237,8,9,1
25237,25237,25238,9,2,-7
25238,25238,25239,2,9,7
25239,25239,25240,9,5,-4
25240,25240,25241,5,6,1
25241,25241,25242,6,7,1
25242,25242,25243,7,0,-7
25243,25243,25244,0,1,1
25244,25244,25245,1,3,2
25245,25245,25246,3,2,-1
25246,25246,25247,2,9,7
25247,25247,25248,9,9,0
25248,25248,25249,9,2,-7
25249,25249,25250,2,8,6
25250,25250,25251,8,8,0
25251,25251,25252,8,0,-8
25252,25252,25253,0,1,1
25253,25253,25254,1,8,7
25254,25254,25255,8,4,-4
25255,25255,25256,4,8,4
25256,25256,25257,8,3,-5
25257,25257,25258,3,9,6
25258,25258,25259,9,5,-4
25259,25259,25260,5,4,-1
25260,25260,25261,4,2,-2
25261,25261,25262,2,8,6
25262,25262,25263,8,9,1
25263,25263,25264,9,1,-8
25264,25264,25265,1,2,1
25265,25265,25266,2,3,1
25266,25266,25267,3,9,6
25267,25267,25268,9,1,-8
25268,25268,25269,1,1,0
25269,25269,25270,1,6,5
25270,25270,25271,6,6,0
25271,25271,25272,6,2,-4
25272,25272,25273,2,5,3
25273,25273,25274,5,1,-4
25274,25274,25275,1,8,7
25275,25275,25276,8,8,0
25276,25276,25277,8,9,1
25277,25277,25278,9,0,-9
25278,25278,25279,0,4,4
25279,25279,25280,4,9,5
25280,25280,25281,9,2,-7
25281,25281,25282,2,3,1
25282,25282,25283,3,5,2
25283,25283,25284,5,3,-2
25284,25284,25285,3,0,-3
25285,25285,25286,0,7,7
25286,25286,25287,7,1,-6
25287,25287,25288,1,4,3
25288,25288,25289,4,2,-2
25289,25289,25290,2,0,-2
25290,25290,25291,0,3,3
25291,25291,25292,3,4,1
25292,25292,25293,4,4,0
25293,25293,25294,4,2,-2
25294,25294,25295,2,5,3
25295,25295,25296,5,3,-2
25296,25296,25297,3,6,3
25297,25297,25298,6,9,3
25298,25298,25299,9,7,-2
25299,25299,25300,7,7,0
25300,25300,25301,7,8,1
25301,25301,25302,8,1,-7
25302,25302,25303,1,9,8
25303,25303,25304,9,0,-9
25304,25304,25305,0,0,0
25305,25305,25306,0,6,6
25306,25306,25307,6,1,-5
25307,25307,25308,1,7,6
25308,25308,25309,7,2,-5
25309,25309,25310,2,1,-1
25310,25310,25311,1,3,2
25311,25311,25312,3,0,-3
25312,25312,25313,0,4,4
25313,25313,25314,4,7,3
25314,25314,25315,7,5,-2
25315,25315,25316,5,6,1
25316,25316,25317,6,6,0
25317,25317,25318,6,2,-4
25318,25318,25319,2,7,5
25319,25319,25320,7,8,1
25320,25320,25321,8,8,0
25321,25321,25322,8,1,-7
25322,25322,25323,1,9,8
25323,25323,25324,9,1,-8
25324,25324,25325,1,0,-1
25325,25325,25326,0,8,8
25326,25326,25327,8,1,-7
25327,25327,25328,1,3,2
25328,25328,25329,3,2,-1
25329,25329,25330,2,5,3
25330,25330,25331,5,3,-2
25331,25331,25332,3,2,-1
25332,25332,25333,2,4,2
25333,25333,25334,4,4,0
25334,25334,25335,4,5,1
25335,25335,25336,5,1,-4
25336,25336,25337,1,6,5
25337,25337,25338,6,6,0
25338,25338,25339,6,7,1
25339,25339,25340,7,6,-1
25340,25340,25341,6,8,2
25341,25341,25342,8,5,-3
25342,25342,25343,5,9,4
25343,25343,25344,9,0,-9
25344,25344,25345,0,6,6
25345,25345,25346,6,3,-3
25346,25346,25347,3,4,1
25347,25347,25348,4,7,3
25348,25348,25349,7,2,-5
25349,25349,25350,2,7,5
25350,25350,25351,7,6,-1
25351,25351,25352,6,1,-5
25352,25352,25353,1,4,3
25353,25353,25354,4,1,-3
25354,25354,25355,1,7,6
25355,25355,25356,7,5,-2
25356,25356,25357,5,5,0
25357,25357,25358,5,6,1
25358,25358,25359,6,5,-1
25359,25359,25360,5,8,3
25360,25360,25361,8,4,-4
25361,25361,25362,4,8,4
25362,25362,25363,8,7,-1
25363,25363,25364,7,1,-6
25364,25364,25365,1,8,7
25365,25365,25366,8,0,-8
25366,25366,25367,0,9,9
25367,25367,25368,9,6,-3
25368,25368,25369,6,2,-4
25369,25369,25370,2,7,5
25370,25370,25371,7,9,2
25371,25371,25372,9,9,0
25372,25372,25373,9,3,-6
25373,25373,25374,3,6,3
25374,25374,25375,6,9,3
25375,25375,25376,9,9,0
25376,25376,25377,9,3,-6
25377,25377,25378,3,4,1
25378,25378,25379,4,8,4
25379,25379,25380,8,4,-4
25380,25380,25381,4,2,-2
25381,25381,25382,2,4,2
25382,25382,25383,4,0,-4
25383,25383,25384,0,5,5
25384,25384,25385,5,9,4
25385,25385,25386,9,0,-9
25386,25386,25387,0,8,8
25387,25387,25388,8,8,0
25388,25388,25389,8,0,-8
25389,25389,25390,0,0,0
25390,25390,25391,0,5,5
25391,25391,25392,5,7,2
25392,25392,25393,7,6,-1
25393,25393,25394,6,1,-5
25394,25394,25395,1,0,-1
25395,25395,25396,0,4,4
25396,25396,25397,4,1,-3
25397,25397,25398,1,3,2
25398,25398,25399,3,0,-3
25399,25399,25400,0,8,8
25400,25400,25401,8,4,-4
25401,25401,25402,4,5,1
25402,25402,25403,5,2,-3
25403,25403,25404,2,9,7
25404,25404,25405,9,6,-3
25405,25405,25406,6,2,-4
25406,25406,25407,2,5,3
25407,25407,25408,5,0,-5
25408,25408,25409,0,3,3
25409,25409,25410,3,4,1
25410,25410,25411,4,5,1
25411,25411,25412,5,2,-3
25412,25412,25413,2,3,1
25413,25413,25414,3,1,-2
25414,25414,25415,1,8,7
25415,25415,25416,8,1,-7
25416,25416,25417,1,3,2
25417,25417,25418,3,8,5
25418,25418,25419,8,4,-4
25419,25419,25420,4,0,-4
25420,25420,25421,0,1,1
25421,25421,25422,1,6,5
25422,25422,25423,6,5,-1
25423,25423,25424,5,6,1
25424,25424,25425,6,3,-3
25425,25425,25426,3,7,4
25426,25426,25427,7,0,-7
25427,25427,25428,0,1,1
25428,25428,25429,1,8,7
25429,25429,25430,8,6,-2
25430,25430,25431,6,3,-3
25431,25431,25432,3,9,6
25432,25432,25433,9,0,-9
25433,25433,25434,0,1,1
25434,25434,25435,1,6,5
25435,25435,25436,6,1,-5
25436,25436,25437,1,2,1
25437,25437,25438,2,4,2
25438,25438,25439,4,7,3
25439,25439,25440,7,5,-2
25440,25440,25441,5,1,-4
25441,25441,25442,1,2,1
25442,25442,25443,2,1,-1
25443,25443,25444,1,7,6
25444,25444,25445,7,8,1
25445,25445,25446,8,9,1
25446,25446,25447,9,1,-8
25447,25447,25448,1,1,0
25448,25448,25449,1,7,6
25449,25449,25450,7,1,-6
25450,25450,25451,1,1,0
25451,25451,25452,1,7,6
25452,25452,25453,7,3,-4
25453,25453,25454,3,3,0
25454,25454,25455,3,8,5
25455,25455,25456,8,0,-8
25456,25456,25457,0,5,5
25457,25457,25458,5,7,2
25458,25458,25459,7,2,-5
25459,25459,25460,2,0,-2
25460,25460,25461,0,0,0
25461,25461,25462,0,6,6
25462,25462,25463,6,9,3
25463,25463,25464,9,8,-1
25464,25464,25465,8,7,-1
25465,25465,25466,7,5,-2
25466,25466,25467,5,6,1
25467,25467,25468,6,5,-1
25468,25468,25469,5,7,2
25469,25469,25470,7,4,-3
25470,25470,25471,4,4,0
25471,25471,25472,4,9,5
25472,25472,25473,9,1,-8
25473,25473,25474,1,1,0
25474,25474,25475,1,6,5
25475,25475,25476,6,2,-4
25476,25476,25477,2,8,6
25477,25477,25478,8,9,1
25478,25478,25479,9,4,-5
25479,25479,25480,4,3,-1
25480,25480,25481,3,7,4
25481,25481,25482,7,8,1
25482,25482,25483,8,5,-3
25483,25483,25484,5,4,-1
25484,25484,25485,4,1,-3
25485,25485,25486,1,8,7
25486,25486,25487,8,2,-6
25487,25487,25488,2,4,2
25488,25488,25489,4,6,2
25489,25489,25490,6,4,-2
25490,25490,25491,4,7,3
25491,25491,25492,7,2,-5
25492,25492,25493,2,9,7
25493,25493,25494,9,5,-4
25494,25494,25495,5,8,3
25495,25495,25496,8,1,-7
25496,25496,25497,1,0,-1
25497,25497,25498,0,4,4
25498,25498,25499,4,6,2
25499,25499,25500,6,7,1
25500,25500,25501,7,9,2
25501,25501,25502,9,9,0
25502,25502,25503,9,4,-5
25503,25503,25504,4,1,-3
25504,25504,25505,1,6,5
25505,25505,25506,6,7,1
25506,25506,25507,7,2,-5
25507,25507,25508,2,5,3
25508,25508,25509,5,3,-2
25509,25509,25510,3,2,-1
25510,25510,25511,2,7,5
25511,25511,25512,7,0,-7
25512,25512,25513,0,1,1
25513,25513,25514,1,8,7
25514,25514,25515,8,9,1
25515,25515,25516,9,2,-7
25516,25516,25517,2,2,0
25517,25517,25518,2,0,-2
25518,25518,25519,0,2,2
25519,25519,25520,2,6,4
25520,25520,25521,6,5,-1
25521,25521,25522,5,7,2
25522,25522,25523,7,3,-4
25523,25523,25524,3,1,-2
25524,25524,25525,1,7,6
25525,25525,25526,7,2,-5
25526,25526,25527,2,8,6
25527,25527,25528,8,9,1
25528,25528,25529,9,0,-9
25529,25529,25530,0,2,2
25530,25530,25531,2,1,-1
25531,25531,25532,1,9,8
25532,25532,25533,9,2,-7
25533,25533,25534,2,4,2
25534,25534,25535,4,3,-1
25535,25535,25536,3,3,0
25536,25536,25537,3,1,-2
25537,25537,25538,1,3,2
25538,25538,25539,3,5,2
25539,25539,25540,5,1,-4
25540,25540,25541,1,6,5
25541,25541,25542,6,0,-6
25542,25542,25543,0,7,7
25543,25543,25544,7,8,1
25544,25544,25545,8,8,0
25545,25545,25546,8,8,0
25546,25546,25547,8,0,-8
25547,25547,25548,0,2,2
25548,25548,25549,2,1,-1
25549,25549,25550,1,4,3
25550,25550,25551,4,2,-2
25551,25551,25552,2,3,1
25552,25552,25553,3,3,0
25553,25553,25554,3,7,4
25554,25554,25555,7,4,-3
25555,25555,25556,4,8,4
25556,25556,25557,8,5,-3
25557,25557,25558,5,4,-1
25558,25558,25559,4,6,2
25559,25559,25560,6,5,-1
25560,25560,25561,5,7,2
25561,25561,25562,7,9,2
25562,25562,25563,9,8,-1
25563,25563,25564,8,2,-6
25564,25564,25565,2,9,7
25565,25565,25566,9,5,-4
25566,25566,25567,5,0,-5
25567,25567,25568,0,8,8
25568,25568,25569,8,1,-7
25569,25569,25570,1,2,1
25570,25570,25571,2,2,0
25571,25571,25572,2,6,4
25572,25572,25573,6,3,-3
25573,25573,25574,3,2,-1
25574,25574,25575,2,4,2
25575,25575,25576,4,0,-4
25576,25576,25577,0,5,5
25577,25577,25578,5,7,2
25578,25578,25579,7,6,-1
25579,25579,25580,6,5,-1
25580,25580,25581,5,7,2
25581,25581,25582,7,8,1
25582,25582,25583,8,8,0
25583,25583,25584,8,0,-8
25584,25584,25585,0,9,9
25585,25585,25586,9,3,-6
25586,25586,25587,3,8,5
25587,25587,25588,8,5,-3
25588,25588,25589,5,9,4
25589,25589,25590,9,3,-6
25590,25590,25591,3,2,-1
25591,25591,25592,2,8,6
25592,25592,25593,8,6,-2
25593,25593,25594,6,7,1
25594,25594,25595,7,1,-6
25595,25595,25596,1,1,0
25596,25596,25597,1,7,6
25597,25597,25598,7,5,-2
25598,25598,25599,5,6,1
25599,25599,25600,6,1,-5
25600,25600,25601,1,3,2
25601,25601,25602,3,4,1
25602,25602,25603,4,5,1
25603,25603,25604,5,4,-1
25604,25604,25605,4,4,0
25605,25605,25606,4,1,-3
25606,25606,25607,1,8,7
25607,25607,25608,8,6,-2
25608,25608,25609,6,2,-4
25609,25609,25610,2,7,5
25610,25610,25611,7,6,-1
25611,25611,25612,6,4,-2
25612,25612,25613,4,4,0
25613,25613,25614,4,6,2
25614,25614,25615,6,7,1
25615,25615,25616,7,4,-3
25616,25616,25617,4,2,-2
25617,25617,25618,2,2,0
25618,25618,25619,2,3,1
25619,25619,25620,3,8,5
25620,25620,25621,8,4,-4
25621,25621,25622,4,5,1
25622,25622,25623,5,5,0
25623,25623,25624,5,9,4
25624,25624,25625,9,9,0
25625,25625,25626,9,0,-9
25626,25626,25627,0,2,2
25627,25627,25628,2,1,-1
25628,25628,25629,1,0,-1
25629,25629,25630,0,3,3
25630,25630,25631,3,3,0
25631,25631,25632,3,2,-1
25632,25632,25633,2,9,7
25633,25633,25634,9,9,0
25634,25634,25635,9,4,-5
25635,25635,25636,4,6,2
25636,25636,25637,6,9,3
25637,25637,25638,9,6,-3
25638,25638,25639,6,7,1
25639,25639,25640,7,9,2
25640,25640,25641,9,3,-6
25641,25641,25642,3,7,4
25642,25642,25643,7,9,2
25643,25643,25644,9,4,-5
25644,25644,25645,4,3,-1
25645,25645,25646,3,6,3
25646,25646,25647,6,8,2
25647,25647,25648,8,9,1
25648,25648,25649,9,7,-2
25649,25649,25650,7,0,-7
25650,25650,25651,0,1,1
25651,25651,25652,1,9,8
25652,25652,25653,9,4,-5
25653,25653,25654,4,5,1
25654,25654,25655,5,9,4
25655,25655,25656,9,4,-5
25656,25656,25657,4,8,4
25657,25657,25658,8,2,-6
25658,25658,25659,2,5,3
25659,25659,25660,5,4,-1
25660,25660,25661,4,8,4
25661,25661,25662,8,4,-4
25662,25662,25663,4,2,-2
25663,25663,25664,2,9,7
25664,25664,25665,9,6,-3
25665,25665,25666,6,1,-5
25666,25666,25667,1,9,8
25667,25667,25668,9,4,-5
25668,25668,25669,4,5,1
25669,25669,25670,5,4,-1
25670,25670,25671,4,3,-1
25671,25671,25672,3,2,-1
25672,25672,25673,2,6,4
25673,25673,25674,6,8,2
25674,25674,25675,8,5,-3
25675,25675,25676,5,0,-5
25676,25676,25677,0,2,2
25677,25677,25678,2,5,3
25678,25678,25679,5,5,0
25679,25679,25680,5,6,1
25680,25680,25681,6,7,1
25681,25681,25682,7,4,-3
25682,25682,25683,4,2,-2
25683,25683,25684,2,6,4
25684,25684,25685,6,3,-3
25685,25685,25686,3,8,5
25686,25686,25687,8,1,-7
25687,25687,25688,1,3,2
25688,25688,25689,3,3,0
25689,25689,25690,3,0,-3
25690,25690,25691,0,2,2
25691,25691,25692,2,8,6
25692,25692,25693,8,7,-1
25693,25693,25694,7,0,-7
25694,25694,25695,0,3,3
25695,25695,25696,3,1,-2
25696,25696,25697,1,1,0
25697,25697,25698,1,9,8
25698,25698,25699,9,9,0
25699,25699,25700,9,2,-7
25700,25700,25701,2,0,-2
25701,25701,25702,0,1,1
25702,25702,25703,1,1,0
25703,25703,25704,1,1,0
25704,25704,25705,1,7,6
25705,25705,25706,7,9,2
25706,25706,25707,9,0,-9
25707,25707,25708,0,3,3
25708,25708,25709,3,8,5
25709,25709,25710,8,8,0
25710,25710,25711,8,5,-3
25711,25711,25712,5,9,4
25712,25712,25713,9,6,-3
25713,25713,25714,6,0,-6
25714,25714,25715,0,8,8
25715,25715,25716,8,7,-1
25716,25716,25717,7,2,-5
25717,25717,25718,2,2,0
25718,25718,25719,2,1,-1
25719,25719,25720,1,5,4
25720,25720,25721,5,3,-2
25721,25721,25722,3,4,1
25722,25722,25723,4,5,1
25723,25723,25724,5,1,-4
25724,25724,25725,1,0,-1
25725,25725,25726,0,5,5
25726,25726,25727,5,7,2
25727,25727,25728,7,3,-4
25728,25728,25729,3,0,-3
25729,25729,25730,0,6,6
25730,25730,25731,6,8,2
25731,25731,25732,8,2,-6
25732,25732,25733,2,7,5
25733,25733,25734,7,1,-6
25734,25734,25735,1,2,1
25735,25735,25736,2,8,6
25736,25736,25737,8,4,-4
25737,25737,25738,4,5,1
25738,25738,25739,5,4,-1
25739,25739,25740,4,3,-1
25740,25740,25741,3,8,5
25741,25741,25742,8,6,-2
25742,25742,25743,6,0,-6
25743,25743,25744,0,1,1
25744,25744,25745,1,1,0
25745,25745,25746,1,3,2
25746,25746,25747,3,5,2
25747,25747,25748,5,7,2
25748,25748,25749,7,1,-6
25749,25749,25750,1,0,-1
25750,25750,25751,0,1,1
25751,25751,25752,1,2,1
25752,25752,25753,2,6,4
25753,25753,25754,6,0,-6
25754,25754,25755,0,0,0
25755,25755,25756,0,7,7
25756,25756,25757,7,0,-7
25757,25757,25758,0,1,1
25758,25758,25759,1,4,3
25759,25759,25760,4,4,0
25760,25760,25761,4,9,5
25761,25761,25762,9,5,-4
25762,25762,25763,5,8,3
25763,25763,25764,8,1,-7
25764,25764,25765,1,5,4
25765,25765,25766,5,8,3
25766,25766,25767,8,1,-7
25767,25767,25768,1,3,2
25768,25768,25769,3,6,3
25769,25769,25770,6,6,0
25770,25770,25771,6,6,0
25771,25771,25772,6,4,-2
25772,25772,25773,4,0,-4
25773,25773,25774,0,1,1
25774,25774,25775,1,7,6
25775,25775,25776,7,8,1
25776,25776,25777,8,6,-2
25777,25777,25778,6,5,-1
25778,25778,25779,5,1,-4
25779,25779,25780,1,2,1
25780,25780,25781,2,1,-1
25781,25781,25782,1,7,6
25782,25782,25783,7,0,-7
25783,25783,25784,0,4,4
25784,25784,25785,4,1,-3
25785,25785,25786,1,1,0
25786,25786,25787,1,2,1
25787,25787,25788,2,7,5
25788,25788,25789,7,3,-4
25789,25789,25790,3,4,1
25790,25790,25791,4,4,0
25791,25791,25792,4,7,3
25792,25792,25793,7,5,-2
25793,25793,25794,5,1,-4
25794,25794,25795,1,6,5
25795,25795,25796,6,8,2
25796,25796,25797,8,7,-1
25797,25797,25798,7,6,-1
25798,25798,25799,6,8,2
25799,25799,25800,8,1,-7
25800,25800,25801,1,9,8
25801,25801,25802,9,3,-6
25802,25802,25803,3,0,-3
25803,25803,25804,0,2,2
25804,25804,25805,2,1,-1
25805,25805,25806,1,7,6
25806,25806,25807,7,2,-5
25807,25807,25808,2,7,5
25808,25808,25809,7,3,-4
25809,25809,25810,3,9,6
25810,25810,25811,9,4,-5
25811,25811,25812,4,1,-3
25812,25812,25813,1,5,4
25813,25813,25814,5,0,-5
25814,25814,25815,0,6,6
25815,25815,25816,6,7,1
25816,25816,25817,7,7,0
25817,25817,25818,7,0,-7
25818,25818,25819,0,8,8
25819,25819,25820,8,3,-5
25820,25820,25821,3,9,6
25821,25821,25822,9,1,-8
25822,25822,25823,1,0,-1
25823,25823,25824,0,9,9
25824,25824,25825,9,1,-8
25825,25825,25826,1,4,3
25826,25826,25827,4,2,-2
25827,25827,25828,2,9,7
25828,25828,25829,9,3,-6
25829,25829,25830,3,7,4
25830,25830,25831,7,4,-3
25831,25831,25832,4,5,1
25832,25832,25833,5,7,2
25833,25833,25834,7,6,-1
25834,25834,25835,6,8,2
25835,25835,25836,8,0,-8
25836,25836,25837,0,9,9
25837,25837,25838,9,2,-7
25838,25838,25839,2,0,-2
25839,25839,25840,0,5,5
25840,25840,25841,5,7,2
25841,25841,25842,7,1,-6
25842,25842,25843,1,8,7
25843,25843,25844,8,4,-4
25844,25844,25845,4,4,0
25845,25845,25846,4,4,0
25846,25846,25847,4,1,-3
25847,25847,25848,1,4,3
25848,25848,25849,4,8,4
25849,25849,25850,8,7,-1
25850,25850,25851,7,8,1
25851,25851,25852,8,9,1
25852,25852,25853,9,1,-8
25853,25853,25854,1,2,1
25854,25854,25855,2,3,1
25855,25855,25856,3,4,1
25856,25856,25857,4,1,-3
25857,25857,25858,1,1,0
25858,25858,25859,1,8,7
25859,25859,25860,8,6,-2
25860,25860,25861,6,3,-3
25861,25861,25862,3,7,4
25862,25862,25863,7,7,0
25863,25863,25864,7,1,-6
25864,25864,25865,1,9,8
25865,25865,25866,9,4,-5
25866,25866,25867,4,3,-1
25867,25867,25868,3,7,4
25868,25868,25869,7,4,-3
25869,25869,25870,4,8,4
25870,25870,25871,8,7,-1
25871,25871,25872,7,9,2
25872,25872,25873,9,8,-1
25873,25873,25874,8,9,1
25874,25874,25875,9,4,-5
25875,25875,25876,4,1,-3
25876,25876,25877,1,7,6
25877,25877,25878,7,4,-3
25878,25878,25879,4,8,4
25879,25879,25880,8,3,-5
25880,25880,25881,3,9,6
25881,25881,25882,9,3,-6
25882,25882,25883,3,3,0
25883,25883,25884,3,4,1
25884,25884,25885,4,1,-3
25885,25885,25886,1,5,4
25886,25886,25887,5,4,-1
25887,25887,25888,4,7,3
25888,25888,25889,7,6,-1
25889,25889,25890,6,8,2
25890,25890,25891,8,5,-3
25891,25891,25892,5,0,-5
25892,25892,25893,0,6,6
25893,25893,25894,6,4,-2
25894,25894,25895,4,7,3
25895,25895,25896,7,3,-4
25896,25896,25897,3,7,4
25897,25897,25898,7,1,-6
25898,25898,25899,1,1,0
25899,25899,25900,1,9,8
25900,25900,25901,9,6,-3
25901,25901,25902,6,2,-4
25902,25902,25903,2,4,2
25903,25903,25904,4,7,3
25904,25904,25905,7,9,2
25905,25905,25906,9,6,-3
25906,25906,25907,6,2,-4
25907,25907,25908,2,6,4
25908,25908,25909,6,9,3
25909,25909,25910,9,1,-8
25910,25910,25911,1,3,2
25911,25911,25912,3,2,-1
25912,25912,25913,2,5,3
25913,25913,25914,5,0,-5
25914,25914,25915,0,3,3
25915,25915,25916,3,2,-1
25916,25916,25917,2,6,4
25917,25917,25918,6,1,-5
25918,25918,25919,1,0,-1
25919,25919,25920,0,2,2
25920,25920,25921,2,0,-2
25921,25921,25922,0,3,3
25922,25922,25923,3,2,-1
25923,25923,25924,2,3,1
25924,25924,25925,3,4,1
25925,25925,25926,4,7,3
25926,25926,25927,7,2,-5
25927,25927,25928,2,0,-2
25928,25928,25929,0,7,7
25929,25929,25930,7,5,-2
25930,25930,25931,5,4,-1
25931,25931,25932,4,0,-4
25932,25932,25933,0,9,9
25933,25933,25934,9,1,-8
25934,25934,25935,1,5,4
25935,25935,25936,5,5,0
25936,25936,25937,5,1,-4
25937,25937,25938,1,4,3
25938,25938,25939,4,2,-2
25939,25939,25940,2,1,-1
25940,25940,25941,1,3,2
25941,25941,25942,3,0,-3
25942,25942,25943,0,6,6
25943,25943,25944,6,6,0
25944,25944,25945,6,1,-5
25945,25945,25946,1,9,8
25946,25946,25947,9,8,-1
25947,25947,25948,8,1,-7
25948,25948,25949,1,3,2
25949,25949,25950,3,3,0
25950,25950,25951,3,8,5
25951,25951,25952,8,0,-8
25952,25952,25953,0,0,0
25953,25953,25954,0,5,5
25954,25954,25955,5,3,-2
25955,25955,25956,3,4,1
25956,25956,25957,4,0,-4
25957,25957,25958,0,5,5
25958,25958,25959,5,6,1
25959,25959,25960,6,4,-2
25960,25960,25961,4,1,-3
25961,25961,25962,1,6,5
25962,25962,25963,6,6,0
25963,25963,25964,6,7,1
25964,25964,25965,7,9,2
25965,25965,25966,9,5,-4
25966,25966,25967,5,5,0
25967,25967,25968,5,8,3
25968,25968,25969,8,9,1
25969,25969,25970,9,1,-8
25970,25970,25971,1,4,3
25971,25971,25972,4,7,3
25972,25972,25973,7,5,-2
25973,25973,25974,5,2,-3
25974,25974,25975,2,8,6
25975,25975,25976,8,8,0
25976,25976,25977,8,6,-2
25977,25977,25978,6,0,-6
25978,25978,25979,0,7,7
25979,25979,25980,7,0,-7
25980,25980,25981,0,1,1
25981,25981,25982,1,7,6
25982,25982,25983,7,1,-6
25983,25983,25984,1,8,7
25984,25984,25985,8,7,-1
25985,25985,25986,7,8,1
25986,25986,25987,8,0,-8
25987,25987,25988,0,8,8
25988,25988,25989,8,1,-7
25989,25989,25990,1,4,3
25990,25990,25991,4,2,-2
25991,25991,25992,2,6,4
25992,25992,25993,6,3,-3
25993,25993,25994,3,2,-1
25994,25994,25995,2,4,2
25995,25995,25996,4,3,-1
25996,25996,25997,3,5,2
25997,25997,25998,5,7,2
25998,25998,25999,7,6,-1
25999,25999,26000,6,4,-2
26000,26000,26001,4,7,3
26001,26001,26002,7,1,-6
26002,26002,26003,1,8,7
26003,26003,26004,8,7,-1
26004,26004,26005,7,9,2
26005,26005,26006,9,2,-7
26006,26006,26007,2,0,-2
26007,26007,26008,0,3,3
26008,26008,26009,3,1,-2
26009,26009,26010,1,7,6
26010,26010,26011,7,2,-5
26011,26011,26012,2,2,0
26012,26012,26013,2,3,1
26013,26013,26014,3,3,0
26014,26014,26015,3,4,1
26015,26015,26016,4,6,2
26016,26016,26017,6,5,-1
26017,26017,26018,5,5,0
26018,26018,26019,5,6,1
26019,26019,26020,6,5,-1
26020,26020,26021,5,7,2
26021,26021,26022,7,8,1
26022,26022,26023,8,8,0
26023,26023,26024,8,5,-3
26024,26024,26025,5,9,4
26025,26025,26026,9,7,-2
26026,26026,26027,7,0,-7
26027,26027,26028,0,8,8
26028,26028,26029,8,1,-7
26029,26029,26030,1,5,4
26030,26030,26031,5,2,-3
26031,26031,26032,2,6,4
26032,26032,26033,6,3,-3
26033,26033,26034,3,5,2
26034,26034,26035,5,4,-1
26035,26035,26036,4,8,4
26036,26036,26037,8,5,-3
26037,26037,26038,5,0,-5
26038,26038,26039,0,6,6
26039,26039,26040,6,0,-6
26040,26040,26041,0,7,7
26041,26041,26042,7,9,2
26042,26042,26043,9,8,-1
26043,26043,26044,8,0,-8
26044,26044,26045,0,9,9
26045,26045,26046,9,2,-7
26046,26046,26047,2,7,5
26047,26047,26048,7,3,-4
26048,26048,26049,3,7,4
26049,26049,26050,7,3,-4
26050,26050,26051,3,7,4
26051,26051,26052,7,6,-1
26052,26052,26053,6,3,-3
26053,26053,26054,3,7,4
26054,26054,26055,7,0,-7
26055,26055,26056,0,7,7
26056,26056,26057,7,3,-4
26057,26057,26058,3,0,-3
26058,26058,26059,0,1,1
26059,26059,26060,1,9,8
26060,26060,26061,9,8,-1
26061,26061,26062,8,5,-3
26062,26062,26063,5,7,2
26063,26063,26064,7,9,2
26064,26064,26065,9,6,-3
26065,26065,26066,6,5,-1
26066,26066,26067,5,4,-1
26067,26067,26068,4,9,5
26068,26068,26069,9,5,-4
26069,26069,26070,5,1,-4
26070,26070,26071,1,6,5
26071,26071,26072,6,1,-5
26072,26072,26073,1,0,-1
26073,26073,26074,0,4,4
26074,26074,26075,4,2,-2
26075,26075,26076,2,7,5
26076,26076,26077,7,6,-1
26077,26077,26078,6,8,2
26078,26078,26079,8,8,0
26079,26079,26080,8,7,-1
26080,26080,26081,7,3,-4
26081,26081,26082,3,9,6
26082,26082,26083,9,2,-7
26083,26083,26084,2,3,1
26084,26084,26085,3,8,5
26085,26085,26086,8,4,-4
26086,26086,26087,4,1,-3
26087,26087,26088,1,7,6
26088,26088,26089,7,1,-6
26089,26089,26090,1,8,7
26090,26090,26091,8,7,-1
26091,26091,26092,7,6,-1
26092,26092,26093,6,2,-4
26093,26093,26094,2,5,3
26094,26094,26095,5,0,-5
26095,26095,26096,0,1,1
26096,26096,26097,1,7,6
26097,26097,26098,7,5,-2
26098,26098,26099,5,1,-4
26099,26099,26100,1,8,7
26100,26100,26101,8,6,-2
26101,26101,26102,6,5,-1
26102,26102,26103,5,0,-5
26103,26103,26104,0,1,1
26104,26104,26105,1,4,3
26105,26105,26106,4,4,0
26106,26106,26107,4,6,2
26107,26107,26108,6,9,3
26108,26108,26109,9,4,-5
26109,26109,26110,4,9,5
26110,26110,26111,9,4,-5
26111,26111,26112,4,5,1
26112,26112,26113,5,5,0
26113,26113,26114,5,6,1
26114,26114,26115,6,8,2
26115,26115,26116,8,9,1
26116,26116,26117,9,0,-9
26117,26117,26118,0,1,1
26118,26118,26119,1,6,5
26119,26119,26120,6,2,-4
26120,26120,26121,2,2,0
26121,26121,26122,2,8,6
26122,26122,26123,8,3,-5
26123,26123,26124,3,6,3
26124,26124,26125,6,1,-5
26125,26125,26126,1,6,5
26126,26126,26127,6,3,-3
26127,26127,26128,3,4,1
26128,26128,26129,4,6,2
26129,26129,26130,6,3,-3
26130,26130,26131,3,5,2
26131,26131,26132,5,4,-1
26132,26132,26133,4,1,-3
26133,26133,26134,1,5,4
26134,26134,26135,5,8,3
26135,26135,26136,8,8,0
26136,26136,26137,8,4,-4
26137,26137,26138,4,8,4
26138,26138,26139,8,0,-8
26139,26139,26140,0,3,3
26140,26140,26141,3,7,4
26141,26141,26142,7,1,-6
26142,26142,26143,1,5,4
26143,26143,26144,5,1,-4
26144,26144,26145,1,8,7
26145,26145,26146,8,2,-6
26146,26146,26147,2,8,6
26147,26147,26148,8,3,-5
26148,26148,26149,3,3,0
26149,26149,26150,3,5,2
26150,26150,26151,5,7,2
26151,26151,26152,7,1,-6
26152,26152,26153,1,8,7
26153,26153,26154,8,3,-5
26154,26154,26155,3,9,6
26155,26155,26156,9,3,-6
26156,26156,26157,3,2,-1
26157,26157,26158,2,7,5
26158,26158,26159,7,6,-1
26159,26159,26160,6,6,0
26160,26160,26161,6,2,-4
26161,26161,26162,2,7,5
26162,26162,26163,7,5,-2
26163,26163,26164,5,2,-3
26164,26164,26165,2,3,1
26165,26165,26166,3,4,1
26166,26166,26167,4,1,-3
26167,26167,26168,1,6,5
26168,26168,26169,6,7,1
26169,26169,26170,7,2,-5
26170,26170,26171,2,3,1
26171,26171,26172,3,4,1
26172,26172,26173,4,9,5
26173,26173,26174,9,1,-8
26174,26174,26175,1,1,0
26175,26175,26176,1,0,-1
26176,26176,26177,0,9,9
26177,26177,26178,9,0,-9
26178,26178,26179,0,9,9
26179,26179,26180,9,6,-3
26180,26180,26181,6,6,0
26181,26181,26182,6,1,-5
26182,26182,26183,1,0,-1
26183,26183,26184,0,0,0
26184,26184,26185,0,9,9
26185,26185,26186,9,6,-3
26186,26186,26187,6,3,-3
26187,26187,26188,3,1,-2
26188,26188,26189,1,7,6
26189,26189,26190,7,1,-6
26190,26190,26191,1,0,-1
26191,26191,26192,0,4,4
26192,26192,26193,4,4,0
26193,26193,26194,4,3,-1
26194,26194,26195,3,5,2
26195,26195,26196,5,5,0
26196,26196,26197,5,0,-5
26197,26197,26198,0,5,5
26198,26198,26199,5,9,4
26199,26199,26200,9,8,-1
26200,26200,26201,8,2,-6
26201,26201,26202,2,1,-1
26202,26202,26203,1,8,7
26203,26203,26204,8,5,-3
26204,26204,26205,5,1,-4
26205,26205,26206,1,5,4
26206,26206,26207,5,4,-1
26207,26207,26208,4,3,-1
26208,26208,26209,3,3,0
26209,26209,26210,3,0,-3
26210,26210,26211,0,5,5
26211,26211,26212,5,9,4
26212,26212,26213,9,2,-7
26213,26213,26214,2,9,7
26214,26214,26215,9,9,0
26215,26215,26216,9,7,-2
26216,26216,26217,7,4,-3
26217,26217,26218,4,7,3
26218,26218,26219,7,0,-7
26219,26219,26220,0,9,9
26220,26220,26221,9,2,-7
26221,26221,26222,2,3,1
26222,26222,26223,3,9,6
26223,26223,26224,9,2,-7
26224,26224,26225,2,1,-1
26225,26225,26226,1,9,8
26226,26226,26227,9,6,-3
26227,26227,26228,6,5,-1
26228,26228,26229,5,5,0
26229,26229,26230,5,0,-5
26230,26230,26231,0,8,8
26231,26231,26232,8,7,-1
26232,26232,26233,7,9,2
26233,26233,26234,9,7,-2
26234,26234,26235,7,4,-3
26235,26235,26236,4,5,1
26236,26236,26237,5,2,-3
26237,26237,26238,2,1,-1
26238,26238,26239,1,5,4
26239,26239,26240,5,5,0
26240,26240,26241,5,0,-5
26241,26241,26242,0,4,4
26242,26242,26243,4,1,-3
26243,26243,26244,1,8,7
26244,26244,26245,8,2,-6
26245,26245,26246,2,4,2
26246,26246,26247,4,3,-1
26247,26247,26248,3,8,5
26248,26248,26249,8,4,-4
26249,26249,26250,4,1,-3
26250,26250,26251,1,5,4
26251,26251,26252,5,6,1
26252,26252,26253,6,6,0
26253,26253,26254,6,9,3
26254,26254,26255,9,7,-2
26255,26255,26256,7,0,-7
26256,26256,26257,0,8,8
26257,26257,26258,8,0,-8
26258,26258,26259,0,9,9
26259,26259,26260,9,0,-9
26260,26260,26261,0,0,0
26261,26261,26262,0,0,0
26262,26262,26263,0,1,1
26263,26263,26264,1,4,3
26264,26264,26265,4,2,-2
26265,26265,26266,2,7,5
26266,26266,26267,7,3,-4
26267,26267,26268,3,1,-2
26268,26268,26269,1,4,3
26269,26269,26270,4,3,-1
26270,26270,26271,3,7,4
26271,26271,26272,7,7,0
26272,26272,26273,7,8,1
26273,26273,26274,8,7,-1
26274,26274,26275,7,9,2
26275,26275,26276,9,9,0
26276,26276,26277,9,0,-9
26277,26277,26278,0,9,9
26278,26278,26279,9,1,-8
26279,26279,26280,1,2,1
26280,26280,26281,2,4,2
26281,26281,26282,4,9,5
26282,26282,26283,9,5,-4
26283,26283,26284,5,3,-2
26284,26284,26285,3,6,3
26285,26285,26286,6,5,-1
26286,26286,26287,5,7,2
26287,26287,26288,7,4,-3
26288,26288,26289,4,8,4
26289,26289,26290,8,5,-3
26290,26290,26291,5,3,-2
26291,26291,26292,3,0,-3
26292,26292,26293,0,4,4
26293,26293,26294,4,8,4
26294,26294,26295,8,1,-7
26295,26295,26296,1,4,3
26296,26296,26297,4,4,0
26297,26297,26298,4,0,-4
26298,26298,26299,0,6,6
26299,26299,26300,6,0,-6
26300,26300,26301,0,6,6
26301,26301,26302,6,9,3
26302,26302,26303,9,7,-2
26303,26303,26304,7,7,0
26304,26304,26305,7,3,-4
26305,26305,26306,3,3,0
26306,26306,26307,3,3,0
26307,26307,26308,3,0,-3
26308,26308,26309,0,4,4
26309,26309,26310,4,1,-3
26310,26310,26311,1,3,2
26311,26311,26312,3,2,-1
26312,26312,26313,2,5,3
26313,26313,26314,5,9,4
26314,26314,26315,9,0,-9
26315,26315,26316,0,9,9
26316,26316,26317,9,1,-8
26317,26317,26318,1,6,5
26318,26318,26319,6,4,-2
26319,26319,26320,4,5,1
26320,26320,26321,5,6,1
26321,26321,26322,6,7,1
26322,26322,26323,7,0,-7
26323,26323,26324,0,3,3
26324,26324,26325,3,2,-1
26325,26325,26326,2,2,0
26326,26326,26327,2,8,6
26327,26327,26328,8,5,-3
26328,26328,26329,5,2,-3
26329,26329,26330,2,2,0
26330,26330,26331,2,5,3
26331,26331,26332,5,9,4
26332,26332,26333,9,2,-7
26333,26333,26334,2,4,2
26334,26334,26335,4,1,-3
26335,26335,26336,1,9,8
26336,26336,26337,9,7,-2
26337,26337,26338,7,0,-7
26338,26338,26339,0,0,0
26339,26339,26340,0,2,2
26340,26340,26341,2,2,0
26341,26341,26342,2,6,4
26342,26342,26343,6,0,-6
26343,26343,26344,0,6,6
26344,26344,26345,6,6,0
26345,26345,26346,6,9,3
26346,26346,26347,9,6,-3
26347,26347,26348,6,2,-4
26348,26348,26349,2,9,7
26349,26349,26350,9,1,-8
26350,26350,26351,1,8,7
26351,26351,26352,8,4,-4
26352,26352,26353,4,9,5
26353,26353,26354,9,7,-2
26354,26354,26355,7,2,-5
26355,26355,26356,2,7,5
26356,26356,26357,7,2,-5
26357,26357,26358,2,3,1
26358,26358,26359,3,9,6
26359,26359,26360,9,5,-4
26360,26360,26361,5,9,4
26361,26361,26362,9,8,-1
26362,26362,26363,8,5,-3
26363,26363,26364,5,3,-2
26364,26364,26365,3,4,1
26365,26365,26366,4,0,-4
26366,26366,26367,0,4,4
26367,26367,26368,4,5,1
26368,26368,26369,5,0,-5
26369,26369,26370,0,5,5
26370,26370,26371,5,0,-5
26371,26371,26372,0,6,6
26372,26372,26373,6,8,2
26373,26373,26374,8,7,-1
26374,26374,26375,7,6,-1
26375,26375,26376,6,1,-5
26376,26376,26377,1,6,5
26377,26377,26378,6,3,-3
26378,26378,26379,3,8,5
26379,26379,26380,8,9,1
26380,26380,26381,9,5,-4
26381,26381,26382,5,6,1
26382,26382,26383,6,3,-3
26383,26383,26384,3,6,3
26384,26384,26385,6,8,2
26385,26385,26386,8,6,-2
26386,26386,26387,6,5,-1
26387,26387,26388,5,1,-4
26388,26388,26389,1,0,-1
26389,26389,26390,0,1,1
26390,26390,26391,1,3,2
26391,26391,26392,3,6,3
26392,26392,26393,6,6,0
26393,26393,26394,6,6,0
26394,26394,26395,6,7,1
26395,26395,26396,7,6,-1
26396,26396,26397,6,8,2
26397,26397,26398,8,5,-3
26398,26398,26399,5,3,-2
26399,26399,26400,3,9,6
26400,26400,26401,9,1,-8
26401,26401,26402,1,6,5
26402,26402,26403,6,3,-3
26403,26403,26404,3,5,2
26404,26404,26405,5,9,4
26405,26405,26406,9,1,-8
26406,26406,26407,1,5,4
26407,26407,26408,5,0,-5
26408,26408,26409,0,1,1
26409,26409,26410,1,6,5
26410,26410,26411,6,5,-1
26411,26411,26412,5,3,-2
26412,26412,26413,3,5,2
26413,26413,26414,5,8,3
26414,26414,26415,8,0,-8
26415,26415,26416,0,9,9
26416,26416,26417,9,7,-2
26417,26417,26418,7,6,-1
26418,26418,26419,6,3,-3
26419,26419,26420,3,1,-2
26420,26420,26421,1,1,0
26421,26421,26422,1,0,-1
26422,26422,26423,0,7,7
26423,26423,26424,7,9,2
26424,26424,26425,9,6,-3
26425,26425,26426,6,9,3
26426,26426,26427,9,0,-9
26427,26427,26428,0,9,9
26428,26428,26429,9,1,-8
26429,26429,26430,1,9,8
26430,26430,26431,9,2,-7
26431,26431,26432,2,5,3
26432,26432,26433,5,3,-2
26433,26433,26434,3,2,-1
26434,26434,26435,2,4,2
26435,26435,26436,4,0,-4
26436,26436,26437,0,5,5
26437,26437,26438,5,0,-5
26438,26438,26439,0,6,6
26439,26439,26440,6,9,3
26440,26440,26441,9,7,-2
26441,26441,26442,7,7,0
26442,26442,26443,7,8,1
26443,26443,26444,8,1,-7
26444,26444,26445,1,1,0
26445,26445,26446,1,7,6
26446,26446,26447,7,2,-5
26447,26447,26448,2,3,1
26448,26448,26449,3,3,0
26449,26449,26450,3,4,1
26450,26450,26451,4,5,1
26451,26451,26452,5,6,1
26452,26452,26453,6,6,0
26453,26453,26454,6,2,-4
26454,26454,26455,2,7,5
26455,26455,26456,7,4,-3
26456,26456,26457,4,0,-4
26457,26457,26458,0,4,4
26458,26458,26459,4,1,-3
26459,26459,26460,1,5,4
26460,26460,26461,5,2,-3
26461,26461,26462,2,9,7
26462,26462,26463,9,3,-6
26463,26463,26464,3,5,2
26464,26464,26465,5,4,-1
26465,26465,26466,4,5,1
26466,26466,26467,5,5,0
26467,26467,26468,5,2,-3
26468,26468,26469,2,6,4
26469,26469,26470,6,6,0
26470,26470,26471,6,8,2
26471,26471,26472,8,6,-2
26472,26472,26473,6,1,-5
26473,26473,26474,1,8,7
26474,26474,26475,8,0,-8
26475,26475,26476,0,1,1
26476,26476,26477,1,2,1
26477,26477,26478,2,3,1
26478,26478,26479,3,1,-2
26479,26479,26480,1,4,3
26480,26480,26481,4,5,1
26481,26481,26482,5,6,1
26482,26482,26483,6,6,0
26483,26483,26484,6,5,-1
26484,26484,26485,5,1,-4
26485,26485,26486,1,9,8
26486,26486,26487,9,1,-8
26487,26487,26488,1,3,2
26488,26488,26489,3,7,4
26489,26489,26490,7,6,-1
26490,26490,26491,6,8,2
26491,26491,26492,8,1,-7
26492,26492,26493,1,5,4
26493,26493,26494,5,4,-1
26494,26494,26495,4,1,-3
26495,26495,26496,1,8,7
26496,26496,26497,8,6,-2
26497,26497,26498,6,6,0
26498,26498,26499,6,7,1
26499,26499,26500,7,7,0
26500,26500,26501,7,0,-7
26501,26501,26502,0,1,1
26502,26502,26503,1,3,2
26503,26503,26504,3,2,-1
26504,26504,26505,2,3,1
26505,26505,26506,3,4,1
26506,26506,26507,4,0,-4
26507,26507,26508,0,0,0
26508,26508,26509,0,2,2
26509,26509,26510,2,4,2
26510,26510,26511,4,6,2
26511,26511,26512,6,9,3
26512,26512,26513,9,9,0
26513,26513,26514,9,1,-8
26514,26514,26515,1,8,7
26515,26515,26516,8,6,-2
26516,26516,26517,6,5,-1
26517,26517,26518,5,9,4
26518,26518,26519,9,8,-1
26519,26519,26520,8,8,0
26520,26520,26521,8,6,-2
26521,26521,26522,6,2,-4
26522,26522,26523,2,8,6
26523,26523,26524,8,6,-2
26524,26524,26525,6,9,3
26525,26525,26526,9,3,-6
26526,26526,26527,3,9,6
26527,26527,26528,9,7,-2
26528,26528,26529,7,7,0
26529,26529,26530,7,6,-1
26530,26530,26531,6,1,-5
26531,26531,26532,1,8,7
26532,26532,26533,8,2,-6
26533,26533,26534,2,3,1
26534,26534,26535,3,1,-2
26535,26535,26536,1,9,8
26536,26536,26537,9,1,-8
26537,26537,26538,1,5,4
26538,26538,26539,5,1,-4
26539,26539,26540,1,2,1
26540,26540,26541,2,2,0
26541,26541,26542,2,3,1
26542,26542,26543,3,8,5
26543,26543,26544,8,4,-4
26544,26544,26545,4,0,-4
26545,26545,26546,0,4,4
26546,26546,26547,4,5,1
26547,26547,26548,5,3,-2
26548,26548,26549,3,7,4
26549,26549,26550,7,3,-4
26550,26550,26551,3,6,3
26551,26551,26552,6,5,-1
26552,26552,26553,5,5,0
26553,26553,26554,5,3,-2
26554,26554,26555,3,3,0
26555,26555,26556,3,1,-2
26556,26556,26557,1,8,7
26557,26557,26558,8,9,1
26558,26558,26559,9,1,-8
26559,26559,26560,1,7,6
26560,26560,26561,7,3,-4
26561,26561,26562,3,2,-1
26562,26562,26563,2,6,4
26563,26563,26564,6,4,-2
26564,26564,26565,4,0,-4
26565,26565,26566,0,9,9
26566,26566,26567,9,4,-5
26567,26567,26568,4,7,3
26568,26568,26569,7,8,1
26569,26569,26570,8,5,-3
26570,26570,26571,5,9,4
26571,26571,26572,9,5,-4
26572,26572,26573,5,4,-1
26573,26573,26574,4,5,1
26574,26574,26575,5,7,2
26575,26575,26576,7,6,-1
26576,26576,26577,6,2,-4
26577,26577,26578,2,1,-1
26578,26578,26579,1,7,6
26579,26579,26580,7,8,1
26580,26580,26581,8,1,-7
26581,26581,26582,1,4,3
26582,26582,26583,4,8,4
26583,26583,26584,8,6,-2
26584,26584,26585,6,2,-4
26585,26585,26586,2,9,7
26586,26586,26587,9,1,-8
26587,26587,26588,1,4,3
26588,26588,26589,4,7,3
26589,26589,26590,7,5,-2
26590,26590,26591,5,7,2
26591,26591,26592,7,5,-2
26592,26592,26593,5,3,-2
26593,26593,26594,3,9,6
26594,26594,26595,9,2,-7
26595,26595,26596,2,3,1
26596,26596,26597,3,0,-3
26597,26597,26598,0,1,1
26598,26598,26599,1,4,3
26599,26599,26600,4,7,3
26600,26600,26601,7,6,-1
26601,26601,26602,6,7,1
26602,26602,26603,7,6,-1
26603,26603,26604,6,1,-5
26604,26604,26605,1,8,7
26605,26605,26606,8,6,-2
26606,26606,26607,6,5,-1
26607,26607,26608,5,0,-5
26608,26608,26609,0,9,9
26609,26609,26610,9,1,-8
26610,26610,26611,1,8,7
26611,26611,26612,8,9,1
26612,26612,26613,9,2,-7
26613,26613,26614,2,6,4
26614,26614,26615,6,5,-1
26615,26615,26616,5,8,3
26616,26616,26617,8,1,-7
26617,26617,26618,1,4,3
26618,26618,26619,4,0,-4
26619,26619,26620,0,0,0
26620,26620,26621,0,5,5
26621,26621,26622,5,6,1
26622,26622,26623,6,0,-6
26623,26623,26624,0,2,2
26624,26624,26625,2,3,1
26625,26625,26626,3,2,-1
26626,26626,26627,2,4,2
26627,26627,26628,4,8,4
26628,26628,26629,8,3,-5
26629,26629,26630,3,2,-1
26630,26630,26631,2,9,7
26631,26631,26632,9,2,-7
26632,26632,26633,2,6,4
26633,26633,26634,6,4,-2
26634,26634,26635,4,2,-2
26635,26635,26636,2,5,3
26636,26636,26637,5,5,0
26637,26637,26638,5,2,-3
26638,26638,26639,2,0,-2
26639,26639,26640,0,9,9
26640,26640,26641,9,6,-3
26641,26641,26642,6,7,1
26642,26642,26643,7,9,2
26643,26643,26644,9,3,-6
26644,26644,26645,3,0,-3
26645,26645,26646,0,2,2
26646,26646,26647,2,1,-1
26647,26647,26648,1,5,4
26648,26648,26649,5,2,-3
26649,26649,26650,2,6,4
26650,26650,26651,6,3,-3
26651,26651,26652,3,4,1
26652,26652,26653,4,4,0
26653,26653,26654,4,6,2
26654,26654,26655,6,5,-1
26655,26655,26656,5,0,-5
26656,26656,26657,0,6,6
26657,26657,26658,6,2,-4
26658,26658,26659,2,7,5
26659,26659,26660,7,8,1
26660,26660,26661,8,8,0
26661,26661,26662,8,3,-5
26662,26662,26663,3,9,6
26663,26663,26664,9,8,-1
26664,26664,26665,8,0,-8
26665,26665,26666,0,8,8
26666,26666,26667,8,1,-7
26667,26667,26668,1,7,6
26668,26668,26669,7,2,-5
26669,26669,26670,2,6,4
26670,26670,26671,6,3,-3
26671,26671,26672,3,8,5
26672,26672,26673,8,4,-4
26673,26673,26674,4,3,-1
26674,26674,26675,3,5,2
26675,26675,26676,5,5,0
26676,26676,26677,5,6,1
26677,26677,26678,6,3,-3
26678,26678,26679,3,7,4
26679,26679,26680,7,5,-2
26680,26680,26681,5,8,3
26681,26681,26682,8,9,1
26682,26682,26683,9,9,0
26683,26683,26684,9,7,-2
26684,26684,26685,7,0,-7
26685,26685,26686,0,0,0
26686,26686,26687,0,1,1
26687,26687,26688,1,2,1
26688,26688,26689,2,2,0
26689,26689,26690,2,2,0
26690,26690,26691,2,3,1
26691,26691,26692,3,3,0
26692,26692,26693,3,4,1
26693,26693,26694,4,3,-1
26694,26694,26695,3,5,2
26695,26695,26696,5,1,-4
26696,26696,26697,1,6,5
26697,26697,26698,6,1,-5
26698,26698,26699,1,7,6
26699,26699,26700,7,5,-2
26700,26700,26701,5,8,3
26701,26701,26702,8,3,-5
26702,26702,26703,3,9,6
26703,26703,26704,9,4,-5
26704,26704,26705,4,7,3
26705,26705,26706,7,5,-2
26706,26706,26707,5,7,2
26707,26707,26708,7,8,1
26708,26708,26709,8,7,-1
26709,26709,26710,7,3,-4
26710,26710,26711,3,3,0
26711,26711,26712,3,0,-3
26712,26712,26713,0,0,0
26713,26713,26714,0,7,7
26714,26714,26715,7,3,-4
26715,26715,26716,3,6,3
26716,26716,26717,6,1,-5
26717,26717,26718,1,2,1
26718,26718,26719,2,8,6
26719,26719,26720,8,8,0
26720,26720,26721,8,7,-1
26721,26721,26722,7,0,-7
26722,26722,26723,0,6,6
26723,26723,26724,6,3,-3
26724,26724,26725,3,4,1
26725,26725,26726,4,1,-3
26726,26726,26727,1,5,4
26727,26727,26728,5,0,-5
26728,26728,26729,0,6,6
26729,26729,26730,6,9,3
26730,26730,26731,9,0,-9
26731,26731,26732,0,3,3
26732,26732,26733,3,2,-1
26733,26733,26734,2,7,5
26734,26734,26735,7,6,-1
26735,26735,26736,6,5,-1
26736,26736,26737,5,8,3
26737,26737,26738,8,4,-4
26738,26738,26739,4,3,-1
26739,26739,26740,3,2,-1
26740,26740,26741,2,2,0
26741,26741,26742,2,7,5
26742,26742,26743,7,8,1
26743,26743,26744,8,3,-5
26744,26744,26745,3,1,-2
26745,26745,26746,1,1,0
26746,26746,26747,1,1,0
26747,26747,26748,1,9,8
26748,26748,26749,9,7,-2
26749,26749,26750,7,7,0
26750,26750,26751,7,2,-5
26751,26751,26752,2,5,3
26752,26752,26753,5,0,-5
26753,26753,26754,0,6,6
26754,26754,26755,6,7,1
26755,26755,26756,7,7,0
26756,26756,26757,7,1,-6
26757,26757,26758,1,4,3
26758,26758,26759,4,6,2
26759,26759,26760,6,8,2
26760,26760,26761,8,0,-8
26761,26761,26762,0,8,8
26762,26762,26763,8,4,-4
26763,26763,26764,4,9,5
26764,26764,26765,9,6,-3
26765,26765,26766,6,6,0
26766,26766,26767,6,4,-2
26767,26767,26768,4,6,2
26768,26768,26769,6,4,-2
26769,26769,26770,4,2,-2
26770,26770,26771,2,5,3
26771,26771,26772,5,1,-4
26772,26772,26773,1,8,7
26773,26773,26774,8,1,-7
26774,26774,26775,1,0,-1
26775,26775,26776,0,8,8
26776,26776,26777,8,6,-2
26777,26777,26778,6,7,1
26778,26778,26779,7,2,-5
26779,26779,26780,2,1,-1
26780,26780,26781,1,3,2
26781,26781,26782,3,2,-1
26782,26782,26783,2,3,1
26783,26783,26784,3,0,-3
26784,26784,26785,0,6,6
26785,26785,26786,6,8,2
26786,26786,26787,8,5,-3
26787,26787,26788,5,2,-3
26788,26788,26789,2,1,-1
26789,26789,26790,1,4,3
26790,26790,26791,4,8,4
26791,26791,26792,8,6,-2
26792,26792,26793,6,5,-1
26793,26793,26794,5,2,-3
26794,26794,26795,2,9,7
26795,26795,26796,9,6,-3
26796,26796,26797,6,4,-2
26797,26797,26798,4,4,0
26798,26798,26799,4,0,-4
26799,26799,26800,0,2,2
26800,26800,26801,2,7,5
26801,26801,26802,7,1,-6
26802,26802,26803,1,5,4
26803,26803,26804,5,8,3
26804,26804,26805,8,8,0
26805,26805,26806,8,9,1
26806,26806,26807,9,8,-1
26807,26807,26808,8,4,-4
26808,26808,26809,4,3,-1
26809,26809,26810,3,6,3
26810,26810,26811,6,7,1
26811,26811,26812,7,1,-6
26812,26812,26813,1,8,7
26813,26813,26814,8,5,-3
26814,26814,26815,5,9,4
26815,26815,26816,9,4,-5
26816,26816,26817,4,2,-2
26817,26817,26818,2,0,-2
26818,26818,26819,0,6,6
26819,26819,26820,6,0,-6
26820,26820,26821,0,2,2
26821,26821,26822,2,9,7
26822,26822,26823,9,5,-4
26823,26823,26824,5,3,-2
26824,26824,26825,3,3,0
26825,26825,26826,3,7,4
26826,26826,26827,7,1,-6
26827,26827,26828,1,9,8
26828,26828,26829,9,7,-2
26829,26829,26830,7,3,-4
26830,26830,26831,3,3,0
26831,26831,26832,3,0,-3
26832,26832,26833,0,9,9
26833,26833,26834,9,9,0
26834,26834,26835,9,1,-8
26835,26835,26836,1,0,-1
26836,26836,26837,0,9,9
26837,26837,26838,9,7,-2
26838,26838,26839,7,9,2
26839,26839,26840,9,0,-9
26840,26840,26841,0,6,6
26841,26841,26842,6,5,-1
26842,26842,26843,5,0,-5
26843,26843,26844,0,9,9
26844,26844,26845,9,9,0
26845,26845,26846,9,9,0
26846,26846,26847,9,4,-5
26847,26847,26848,4,6,2
26848,26848,26849,6,3,-3
26849,26849,26850,3,2,-1
26850,26850,26851,2,7,5
26851,26851,26852,7,8,1
26852,26852,26853,8,0,-8
26853,26853,26854,0,7,7
26854,26854,26855,7,4,-3
26855,26855,26856,4,5,1
26856,26856,26857,5,5,0
26857,26857,26858,5,4,-1
26858,26858,26859,4,0,-4
26859,26859,26860,0,9,9
26860,26860,26861,9,9,0
26861,26861,26862,9,5,-4
26862,26862,26863,5,2,-3
26863,26863,26864,2,4,2
26864,26864,26865,4,8,4
26865,26865,26866,8,3,-5
26866,26866,26867,3,1,-2
26867,26867,26868,1,5,4
26868,26868,26869,5,4,-1
26869,26869,26870,4,9,5
26870,26870,26871,9,3,-6
26871,26871,26872,3,4,1
26872,26872,26873,4,5,1
26873,26873,26874,5,6,1
26874,26874,26875,6,2,-4
26875,26875,26876,2,5,3
26876,26876,26877,5,9,4
26877,26877,26878,9,3,-6
26878,26878,26879,3,4,1
26879,26879,26880,4,3,-1
26880,26880,26881,3,0,-3
26881,26881,26882,0,7,7
26882,26882,26883,7,2,-5
26883,26883,26884,2,6,4
26884,26884,26885,6,9,3
26885,26885,26886,9,7,-2
26886,26886,26887,7,1,-6
26887,26887,26888,1,2,1
26888,26888,26889,2,6,4
26889,26889,26890,6,4,-2
26890,26890,26891,4,5,1
26891,26891,26892,5,1,-4
26892,26892,26893,1,8,7
26893,26893,26894,8,7,-1
26894,26894,26895,7,9,2
26895,26895,26896,9,5,-4
26896,26896,26897,5,4,-1
26897,26897,26898,4,7,3
26898,26898,26899,7,2,-5
26899,26899,26900,2,6,4
26900,26900,26901,6,5,-1
26901,26901,26902,5,9,4
26902,26902,26903,9,0,-9
26903,26903,26904,0,4,4
26904,26904,26905,4,1,-3
26905,26905,26906,1,9,8
26906,26906,26907,9,2,-7
26907,26907,26908,2,8,6
26908,26908,26909,8,3,-5
26909,26909,26910,3,1,-2
26910,26910,26911,1,4,3
26911,26911,26912,4,6,2
26912,26912,26913,6,5,-1
26913,26913,26914,5,1,-4
26914,26914,26915,1,6,5
26915,26915,26916,6,7,1
26916,26916,26917,7,7,0
26917,26917,26918,7,5,-2
26918,26918,26919,5,8,3
26919,26919,26920,8,6,-2
26920,26920,26921,6,9,3
26921,26921,26922,9,2,-7
26922,26922,26923,2,0,-2
26923,26923,26924,0,1,1
26924,26924,26925,1,1,0
26925,26925,26926,1,5,4
26926,26926,26927,5,2,-3
26927,26927,26928,2,3,1
26928,26928,26929,3,3,0
26929,26929,26930,3,0,-3
26930,26930,26931,0,6,6
26931,26931,26932,6,2,-4
26932,26932,26933,2,7,5
26933,26933,26934,7,6,-1
26934,26934,26935,6,8,2
26935,26935,26936,8,8,0
26936,26936,26937,8,0,-8
26937,26937,26938,0,6,6
26938,26938,26939,6,1,-5
26939,26939,26940,1,6,5
26940,26940,26941,6,2,-4
26941,26941,26942,2,3,1
26942,26942,26943,3,3,0
26943,26943,26944,3,1,-2
26944,26944,26945,1,7,6
26945,26945,26946,7,6,-1
26946,26946,26947,6,8,2
26947,26947,26948,8,8,0
26948,26948,26949,8,9,1
26949,26949,26950,9,9,0
26950,26950,26951,9,1,-8
26951,26951,26952,1,8,7
26952,26952,26953,8,8,0
26953,26953,26954,8,9,1
26954,26954,26955,9,6,-3
26955,26955,26956,6,2,-4
26956,26956,26957,2,7,5
26957,26957,26958,7,6,-1
26958,26958,26959,6,1,-5
26959,26959,26960,1,1,0
26960,26960,26961,1,1,0
26961,26961,26962,1,6,5
26962,26962,26963,6,4,-2
26963,26963,26964,4,7,3
26964,26964,26965,7,3,-4
26965,26965,26966,3,7,4
26966,26966,26967,7,7,0
26967,26967,26968,7,1,-6
26968,26968,26969,1,7,6
26969,26969,26970,7,9,2
26970,26970,26971,9,8,-1
26971,26971,26972,8,5,-3
26972,26972,26973,5,9,4
26973,26973,26974,9,2,-7
26974,26974,26975,2,3,1
26975,26975,26976,3,5,2
26976,26976,26977,5,6,1
26977,26977,26978,6,5,-1
26978,26978,26979,5,0,-5
26979,26979,26980,0,0,0
26980,26980,26981,0,3,3
26981,26981,26982,3,7,4
26982,26982,26983,7,6,-1
26983,26983,26984,6,1,-5
26984,26984,26985,1,4,3
26985,26985,26986,4,1,-3
26986,26986,26987,1,8,7
26987,26987,26988,8,6,-2
26988,26988,26989,6,3,-3
26989,26989,26990,3,0,-3
26990,26990,26991,0,1,1
26991,26991,26992,1,4,3
26992,26992,26993,4,1,-3
26993,26993,26994,1,2,1
26994,26994,26995,2,5,3
26995,26995,26996,5,8,3
26996,26996,26997,8,9,1
26997,26997,26998,9,3,-6
26998,26998,26999,3,0,-3
26999,26999,27000,0,5,5
27000,27000,27001,5,4,-1
27001,27001,27002,4,5,1
27002,27002,27003,5,1,-4
27003,27003,27004,1,9,8
27004,27004,27005,9,7,-2
27005,27005,27006,7,6,-1
27006,27006,27007,6,9,3
27007,27007,27008,9,8,-1
27008,27008,27009,8,5,-3
27009,27009,27010,5,2,-3
27010,27010,27011,2,1,-1
27011,27011,27012,1,1,0
27012,27012,27013,1,1,0
27013,27013,27014,1,4,3
27014,27014,27015,4,9,5
27015,27015,27016,9,9,0
27016,27016,27017,9,8,-1
27017,27017,27018,8,1,-7
27018,27018,27019,1,6,5
27019,27019,27020,6,1,-5
27020,27020,27021,1,6,5
27021,27021,27022,6,3,-3
27022,27022,27023,3,0,-3
27023,27023,27024,0,8,8
27024,27024,27025,8,1,-7
27025,27025,27026,1,2,1
27026,27026,27027,2,8,6
27027,27027,27028,8,1,-7
27028,27028,27029,1,8,7
27029,27029,27030,8,8,0
27030,27030,27031,8,3,-5
27031,27031,27032,3,3,0
27032,27032,27033,3,2,-1
27033,27033,27034,2,1,-1
27034,27034,27035,1,0,-1
27035,27035,27036,0,4,4
27036,27036,27037,4,9,5
27037,27037,27038,9,5,-4
27038,27038,27039,5,7,2
27039,27039,27040,7,4,-3
27040,27040,27041,4,4,0
27041,27041,27042,4,5,1
27042,27042,27043,5,5,0
27043,27043,27044,5,4,-1
27044,27044,27045,4,8,4
27045,27045,27046,8,6,-2
27046,27046,27047,6,3,-3
27047,27047,27048,3,8,5
27048,27048,27049,8,5,-3
27049,27049,27050,5,0,-5
27050,27050,27051,0,8,8
27051,27051,27052,8,2,-6
27052,27052,27053,2,5,3
27053,27053,27054,5,7,2
27054,27054,27055,7,4,-3
27055,27055,27056,4,4,0
27056,27056,27057,4,7,3
27057,27057,27058,7,7,0
27058,27058,27059,7,7,0
27059,27059,27060,7,3,-4
27060,27060,27061,3,7,4
27061,27061,27062,7,5,-2
27062,27062,27063,5,1,-4
27063,27063,27064,1,1,0
27064,27064,27065,1,5,4
27065,27065,27066,5,9,4
27066,27066,27067,9,3,-6
27067,27067,27068,3,1,-2
27068,27068,27069,1,0,-1
27069,27069,27070,0,0,0
27070,27070,27071,0,1,1
27071,27071,27072,1,8,7
27072,27072,27073,8,2,-6
27073,27073,27074,2,9,7
27074,27074,27075,9,3,-6
27075,27075,27076,3,8,5
27076,27076,27077,8,4,-4
27077,27077,27078,4,3,-1
27078,27078,27079,3,5,2
27079,27079,27080,5,4,-1
27080,27080,27081,4,6,2
27081,27081,27082,6,0,-6
27082,27082,27083,0,7,7
27083,27083,27084,7,3,-4
27084,27084,27085,3,8,5
27085,27085,27086,8,6,-2
27086,27086,27087,6,9,3
27087,27087,27088,9,4,-5
27088,27088,27089,4,0,-4
27089,27089,27090,0,6,6
27090,27090,27091,6,1,-5
27091,27091,27092,1,0,-1
27092,27092,27093,0,2,2
27093,27093,27094,2,0,-2
27094,27094,27095,0,3,3
27095,27095,27096,3,8,5
27096,27096,27097,8,4,-4
27097,27097,27098,4,7,3
27098,27098,27099,7,5,-2
27099,27099,27100,5,5,0
27100,27100,27101,5,6,1
27101,27101,27102,6,4,-2
27102,27102,27103,4,7,3
27103,27103,27104,7,1,-6
27104,27104,27105,1,8,7
27105,27105,27106,8,8,0
27106,27106,27107,8,9,1
27107,27107,27108,9,2,-7
27108,27108,27109,2,0,-2
27109,27109,27110,0,9,9
27110,27110,27111,9,1,-8
27111,27111,27112,1,9,8
27112,27112,27113,9,2,-7
27113,27113,27114,2,0,-2
27114,27114,27115,0,3,3
27115,27115,27116,3,9,6
27116,27116,27117,9,5,-4
27117,27117,27118,5,8,3
27118,27118,27119,8,6,-2
27119,27119,27120,6,2,-4
27120,27120,27121,2,8,6
27121,27121,27122,8,2,-6
27122,27122,27123,2,1,-1
27123,27123,27124,1,1,0
27124,27124,27125,1,4,3
27125,27125,27126,4,8,4
27126,27126,27127,8,5,-3
27127,27127,27128,5,9,4
27128,27128,27129,9,4,-5
27129,27129,27130,4,9,5
27130,27130,27131,9,2,-7
27131,27131,27132,2,3,1
27132,27132,27133,3,3,0
27133,27133,27134,3,6,3
27134,27134,27135,6,3,-3
27135,27135,27136,3,1,-2
27136,27136,27137,1,0,-1
27137,27137,27138,0,2,2
27138,27138,27139,2,5,3
27139,27139,27140,5,3,-2
27140,27140,27141,3,4,1
27141,27141,27142,4,1,-3
27142,27142,27143,1,3,2
27143,27143,27144,3,7,4
27144,27144,27145,7,0,-7
27145,27145,27146,0,8,8
27146,27146,27147,8,8,0
27147,27147,27148,8,0,-8
27148,27148,27149,0,6,6
27149,27149,27150,6,2,-4
27150,27150,27151,2,7,5
27151,27151,27152,7,3,-4
27152,27152,27153,3,0,-3
27153,27153,27154,0,5,5
27154,27154,27155,5,7,2
27155,27155,27156,7,6,-1
27156,27156,27157,6,7,1
27157,27157,27158,7,7,0
27158,27158,27159,7,1,-6
27159,27159,27160,1,3,2
27160,27160,27161,3,6,3
27161,27161,27162,6,2,-4
27162,27162,27163,2,9,7
27163,27163,27164,9,9,0
27164,27164,27165,9,2,-7
27165,27165,27166,2,7,5
27166,27166,27167,7,3,-4
27167,27167,27168,3,7,4
27168,27168,27169,7,6,-1
27169,27169,27170,6,0,-6
27170,27170,27171,0,2,2
27171,27171,27172,2,3,1
27172,27172,27173,3,3,0
27173,27173,27174,3,9,6
27174,27174,27175,9,6,-3
27175,27175,27176,6,5,-1
27176,27176,27177,5,8,3
27177,27177,27178,8,2,-6
27178,27178,27179,2,5,3
27179,27179,27180,5,4,-1
27180,27180,27181,4,2,-2
27181,27181,27182,2,1,-1
27182,27182,27183,1,3,2
27183,27183,27184,3,7,4
27184,27184,27185,7,8,1
27185,27185,27186,8,2,-6
27186,27186,27187,2,1,-1
27187,27187,27188,1,2,1
27188,27188,27189,2,2,0
27189,27189,27190,2,6,4
27190,27190,27191,6,9,3
27191,27191,27192,9,2,-7
27192,27192,27193,2,5,3
27193,27193,27194,5,7,2
27194,27194,27195,7,8,1
27195,27195,27196,8,4,-4
27196,27196,27197,4,8,4
27197,27197,27198,8,6,-2
27198,27198,27199,6,7,1
27199,27199,27200,7,0,-7
27200,27200,27201,0,1,1
27201,27201,27202,1,1,0
27202,27202,27203,1,7,6
27203,27203,27204,7,6,-1
27204,27204,27205,6,1,-5
27205,27205,27206,1,0,-1
27206,27206,27207,0,1,1
27207,27207,27208,1,6,5
27208,27208,27209,6,0,-6
27209,27209,27210,0,8,8
27210,27210,27211,8,3,-5
27211,27211,27212,3,3,0
27212,27212,27213,3,4,1
27213,27213,27214,4,3,-1
27214,27214,27215,3,2,-1
27215,27215,27216,2,5,3
27216,27216,27217,5,6,1
27217,27217,27218,6,4,-2
27218,27218,27219,4,7,3
27219,27219,27220,7,7,0
27220,27220,27221,7,4,-3
27221,27221,27222,4,4,0
27222,27222,27223,4,2,-2
27223,27223,27224,2,5,3
27224,27224,27225,5,7,2
27225,27225,27226,7,9,2
27226,27226,27227,9,4,-5
27227,27227,27228,4,5,1
27228,27228,27229,5,2,-3
27229,27229,27230,2,9,7
27230,27230,27231,9,9,0
27231,27231,27232,9,2,-7
27232,27232,27233,2,2,0
27233,27233,27234,2,9,7
27234,27234,27235,9,7,-2
27235,27235,27236,7,8,1
27236,27236,27237,8,9,1
27237,27237,27238,9,3,-6
27238,27238,27239,3,2,-1
27239,27239,27240,2,6,4
27240,27240,27241,6,8,2
27241,27241,27242,8,1,-7
27242,27242,27243,1,6,5
27243,27243,27244,6,6,0
27244,27244,27245,6,1,-5
27245,27245,27246,1,0,-1
27246,27246,27247,0,0,0
27247,27247,27248,0,3,3
27248,27248,27249,3,6,3
27249,27249,27250,6,1,-5
27250,27250,27251,1,8,7
27251,27251,27252,8,2,-6
27252,27252,27253,2,5,3
27253,27253,27254,5,7,2
27254,27254,27255,7,5,-2
27255,27255,27256,5,1,-4
27256,27256,27257,1,0,-1
27257,27257,27258,0,2,2
27258,27258,27259,2,5,3
27259,27259,27260,5,9,4
27260,27260,27261,9,3,-6
27261,27261,27262,3,1,-2
27262,27262,27263,1,5,4
27263,27263,27264,5,2,-3
27264,27264,27265,2,7,5
27265,27265,27266,7,6,-1
27266,27266,27267,6,4,-2
27267,27267,27268,4,6,2
27268,27268,27269,6,8,2
27269,27269,27270,8,1,-7
27270,27270,27271,1,5,4
27271,27271,27272,5,4,-1
27272,27272,27273,4,9,5
27273,27273,27274,9,3,-6
27274,27274,27275,3,6,3
27275,27275,27276,6,1,-5
27276,27276,27277,1,9,8
27277,27277,27278,9,8,-1
27278,27278,27279,8,3,-5
27279,27279,27280,3,0,-3
27280,27280,27281,0,0,0
27281,27281,27282,0,3,3
27282,27282,27283,3,0,-3
27283,27283,27284,0,1,1
27284,27284,27285,1,6,5
27285,27285,27286,6,8,2
27286,27286,27287,8,3,-5
27287,27287,27288,3,5,2
27288,27288,27289,5,0,-5
27289,27289,27290,0,0,0
27290,27290,27291,0,5,5
27291,27291,27292,5,7,2
27292,27292,27293,7,8,1
27293,27293,27294,8,8,0
27294,27294,27295,8,9,1
27295,27295,27296,9,5,-4
27296,27296,27297,5,1,-4
27297,27297,27298,1,6,5
27298,27298,27299,6,8,2
27299,27299,27300,8,1,-7
27300,27300,27301,1,1,0
27301,27301,27302,1,7,6
27302,27302,27303,7,6,-1
27303,27303,27304,6,9,3
27304,27304,27305,9,0,-9
27305,27305,27306,0,6,6
27306,27306,27307,6,0,-6
27307,27307,27308,0,4,4
27308,27308,27309,4,1,-3
27309,27309,27310,1,5,4
27310,27310,27311,5,2,-3
27311,27311,27312,2,8,6
27312,27312,27313,8,3,-5
27313,27313,27314,3,5,2
27314,27314,27315,5,4,-1
27315,27315,27316,4,3,-1
27316,27316,27317,3,5,2
27317,27317,27318,5,0,-5
27318,27318,27319,0,6,6
27319,27319,27320,6,6,0
27320,27320,27321,6,7,1
27321,27321,27322,7,0,-7
27322,27322,27323,0,8,8
27323,27323,27324,8,8,0
27324,27324,27325,8,9,1
27325,27325,27326,9,0,-9
27326,27326,27327,0,0,0
27327,27327,27328,0,0,0
27328,27328,27329,0,1,1
27329,27329,27330,1,1,0
27330,27330,27331,1,2,1
27331,27331,27332,2,0,-2
27332,27332,27333,0,3,3
27333,27333,27334,3,9,6
27334,27334,27335,9,4,-5
27335,27335,27336,4,1,-3
27336,27336,27337,1,5,4
27337,27337,27338,5,6,1
27338,27338,27339,6,6,0
27339,27339,27340,6,5,-1
27340,27340,27341,5,7,2
27341,27341,27342,7,9,2
27342,27342,27343,9,0,-9
27343,27343,27344,0,9,9
27344,27344,27345,9,1,-8
27345,27345,27346,1,4,3
27346,27346,27347,4,2,-2
27347,27347,27348,2,8,6
27348,27348,27349,8,3,-5
27349,27349,27350,3,6,3
27350,27350,27351,6,4,-2
27351,27351,27352,4,4,0
27352,27352,27353,4,5,1
27353,27353,27354,5,1,-4
27354,27354,27355,1,6,5
27355,27355,27356,6,2,-4
27356,27356,27357,2,7,5
27357,27357,27358,7,8,1
27358,27358,27359,8,8,0
27359,27359,27360,8,7,-1
27360,27360,27361,7,9,2
27361,27361,27362,9,3,-6
27362,27362,27363,3,6,3
27363,27363,27364,6,4,-2
27364,27364,27365,4,4,0
27365,27365,27366,4,3,-1
27366,27366,27367,3,2,-1
27367,27367,27368,2,9,7
27368,27368,27369,9,6,-3
27369,27369,27370,6,9,3
27370,27370,27371,9,4,-5
27371,27371,27372,4,8,4
27372,27372,27373,8,7,-1
27373,27373,27374,7,2,-5
27374,27374,27375,2,5,3
27375,27375,27376,5,2,-3
27376,27376,27377,2,5,3
27377,27377,27378,5,5,0
27378,27378,27379,5,7,2
27379,27379,27380,7,0,-7
27380,27380,27381,0,8,8
27381,27381,27382,8,6,-2
27382,27382,27383,6,9,3
27383,27383,27384,9,2,-7
27384,27384,27385,2,2,0
27385,27385,27386,2,8,6
27386,27386,27387,8,9,1
27387,27387,27388,9,1,-8
27388,27388,27389,1,3,2
27389,27389,27390,3,6,3
27390,27390,27391,6,9,3
27391,27391,27392,9,7,-2
27392,27392,27393,7,2,-5
27393,27393,27394,2,0,-2
27394,27394,27395,0,0,0
27395,27395,27396,0,1,1
27396,27396,27397,1,9,8
27397,27397,27398,9,4,-5
27398,27398,27399,4,8,4
27399,27399,27400,8,5,-3
27400,27400,27401,5,0,-5
27401,27401,27402,0,6,6
27402,27402,27403,6,5,-1
27403,27403,27404,5,6,1
27404,27404,27405,6,6,0
27405,27405,27406,6,7,1
27406,27406,27407,7,0,-7
27407,27407,27408,0,5,5
27408,27408,27409,5,1,-4
27409,27409,27410,1,1,0
27410,27410,27411,1,0,-1
27411,27411,27412,0,5,5
27412,27412,27413,5,2,-3
27413,27413,27414,2,0,-2
27414,27414,27415,0,6,6
27415,27415,27416,6,5,-1
27416,27416,27417,5,5,0
27417,27417,27418,5,8,3
27418,27418,27419,8,3,-5
27419,27419,27420,3,3,0
27420,27420,27421,3,5,2
27421,27421,27422,5,5,0
27422,27422,27423,5,3,-2
27423,27423,27424,3,4,1
27424,27424,27425,4,8,4
27425,27425,27426,8,2,-6
27426,27426,27427,2,0,-2
27427,27427,27428,0,6,6
27428,27428,27429,6,0,-6
27429,27429,27430,0,9,9
27430,27430,27431,9,5,-4
27431,27431,27432,5,2,-3
27432,27432,27433,2,4,2
27433,27433,27434,4,2,-2
27434,27434,27435,2,3,1
27435,27435,27436,3,0,-3
27436,27436,27437,0,4,4
27437,27437,27438,4,6,2
27438,27438,27439,6,1,-5
27439,27439,27440,1,9,8
27440,27440,27441,9,5,-4
27441,27441,27442,5,6,1
27442,27442,27443,6,3,-3
27443,27443,27444,3,2,-1
27444,27444,27445,2,0,-2
27445,27445,27446,0,0,0
27446,27446,27447,0,8,8
27447,27447,27448,8,9,1
27448,27448,27449,9,6,-3
27449,27449,27450,6,9,3
27450,27450,27451,9,2,-7
27451,27451,27452,2,5,3
27452,27452,27453,5,7,2
27453,27453,27454,7,1,-6
27454,27454,27455,1,1,0
27455,27455,27456,1,2,1
27456,27456,27457,2,1,-1
27457,27457,27458,1,2,1
27458,27458,27459,2,8,6
27459,27459,27460,8,9,1
27460,27460,27461,9,1,-8
27461,27461,27462,1,0,-1
27462,27462,27463,0,7,7
27463,27463,27464,7,2,-5
27464,27464,27465,2,1,-1
27465,27465,27466,1,0,-1
27466,27466,27467,0,3,3
27467,27467,27468,3,7,4
27468,27468,27469,7,8,1
27469,27469,27470,8,2,-6
27470,27470,27471,2,5,3
27471,27471,27472,5,2,-3
27472,27472,27473,2,4,2
27473,27473,27474,4,1,-3
27474,27474,27475,1,2,1
27475,27475,27476,2,4,2
27476,27476,27477,4,0,-4
27477,27477,27478,0,3,3
27478,27478,27479,3,9,6
27479,27479,27480,9,3,-6
27480,27480,27481,3,7,4
27481,27481,27482,7,5,-2
27482,27482,27483,5,6,1
27483,27483,27484,6,0,-6
27484,27484,27485,0,7,7
27485,27485,27486,7,3,-4
27486,27486,27487,3,4,1
27487,27487,27488,4,8,4
27488,27488,27489,8,1,-7
27489,27489,27490,1,2,1
27490,27490,27491,2,6,4
27491,27491,27492,6,0,-6
27492,27492,27493,0,8,8
27493,27493,27494,8,4,-4
27494,27494,27495,4,4,0
27495,27495,27496,4,6,2
27496,27496,27497,6,7,1
27497,27497,27498,7,7,0
27498,27498,27499,7,5,-2
27499,27499,27500,5,5,0
27500,27500,27501,5,1,-4
27501,27501,27502,1,5,4
27502,27502,27503,5,2,-3
27503,27503,27504,2,6,4
27504,27504,27505,6,6,0
27505,27505,27506,6,1,-5
27506,27506,27507,1,7,6
27507,27507,27508,7,8,1
27508,27508,27509,8,1,-7
27509,27509,27510,1,5,4
27510,27510,27511,5,9,4
27511,27511,27512,9,0,-9
27512,27512,27513,0,8,8
27513,27513,27514,8,4,-4
27514,27514,27515,4,9,5
27515,27515,27516,9,7,-2
27516,27516,27517,7,4,-3
27517,27517,27518,4,3,-1
27518,27518,27519,3,9,6
27519,27519,27520,9,2,-7
27520,27520,27521,2,9,7
27521,27521,27522,9,7,-2
27522,27522,27523,7,6,-1
27523,27523,27524,6,8,2
27524,27524,27525,8,2,-6
27525,27525,27526,2,5,3
27526,27526,27527,5,3,-2
27527,27527,27528,3,1,-2
27528,27528,27529,1,7,6
27529,27529,27530,7,6,-1
27530,27530,27531,6,1,-5
27531,27531,27532,1,7,6
27532,27532,27533,7,9,2
27533,27533,27534,9,3,-6
27534,27534,27535,3,2,-1
27535,27535,27536,2,6,4
27536,27536,27537,6,2,-4
27537,27537,27538,2,4,2
27538,27538,27539,4,5,1
27539,27539,27540,5,3,-2
27540,27540,27541,3,3,0
27541,27541,27542,3,7,4
27542,27542,27543,7,7,0
27543,27543,27544,7,0,-7
27544,27544,27545,0,8,8
27545,27545,27546,8,7,-1
27546,27546,27547,7,0,-7
27547,27547,27548,0,2,2
27548,27548,27549,2,1,-1
27549,27549,27550,1,0,-1
27550,27550,27551,0,2,2
27551,27551,27552,2,4,2
27552,27552,27553,4,3,-1
27553,27553,27554,3,7,4
27554,27554,27555,7,4,-3
27555,27555,27556,4,6,2
27556,27556,27557,6,5,-1
27557,27557,27558,5,1,-4
27558,27558,27559,1,6,5
27559,27559,27560,6,3,-3
27560,27560,27561,3,7,4
27561,27561,27562,7,8,1
27562,27562,27563,8,8,0
27563,27563,27564,8,1,-7
27564,27564,27565,1,9,8
27565,27565,27566,9,9,0
27566,27566,27567,9,0,-9
27567,27567,27568,0,8,8
27568,27568,27569,8,1,-7
27569,27569,27570,1,3,2
27570,27570,27571,3,2,-1
27571,27571,27572,2,1,-1
27572,27572,27573,1,3,2
27573,27573,27574,3,7,4
27574,27574,27575,7,4,-3
27575,27575,27576,4,5,1
27576,27576,27577,5,7,2
27577,27577,27578,7,1,-6
27578,27578,27579,1,8,7
27579,27579,27580,8,0,-8
27580,27580,27581,0,9,9
27581,27581,27582,9,1,-8
27582,27582,27583,1,0,-1
27583,27583,27584,0,4,4
27584,27584,27585,4,1,-3
27585,27585,27586,1,4,3
27586,27586,27587,4,2,-2
27587,27587,27588,2,4,2
27588,27588,27589,4,3,-1
27589,27589,27590,3,1,-2
27590,27590,27591,1,4,3
27591,27591,27592,4,7,3
27592,27592,27593,7,5,-2
27593,27593,27594,5,5,0
27594,27594,27595,5,6,1
27595,27595,27596,6,8,2
27596,27596,27597,8,7,-1
27597,27597,27598,7,2,-5
27598,27598,27599,2,8,6
27599,27599,27600,8,2,-6
27600,27600,27601,2,9,7
27601,27601,27602,9,5,-4
27602,27602,27603,5,0,-5
27603,27603,27604,0,1,1
27604,27604,27605,1,9,8
27605,27605,27606,9,8,-1
27606,27606,27607,8,5,-3
27607,27607,27608,5,8,3
27608,27608,27609,8,0,-8
27609,27609,27610,0,3,3
27610,27610,27611,3,9,6
27611,27611,27612,9,4,-5
27612,27612,27613,4,8,4
27613,27613,27614,8,2,-6
27614,27614,27615,2,9,7
27615,27615,27616,9,8,-1
27616,27616,27617,8,4,-4
27617,27617,27618,4,2,-2
27618,27618,27619,2,1,-1
27619,27619,27620,1,0,-1
27620,27620,27621,0,7,7
27621,27621,27622,7,2,-5
27622,27622,27623,2,7,5
27623,27623,27624,7,6,-1
27624,27624,27625,6,3,-3
27625,27625,27626,3,9,6
27626,27626,27627,9,5,-4
27627,27627,27628,5,0,-5
27628,27628,27629,0,1,1
27629,27629,27630,1,1,0
27630,27630,27631,1,0,-1
27631,27631,27632,0,7,7
27632,27632,27633,7,0,-7
27633,27633,27634,0,1,1
27634,27634,27635,1,7,6
27635,27635,27636,7,8,1
27636,27636,27637,8,0,-8
27637,27637,27638,0,0,0
27638,27638,27639,0,1,1
27639,27639,27640,1,3,2
27640,27640,27641,3,2,-1
27641,27641,27642,2,6,4
27642,27642,27643,6,2,-4
27643,27643,27644,2,3,1
27644,27644,27645,3,3,0
27645,27645,27646,3,8,5
27646,27646,27647,8,7,-1
27647,27647,27648,7,5,-2
27648,27648,27649,5,3,-2
27649,27649,27650,3,8,5
27650,27650,27651,8,3,-5
27651,27651,27652,3,2,-1
27652,27652,27653,2,6,4
27653,27653,27654,6,9,3
27654,27654,27655,9,6,-3
27655,27655,27656,6,5,-1
27656,27656,27657,5,1,-4
27657,27657,27658,1,0,-1
27658,27658,27659,0,0,0
27659,27659,27660,0,2,2
27660,27660,27661,2,9,7
27661,27661,27662,9,1,-8
27662,27662,27663,1,0,-1
27663,27663,27664,0,2,2
27664,27664,27665,2,1,-1
27665,27665,27666,1,3,2
27666,27666,27667,3,7,4
27667,27667,27668,7,5,-2
27668,27668,27669,5,6,1
27669,27669,27670,6,3,-3
27670,27670,27671,3,3,0
27671,27671,27672,3,2,-1
27672,27672,27673,2,2,0
27673,27673,27674,2,6,4
27674,27674,27675,6,3,-3
27675,27675,27676,3,4,1
27676,27676,27677,4,1,-3
27677,27677,27678,1,8,7
27678,27678,27679,8,9,1
27679,27679,27680,9,2,-7
27680,27680,27681,2,1,-1
27681,27681,27682,1,6,5
27682,27682,27683,6,7,1
27683,27683,27684,7,1,-6
27684,27684,27685,1,6,5
27685,27685,27686,6,4,-2
27686,27686,27687,4,8,4
27687,27687,27688,8,9,1
27688,27688,27689,9,4,-5
27689,27689,27690,4,3,-1
27690,27690,27691,3,3,0
27691,27691,27692,3,9,6
27692,27692,27693,9,1,-8
27693,27693,27694,1,4,3
27694,27694,27695,4,4,0
27695,27695,27696,4,2,-2
27696,27696,27697,2,0,-2
27697,27697,27698,0,9,9
27698,27698,27699,9,5,-4
27699,27699,27700,5,2,-3
27700,27700,27701,2,3,1
27701,27701,27702,3,6,3
27702,27702,27703,6,6,0
27703,27703,27704,6,6,0
27704,27704,27705,6,9,3
27705,27705,27706,9,7,-2
27706,27706,27707,7,1,-6
27707,27707,27708,1,6,5
27708,27708,27709,6,7,1
27709,27709,27710,7,9,2
27710,27710,27711,9,5,-4
27711,27711,27712,5,0,-5
27712,27712,27713,0,4,4
27713,27713,27714,4,7,3
27714,27714,27715,7,4,-3
27715,27715,27716,4,7,3
27716,27716,27717,7,7,0
27717,27717,27718,7,3,-4
27718,27718,27719,3,2,-1
27719,27719,27720,2,0,-2
27720,27720,27721,0,2,2
27721,27721,27722,2,7,5
27722,27722,27723,7,7,0
27723,27723,27724,7,6,-1
27724,27724,27725,6,9,3
27725,27725,27726,9,3,-6
27726,27726,27727,3,5,2
27727,27727,27728,5,7,2
27728,27728,27729,7,8,1
27729,27729,27730,8,9,1
27730,27730,27731,9,9,0
27731,27731,27732,9,9,0
27732,27732,27733,9,8,-1
27733,27733,27734,8,9,1
27734,27734,27735,9,0,-9
27735,27735,27736,0,2,2
27736,27736,27737,2,1,-1
27737,27737,27738,1,4,3
27738,27738,27739,4,2,-2
27739,27739,27740,2,8,6
27740,27740,27741,8,3,-5
27741,27741,27742,3,5,2
27742,27742,27743,5,4,-1
27743,27743,27744,4,1,-3
27744,27744,27745,1,5,4
27745,27745,27746,5,1,-4
27746,27746,27747,1,7,6
27747,27747,27748,7,9,2
27748,27748,27749,9,0,-9
27749,27749,27750,0,6,6
27750,27750,27751,6,1,-5
27751,27751,27752,1,2,1
27752,27752,27753,2,2,0
27753,27753,27754,2,2,0
27754,27754,27755,2,3,1
27755,27755,27756,3,7,4
27756,27756,27757,7,6,-1
27757,27757,27758,6,7,1
27758,27758,27759,7,1,-6
27759,27759,27760,1,5,4
27760,27760,27761,5,2,-3
27761,27761,27762,2,8,6
27762,27762,27763,8,3,-5
27763,27763,27764,3,5,2
27764,27764,27765,5,4,-1
27765,27765,27766,4,9,5
27766,27766,27767,9,5,-4
27767,27767,27768,5,2,-3
27768,27768,27769,2,6,4
27769,27769,27770,6,2,-4
27770,27770,27771,2,9,7
27771,27771,27772,9,1,-8
27772,27772,27773,1,9,8
27773,27773,27774,9,9,0
27774,27774,27775,9,6,-3
27775,27775,27776,6,4,-2
27776,27776,27777,4,5,1
27777,27777,27778,5,5,0
27778,27778,27779,5,9,4
27779,27779,27780,9,9,0
27780,27780,27781,9,2,-7
27781,27781,27782,2,4,2
27782,27782,27783,4,3,-1
27783,27783,27784,3,3,0
27784,27784,27785,3,1,-2
27785,27785,27786,1,3,2
27786,27786,27787,3,2,-1
27787,27787,27788,2,0,-2
27788,27788,27789,0,1,1
27789,27789,27790,1,1,0
27790,27790,27791,1,2,1
27791,27791,27792,2,1,-1
27792,27792,27793,1,1,0
27793,27793,27794,1,6,5
27794,27794,27795,6,3,-3
27795,27795,27796,3,6,3
27796,27796,27797,6,2,-4
27797,27797,27798,2,8,6
27798,27798,27799,8,6,-2
27799,27799,27800,6,4,-2
27800,27800,27801,4,5,1
27801,27801,27802,5,5,0
27802,27802,27803,5,3,-2
27803,27803,27804,3,3,0
27804,27804,27805,3,0,-3
27805,27805,27806,0,0,0
27806,27806,27807,0,6,6
27807,27807,27808,6,7,1
27808,27808,27809,7,4,-3
27809,27809,27810,4,2,-2
27810,27810,27811,2,0,-2
27811,27811,27812,0,6,6
27812,27812,27813,6,5,-1
27813,27813,27814,5,5,0
27814,27814,27815,5,9,4
27815,27815,27816,9,1,-8
27816,27816,27817,1,9,8
27817,27817,27818,9,5,-4
27818,27818,27819,5,8,3
27819,27819,27820,8,0,-8
27820,27820,27821,0,1,1
27821,27821,27822,1,0,-1
27822,27822,27823,0,7,7
27823,27823,27824,7,4,-3
27824,27824,27825,4,4,0
27825,27825,27826,4,4,0
27826,27826,27827,4,7,3
27827,27827,27828,7,3,-4
27828,27828,27829,3,0,-3
27829,27829,27830,0,7,7
27830,27830,27831,7,1,-6
27831,27831,27832,1,4,3
27832,27832,27833,4,6,2
27833,27833,27834,6,2,-4
27834,27834,27835,2,3,1
27835,27835,27836,3,1,-2
27836,27836,27837,1,7,6
27837,27837,27838,7,3,-4
27838,27838,27839,3,9,6
27839,27839,27840,9,3,-6
27840,27840,27841,3,0,-3
27841,27841,27842,0,6,6
27842,27842,27843,6,9,3
27843,27843,27844,9,2,-7
27844,27844,27845,2,5,3
27845,27845,27846,5,9,4
27846,27846,27847,9,3,-6
27847,27847,27848,3,9,6
27848,27848,27849,9,8,-1
27849,27849,27850,8,6,-2
27850,27850,27851,6,8,2
27851,27851,27852,8,2,-6
27852,27852,27853,2,7,5
27853,27853,27854,7,0,-7
27854,27854,27855,0,1,1
27855,27855,27856,1,3,2
27856,27856,27857,3,4,1
27857,27857,27858,4,6,2
27858,27858,27859,6,0,-6
27859,27859,27860,0,2,2
27860,27860,27861,2,3,1
27861,27861,27862,3,7,4
27862,27862,27863,7,9,2
27863,27863,27864,9,2,-7
27864,27864,27865,2,0,-2
27865,27865,27866,0,3,3
27866,27866,27867,3,7,4
27867,27867,27868,7,7,0
27868,27868,27869,7,2,-5
27869,27869,27870,2,3,1
27870,27870,27871,3,1,-2
27871,27871,27872,1,7,6
27872,27872,27873,7,9,2
27873,27873,27874,9,2,-7
27874,27874,27875,2,1,-1
27875,27875,27876,1,9,8
27876,27876,27877,9,5,-4
27877,27877,27878,5,2,-3
27878,27878,27879,2,1,-1
27879,27879,27880,1,2,1
27880,27880,27881,2,7,5
27881,27881,27882,7,4,-3
27882,27882,27883,4,2,-2
27883,27883,27884,2,9,7
27884,27884,27885,9,1,-8
27885,27885,27886,1,1,0
27886,27886,27887,1,6,5
27887,27887,27888,6,2,-4
27888,27888,27889,2,8,6
27889,27889,27890,8,6,-2
27890,27890,27891,6,8,2
27891,27891,27892,8,8,0
27892,27892,27893,8,0,-8
27893,27893,27894,0,0,0
27894,27894,27895,0,1,1
27895,27895,27896,1,1,0
27896,27896,27897,1,2,1
27897,27897,27898,2,2,0
27898,27898,27899,2,3,1
27899,27899,27900,3,0,-3
27900,27900,27901,0,4,4
27901,27901,27902,4,9,5
27902,27902,27903,9,5,-4
27903,27903,27904,5,9,4
27904,27904,27905,9,6,-3
27905,27905,27906,6,7,1
27906,27906,27907,7,8,1
27907,27907,27908,8,9,1
27908,27908,27909,9,9,0
27909,27909,27910,9,8,-1
27910,27910,27911,8,0,-8
27911,27911,27912,0,7,7
27912,27912,27913,7,1,-6
27913,27913,27914,1,4,3
27914,27914,27915,4,2,-2
27915,27915,27916,2,8,6
27916,27916,27917,8,3,-5
27917,27917,27918,3,8,5
27918,27918,27919,8,4,-4
27919,27919,27920,4,1,-3
27920,27920,27921,1,5,4
27921,27921,27922,5,4,-1
27922,27922,27923,4,6,2
27923,27923,27924,6,1,-5
27924,27924,27925,1,7,6
27925,27925,27926,7,9,2
27926,27926,27927,9,8,-1
27927,27927,27928,8,2,-6
27928,27928,27929,2,9,7
27929,27929,27930,9,3,-6
27930,27930,27931,3,0,-3
27931,27931,27932,0,9,9
27932,27932,27933,9,1,-8
27933,27933,27934,1,6,5
27934,27934,27935,6,2,-4
27935,27935,27936,2,0,-2
27936,27936,27937,0,3,3
27937,27937,27938,3,7,4
27938,27938,27939,7,4,-3
27939,27939,27940,4,6,2
27940,27940,27941,6,5,-1
27941,27941,27942,5,5,0
27942,27942,27943,5,6,1
27943,27943,27944,6,7,1
27944,27944,27945,7,7,0
27945,27945,27946,7,3,-4
27946,27946,27947,3,8,5
27947,27947,27948,8,4,-4
27948,27948,27949,4,9,5
27949,27949,27950,9,7,-2
27950,27950,27951,7,0,-7
27951,27951,27952,0,5,5
27952,27952,27953,5,9,4
27953,27953,27954,9,5,-4
27954,27954,27955,5,4,-1
27955,27955,27956,4,7,3
27956,27956,27957,7,2,-5
27957,27957,27958,2,8,6
27958,27958,27959,8,4,-4
27959,27959,27960,4,3,-1
27960,27960,27961,3,1,-2
27961,27961,27962,1,6,5
27962,27962,27963,6,5,-1
27963,27963,27964,5,8,3
27964,27964,27965,8,6,-2
27965,27965,27966,6,9,3
27966,27966,27967,9,1,-8
27967,27967,27968,1,9,8
27968,27968,27969,9,1,-8
27969,27969,27970,1,7,6
27970,27970,27971,7,7,0
27971,27971,27972,7,8,1
27972,27972,27973,8,8,0
27973,27973,27974,8,8,0
27974,27974,27975,8,5,-3
27975,27975,27976,5,7,2
27976,27976,27977,7,3,-4
27977,27977,27978,3,1,-2
27978,27978,27979,1,4,3
27979,27979,27980,4,4,0
27980,27980,27981,4,6,2
27981,27981,27982,6,0,-6
27982,27982,27983,0,7,7
27983,27983,27984,7,7,0
27984,27984,27985,7,0,-7
27985,27985,27986,0,7,7
27986,27986,27987,7,3,-4
27987,27987,27988,3,3,0
27988,27988,27989,3,2,-1
27989,27989,27990,2,0,-2
27990,27990,27991,0,6,6
27991,27991,27992,6,6,0
27992,27992,27993,6,9,3
27993,27993,27994,9,8,-1
27994,27994,27995,8,8,0
27995,27995,27996,8,5,-3
27996,27996,27997,5,5,0
27997,27997,27998,5,8,3
27998,27998,27999,8,8,0
27999,27999,28000,8,1,-7
28000,28000,28001,1,6,5
28001,28001,28002,6,0,-6
28002,28002,28003,0,8,8
28003,28003,28004,8,7,-1
28004,28004,28005,7,9,2
28005,28005,28006,9,3,-6
28006,28006,28007,3,9,6
28007,28007,28008,9,4,-5
28008,28008,28009,4,7,3
28009,28009,28010,7,8,1
28010,28010,28011,8,7,-1
28011,28011,28012,7,7,0
28012,28012,28013,7,2,-5
28013,28013,28014,2,7,5
28014,28014,28015,7,1,-6
28015,28015,28016,1,0,-1
28016,28016,28017,0,1,1
28017,28017,28018,1,1,0
28018,28018,28019,1,1,0
28019,28019,28020,1,4,3
28020,28020,28021,4,2,-2
28021,28021,28022,2,4,2
28022,28022,28023,4,8,4
28023,28023,28024,8,0,-8
28024,28024,28025,0,7,7
28025,28025,28026,7,3,-4
28026,28026,28027,3,6,3
28027,28027,28028,6,4,-2
28028,28028,28029,4,5,1
28029,28029,28030,5,0,-5
28030,28030,28031,0,3,3
28031,28031,28032,3,3,0
28032,28032,28033,3,8,5
28033,28033,28034,8,4,-4
28034,28034,28035,4,1,-3
28035,28035,28036,1,4,3
28036,28036,28037,4,3,-1
28037,28037,28038,3,1,-2
28038,28038,28039,1,6,5
28039,28039,28040,6,5,-1
28040,28040,28041,5,0,-5
28041,28041,28042,0,8,8
28042,28042,28043,8,4,-4
28043,28043,28044,4,0,-4
28044,28044,28045,0,8,8
28045,28045,28046,8,5,-3
28046,28046,28047,5,9,4
28047,28047,28048,9,5,-4
28048,28048,28049,5,4,-1
28049,28049,28050,4,2,-2
28050,28050,28051,2,9,7
28051,28051,28052,9,2,-7
28052,28052,28053,2,7,5
28053,28053,28054,7,8,1
28054,28054,28055,8,9,1
28055,28055,28056,9,1,-8
28056,28056,28057,1,5,4
28057,28057,28058,5,9,4
28058,28058,28059,9,2,-7
28059,28059,28060,2,5,3
28060,28060,28061,5,7,2
28061,28061,28062,7,9,2
28062,28062,28063,9,1,-8
28063,28063,28064,1,7,6
28064,28064,28065,7,8,1
28065,28065,28066,8,6,-2
28066,28066,28067,6,2,-4
28067,28067,28068,2,2,0
28068,28068,28069,2,1,-1
28069,28069,28070,1,6,5
28070,28070,28071,6,7,1
28071,28071,28072,7,0,-7
28072,28072,28073,0,7,7
28073,28073,28074,7,2,-5
28074,28074,28075,2,3,1
28075,28075,28076,3,0,-3
28076,28076,28077,0,2,2
28077,28077,28078,2,2,0
28078,28078,28079,2,0,-2
28079,28079,28080,0,5,5
28080,28080,28081,5,4,-1
28081,28081,28082,4,7,3
28082,28082,28083,7,6,-1
28083,28083,28084,6,6,0
28084,28084,28085,6,6,0
28085,28085,28086,6,4,-2
28086,28086,28087,4,9,5
28087,28087,28088,9,9,0
28088,28088,28089,9,4,-5
28089,28089,28090,4,1,-3
28090,28090,28091,1,2,1
28091,28091,28092,2,9,7
28092,28092,28093,9,8,-1
28093,28093,28094,8,1,-7
28094,28094,28095,1,2,1
28095,28095,28096,2,4,2
28096,28096,28097,4,5,1
28097,28097,28098,5,1,-4
28098,28098,28099,1,1,0
28099,28099,28100,1,1,0
28100,28100,28101,1,0,-1
28101,28101,28102,0,0,0
28102,28102,28103,0,5,5
28103,28103,28104,5,6,1
28104,28104,28105,6,0,-6
28105,28105,28106,0,7,7
28106,28106,28107,7,3,-4
28107,28107,28108,3,0,-3
28108,28108,28109,0,4,4
28109,28109,28110,4,1,-3
28110,28110,28111,1,3,2
28111,28111,28112,3,2,-1
28112,28112,28113,2,9,7
28113,28113,28114,9,9,0
28114,28114,28115,9,6,-3
28115,28115,28116,6,5,-1
28116,28116,28117,5,7,2
28117,28117,28118,7,7,0
28118,28118,28119,7,3,-4
28119,28119,28120,3,7,4
28120,28120,28121,7,4,-3
28121,28121,28122,4,0,-4
28122,28122,28123,0,3,3
28123,28123,28124,3,4,1
28124,28124,28125,4,0,-4
28125,28125,28126,0,2,2
28126,28126,28127,2,6,4
28127,28127,28128,6,4,-2
28128,28128,28129,4,9,5
28129,28129,28130,9,1,-8
28130,28130,28131,1,0,-1
28131,28131,28132,0,3,3
28132,28132,28133,3,1,-2
28133,28133,28134,1,1,0
28134,28134,28135,1,2,1
28135,28135,28136,2,8,6
28136,28136,28137,8,3,-5
28137,28137,28138,3,7,4
28138,28138,28139,7,4,-3
28139,28139,28140,4,2,-2
28140,28140,28141,2,5,3
28141,28141,28142,5,6,1
28142,28142,28143,6,6,0
28143,28143,28144,6,8,2
28144,28144,28145,8,7,-1
28145,28145,28146,7,4,-3
28146,28146,28147,4,8,4
28147,28147,28148,8,5,-3
28148,28148,28149,5,9,4
28149,28149,28150,9,6,-3
28150,28150,28151,6,0,-6
28151,28151,28152,0,6,6
28152,28152,28153,6,1,-5
28153,28153,28154,1,2,1
28154,28154,28155,2,2,0
28155,28155,28156,2,2,0
28156,28156,28157,2,3,1
28157,28157,28158,3,7,4
28158,28158,28159,7,4,-3
28159,28159,28160,4,0,-4
28160,28160,28161,0,5,5
28161,28161,28162,5,6,1
28162,28162,28163,6,6,0
28163,28163,28164,6,4,-2
28164,28164,28165,4,0,-4
28165,28165,28166,0,1,1
28166,28166,28167,1,1,0
28167,28167,28168,1,9,8
28168,28168,28169,9,2,-7
28169,28169,28170,2,6,4
28170,28170,28171,6,3,-3
28171,28171,28172,3,5,2
28172,28172,28173,5,4,-1
28173,28173,28174,4,3,-1
28174,28174,28175,3,5,2
28175,28175,28176,5,9,4
28176,28176,28177,9,6,-3
28177,28177,28178,6,5,-1
28178,28178,28179,5,7,2
28179,28179,28180,7,7,0
28180,28180,28181,7,8,1
28181,28181,28182,8,8,0
28182,28182,28183,8,9,1
28183,28183,28184,9,1,-8
28184,28184,28185,1,2,1
28185,28185,28186,2,0,-2
28186,28186,28187,0,1,1
28187,28187,28188,1,8,7
28188,28188,28189,8,2,-6
28189,28189,28190,2,4,2
28190,28190,28191,4,1,-3
28191,28191,28192,1,9,8
28192,28192,28193,9,3,-6
28193,28193,28194,3,9,6
28194,28194,28195,9,9,0
28195,28195,28196,9,1,-8
28196,28196,28197,1,9,8
28197,28197,28198,9,8,-1
28198,28198,28199,8,3,-5
28199,28199,28200,3,2,-1
28200,28200,28201,2,7,5
28201,28201,28202,7,0,-7
28202,28202,28203,0,0,0
28203,28203,28204,0,3,3
28204,28204,28205,3,7,4
28205,28205,28206,7,8,1
28206,28206,28207,8,7,-1
28207,28207,28208,7,1,-6
28208,28208,28209,1,5,4
28209,28209,28210,5,2,-3
28210,28210,28211,2,7,5
28211,28211,28212,7,2,-5
28212,28212,28213,2,9,7
28213,28213,28214,9,2,-7
28214,28214,28215,2,9,7
28215,28215,28216,9,6,-3
28216,28216,28217,6,4,-2
28217,28217,28218,4,2,-2
28218,28218,28219,2,7,5
28219,28219,28220,7,7,0
28220,28220,28221,7,0,-7
28221,28221,28222,0,6,6
28222,28222,28223,6,1,-5
28223,28223,28224,1,3,2
28224,28224,28225,3,4,1
28225,28225,28226,4,8,4
28226,28226,28227,8,4,-4
28227,28227,28228,4,2,-2
28228,28228,28229,2,7,5
28229,28229,28230,7,0,-7
28230,28230,28231,0,5,5
28231,28231,28232,5,1,-4
28232,28232,28233,1,8,7
28233,28233,28234,8,2,-6
28234,28234,28235,2,1,-1
28235,28235,28236,1,7,6
28236,28236,28237,7,4,-3
28237,28237,28238,4,1,-3
28238,28238,28239,1,9,8
28239,28239,28240,9,9,0
28240,28240,28241,9,8,-1
28241,28241,28242,8,0,-8
28242,28242,28243,0,4,4
28243,28243,28244,4,1,-3
28244,28244,28245,1,1,0
28245,28245,28246,1,1,0
28246,28246,28247,1,8,7
28247,28247,28248,8,4,-4
28248,28248,28249,4,6,2
28249,28249,28250,6,1,-5
28250,28250,28251,1,6,5
28251,28251,28252,6,3,-3
28252,28252,28253,3,4,1
28253,28253,28254,4,5,1
28254,28254,28255,5,6,1
28255,28255,28256,6,3,-3
28256,28256,28257,3,0,-3
28257,28257,28258,0,5,5
28258,28258,28259,5,5,0
28259,28259,28260,5,9,4
28260,28260,28261,9,5,-4
28261,28261,28262,5,9,4
28262,28262,28263,9,3,-6
28263,28263,28264,3,3,0
28264,28264,28265,3,3,0
28265,28265,28266,3,2,-1
28266,28266,28267,2,5,3
28267,28267,28268,5,2,-3
28268,28268,28269,2,2,0
28269,28269,28270,2,7,5
28270,28270,28271,7,5,-2
28271,28271,28272,5,0,-5
28272,28272,28273,0,7,7
28273,28273,28274,7,0,-7
28274,28274,28275,0,2,2
28275,28275,28276,2,3,1
28276,28276,28277,3,5,2
28277,28277,28278,5,2,-3
28278,28278,28279,2,9,7
28279,28279,28280,9,5,-4
28280,28280,28281,5,6,1
28281,28281,28282,6,2,-4
28282,28282,28283,2,9,7
28283,28283,28284,9,2,-7
28284,28284,28285,2,2,0
28285,28285,28286,2,0,-2
28286,28286,28287,0,6,6
28287,28287,28288,6,9,3
28288,28288,28289,9,2,-7
28289,28289,28290,2,4,2
28290,28290,28291,4,1,-3
28291,28291,28292,1,1,0
28292,28292,28293,1,2,1
28293,28293,28294,2,2,0
28294,28294,28295,2,0,-2
28295,28295,28296,0,0,0
28296,28296,28297,0,8,8
28297,28297,28298,8,7,-1
28298,28298,28299,7,3,-4
28299,28299,28300,3,1,-2
28300,28300,28301,1,8,7
28301,28301,28302,8,6,-2
28302,28302,28303,6,3,-3
28303,28303,28304,3,4,1
28304,28304,28305,4,0,-4
28305,28305,28306,0,8,8
28306,28306,28307,8,8,0
28307,28307,28308,8,9,1
28308,28308,28309,9,7,-2
28309,28309,28310,7,4,-3
28310,28310,28311,4,4,0
28311,28311,28312,4,4,0
28312,28312,28313,4,9,5
28313,28313,28314,9,7,-2
28314,28314,28315,7,5,-2
28315,28315,28316,5,3,-2
28316,28316,28317,3,0,-3
28317,28317,28318,0,1,1
28318,28318,28319,1,9,8
28319,28319,28320,9,6,-3
28320,28320,28321,6,7,1
28321,28321,28322,7,1,-6
28322,28322,28323,1,0,-1
28323,28323,28324,0,2,2
28324,28324,28325,2,0,-2
28325,28325,28326,0,6,6
28326,28326,28327,6,4,-2
28327,28327,28328,4,0,-4
28328,28328,28329,0,9,9
28329,28329,28330,9,9,0
28330,28330,28331,9,1,-8
28331,28331,28332,1,5,4
28332,28332,28333,5,6,1
28333,28333,28334,6,1,-5
28334,28334,28335,1,2,1
28335,28335,28336,2,2,0
28336,28336,28337,2,7,5
28337,28337,28338,7,8,1
28338,28338,28339,8,6,-2
28339,28339,28340,6,5,-1
28340,28340,28341,5,8,3
28341,28341,28342,8,8,0
28342,28342,28343,8,3,-5
28343,28343,28344,3,3,0
28344,28344,28345,3,5,2
28345,28345,28346,5,9,4
28346,28346,28347,9,2,-7
28347,28347,28348,2,8,6
28348,28348,28349,8,1,-7
28349,28349,28350,1,1,0
28350,28350,28351,1,8,7
28351,28351,28352,8,8,0
28352,28352,28353,8,6,-2
28353,28353,28354,6,9,3
28354,28354,28355,9,1,-8
28355,28355,28356,1,5,4
28356,28356,28357,5,0,-5
28357,28357,28358,0,0,0
28358,28358,28359,0,3,3
28359,28359,28360,3,5,2
28360,28360,28361,5,1,-4
28361,28361,28362,1,7,6
28362,28362,28363,7,4,-3
28363,28363,28364,4,8,4
28364,28364,28365,8,0,-8
28365,28365,28366,0,2,2
28366,28366,28367,2,1,-1
28367,28367,28368,1,9,8
28368,28368,28369,9,2,-7
28369,28369,28370,2,2,0
28370,28370,28371,2,3,1
28371,28371,28372,3,5,2
28372,28372,28373,5,4,-1
28373,28373,28374,4,3,-1
28374,28374,28375,3,5,2
28375,28375,28376,5,5,0
28376,28376,28377,5,6,1
28377,28377,28378,6,1,-5
28378,28378,28379,1,7,6
28379,28379,28380,7,3,-4
28380,28380,28381,3,8,5
28381,28381,28382,8,6,-2
28382,28382,28383,6,9,3
28383,28383,28384,9,5,-4
28384,28384,28385,5,0,-5
28385,28385,28386,0,6,6
28386,28386,28387,6,1,-5
28387,28387,28388,1,2,1
28388,28388,28389,2,2,0
28389,28389,28390,2,8,6
28390,28390,28391,8,3,-5
28391,28391,28392,3,3,0
28392,28392,28393,3,4,1
28393,28393,28394,4,1,-3
28394,28394,28395,1,5,4
28395,28395,28396,5,9,4
28396,28396,28397,9,6,-3
28397,28397,28398,6,4,-2
28398,28398,28399,4,7,3
28399,28399,28400,7,6,-1
28400,28400,28401,6,8,2
28401,28401,28402,8,0,-8
28402,28402,28403,0,0,0
28403,28403,28404,0,2,2
28404,28404,28405,2,1,-1
28405,28405,28406,1,3,2
28406,28406,28407,3,2,-1
28407,28407,28408,2,0,-2
28408,28408,28409,0,3,3
28409,28409,28410,3,5,2
28410,28410,28411,5,1,-4
28411,28411,28412,1,0,-1
28412,28412,28413,0,5,5
28413,28413,28414,5,0,-5
28414,28414,28415,0,6,6
28415,28415,28416,6,9,3
28416,28416,28417,9,7,-2
28417,28417,28418,7,3,-4
28418,28418,28419,3,8,5
28419,28419,28420,8,1,-7
28420,28420,28421,1,7,6
28421,28421,28422,7,9,2
28422,28422,28423,9,0,-9
28423,28423,28424,0,9,9
28424,28424,28425,9,6,-3
28425,28425,28426,6,4,-2
28426,28426,28427,4,0,-4
28427,28427,28428,0,0,0
28428,28428,28429,0,7,7
28429,28429,28430,7,5,-2
28430,28430,28431,5,3,-2
28431,28431,28432,3,8,5
28432,28432,28433,8,8,0
28433,28433,28434,8,5,-3
28434,28434,28435,5,6,1
28435,28435,28436,6,2,-4
28436,28436,28437,2,7,5
28437,28437,28438,7,6,-1
28438,28438,28439,6,1,-5
28439,28439,28440,1,6,5
28440,28440,28441,6,3,-3
28441,28441,28442,3,4,1
28442,28442,28443,4,7,3
28443,28443,28444,7,3,-4
28444,28444,28445,3,9,6
28445,28445,28446,9,9,0
28446,28446,28447,9,7,-2
28447,28447,28448,7,9,2
28448,28448,28449,9,4,-5
28449,28449,28450,4,7,3
28450,28450,28451,7,0,-7
28451,28451,28452,0,0,0
28452,28452,28453,0,2,2
28453,28453,28454,2,2,0
28454,28454,28455,2,5,3
28455,28455,28456,5,0,-5
28456,28456,28457,0,0,0
28457,28457,28458,0,3,3
28458,28458,28459,3,6,3
28459,28459,28460,6,9,3
28460,28460,28461,9,4,-5
28461,28461,28462,4,4,0
28462,28462,28463,4,9,5
28463,28463,28464,9,4,-5
28464,28464,28465,4,5,1
28465,28465,28466,5,0,-5
28466,28466,28467,0,6,6
28467,28467,28468,6,4,-2
28468,28468,28469,4,5,1
28469,28469,28470,5,8,3
28470,28470,28471,8,2,-6
28471,28471,28472,2,3,1
28472,28472,28473,3,9,6
28473,28473,28474,9,8,-1
28474,28474,28475,8,8,0
28475,28475,28476,8,3,-5
28476,28476,28477,3,5,2
28477,28477,28478,5,5,0
28478,28478,28479,5,1,-4
28479,28479,28480,1,8,7
28480,28480,28481,8,9,1
28481,28481,28482,9,1,-8
28482,28482,28483,1,8,7
28483,28483,28484,8,1,-7
28484,28484,28485,1,3,2
28485,28485,28486,3,0,-3
28486,28486,28487,0,4,4
28487,28487,28488,4,1,-3
28488,28488,28489,1,0,-1
28489,28489,28490,0,8,8
28490,28490,28491,8,5,-3
28491,28491,28492,5,4,-1
28492,28492,28493,4,4,0
28493,28493,28494,4,2,-2
28494,28494,28495,2,8,6
28495,28495,28496,8,6,-2
28496,28496,28497,6,6,0
28497,28497,28498,6,8,2
28498,28498,28499,8,3,-5
28499,28499,28500,3,4,1
28500,28500,28501,4,4,0
28501,28501,28502,4,2,-2
28502,28502,28503,2,8,6
28503,28503,28504,8,5,-3
28504,28504,28505,5,0,-5
28505,28505,28506,0,8,8
28506,28506,28507,8,6,-2
28507,28507,28508,6,6,0
28508,28508,28509,6,4,-2
28509,28509,28510,4,0,-4
28510,28510,28511,0,8,8
28511,28511,28512,8,5,-3
28512,28512,28513,5,1,-4
28513,28513,28514,1,7,6
28514,28514,28515,7,3,-4
28515,28515,28516,3,1,-2
28516,28516,28517,1,4,3
28517,28517,28518,4,4,0
28518,28518,28519,4,0,-4
28519,28519,28520,0,7,7
28520,28520,28521,7,1,-6
28521,28521,28522,1,1,0
28522,28522,28523,1,9,8
28523,28523,28524,9,1,-8
28524,28524,28525,1,2,1
28525,28525,28526,2,8,6
28526,28526,28527,8,3,-5
28527,28527,28528,3,3,0
28528,28528,28529,3,7,4
28529,28529,28530,7,9,2
28530,28530,28531,9,1,-8
28531,28531,28532,1,7,6
28532,28532,28533,7,2,-5
28533,28533,28534,2,5,3
28534,28534,28535,5,7,2
28535,28535,28536,7,3,-4
28536,28536,28537,3,2,-1
28537,28537,28538,2,9,7
28538,28538,28539,9,8,-1
28539,28539,28540,8,0,-8
28540,28540,28541,0,7,7
28541,28541,28542,7,7,0
28542,28542,28543,7,0,-7
28543,28543,28544,0,2,2
28544,28544,28545,2,1,-1
28545,28545,28546,1,0,-1
28546,28546,28547,0,9,9
28547,28547,28548,9,6,-3
28548,28548,28549,6,6,0
28549,28549,28550,6,7,1
28550,28550,28551,7,4,-3
28551,28551,28552,4,6,2
28552,28552,28553,6,9,3
28553,28553,28554,9,6,-3
28554,28554,28555,6,2,-4
28555,28555,28556,2,4,2
28556,28556,28557,4,1,-3
28557,28557,28558,1,7,6
28558,28558,28559,7,2,-5
28559,28559,28560,2,2,0
28560,28560,28561,2,3,1
28561,28561,28562,3,7,4
28562,28562,28563,7,7,0
28563,28563,28564,7,9,2
28564,28564,28565,9,0,-9
28565,28565,28566,0,2,2
28566,28566,28567,2,2,0
28567,28567,28568,2,1,-1
28568,28568,28569,1,1,0
28569,28569,28570,1,5,4
28570,28570,28571,5,3,-2
28571,28571,28572,3,6,3
28572,28572,28573,6,4,-2
28573,28573,28574,4,9,5
28574,28574,28575,9,7,-2
28575,28575,28576,7,6,-1
28576,28576,28577,6,2,-4
28577,28577,28578,2,4,2
28578,28578,28579,4,5,1
28579,28579,28580,5,3,-2
28580,28580,28581,3,8,5
28581,28581,28582,8,9,1
28582,28582,28583,9,1,-8
28583,28583,28584,1,4,3
28584,28584,28585,4,6,2
28585,28585,28586,6,1,-5
28586,28586,28587,1,8,7
28587,28587,28588,8,4,-4
28588,28588,28589,4,5,1
28589,28589,28590,5,6,1
28590,28590,28591,6,6,0
28591,28591,28592,6,9,3
28592,28592,28593,9,0,-9
28593,28593,28594,0,6,6
28594,28594,28595,6,8,2
28595,28595,28596,8,5,-3
28596,28596,28597,5,9,4
28597,28597,28598,9,9,0
28598,28598,28599,9,4,-5
28599,28599,28600,4,4,0
28600,28600,28601,4,9,5
28601,28601,28602,9,6,-3
28602,28602,28603,6,2,-4
28603,28603,28604,2,9,7
28604,28604,28605,9,6,-3
28605,28605,28606,6,5,-1
28606,28606,28607,5,0,-5
28607,28607,28608,0,5,5
28608,28608,28609,5,1,-4
28609,28609,28610,1,4,3
28610,28610,28611,4,2,-2
28611,28611,28612,2,0,-2
28612,28612,28613,0,3,3
28613,28613,28614,3,4,1
28614,28614,28615,4,4,0
28615,28615,28616,4,6,2
28616,28616,28617,6,5,-1
28617,28617,28618,5,9,4
28618,28618,28619,9,6,-3
28619,28619,28620,6,7,1
28620,28620,28621,7,7,0
28621,28621,28622,7,1,-6
28622,28622,28623,1,8,7
28623,28623,28624,8,7,-1
28624,28624,28625,7,9,2
28625,28625,28626,9,3,-6
28626,28626,28627,3,0,-3
28627,28627,28628,0,0,0
28628,28628,28629,0,1,1
28629,28629,28630,1,2,1
28630,28630,28631,2,2,0
28631,28631,28632,2,7,5
28632,28632,28633,7,3,-4
28633,28633,28634,3,7,4
28634,28634,28635,7,4,-3
28635,28635,28636,4,9,5
28636,28636,28637,9,5,-4
28637,28637,28638,5,7,2
28638,28638,28639,7,6,-1
28639,28639,28640,6,2,-4
28640,28640,28641,2,7,5
28641,28641,28642,7,7,0
28642,28642,28643,7,8,1
28643,28643,28644,8,6,-2
28644,28644,28645,6,9,3
28645,28645,28646,9,1,-8
28646,28646,28647,1,0,-1
28647,28647,28648,0,8,8
28648,28648,28649,8,1,-7
28649,28649,28650,1,1,0
28650,28650,28651,1,2,1
28651,28651,28652,2,4,2
28652,28652,28653,4,3,-1
28653,28653,28654,3,5,2
28654,28654,28655,5,4,-1
28655,28655,28656,4,1,-3
28656,28656,28657,1,5,4
28657,28657,28658,5,5,0
28658,28658,28659,5,6,1
28659,28659,28660,6,1,-5
28660,28660,28661,1,7,6
28661,28661,28662,7,8,1
28662,28662,28663,8,8,0
28663,28663,28664,8,8,0
28664,28664,28665,8,9,1
28665,28665,28666,9,5,-4
28666,28666,28667,5,0,-5
28667,28667,28668,0,3,3
28668,28668,28669,3,4,1
28669,28669,28670,4,7,3
28670,28670,28671,7,0,-7
28671,28671,28672,0,2,2
28672,28672,28673,2,1,-1
28673,28673,28674,1,9,8
28674,28674,28675,9,7,-2
28675,28675,28676,7,9,2
28676,28676,28677,9,9,0
28677,28677,28678,9,6,-3
28678,28678,28679,6,5,-1
28679,28679,28680,5,6,1
28680,28680,28681,6,1,-5
28681,28681,28682,1,8,7
28682,28682,28683,8,4,-4
28683,28683,28684,4,2,-2
28684,28684,28685,2,2,0
28685,28685,28686,2,2,0
28686,28686,28687,2,8,6
28687,28687,28688,8,7,-1
28688,28688,28689,7,9,2
28689,28689,28690,9,0,-9
28690,28690,28691,0,4,4
28691,28691,28692,4,0,-4
28692,28692,28693,0,3,3
28693,28693,28694,3,8,5
28694,28694,28695,8,1,-7
28695,28695,28696,1,7,6
28696,28696,28697,7,7,0
28697,28697,28698,7,6,-1
28698,28698,28699,6,8,2
28699,28699,28700,8,4,-4
28700,28700,28701,4,2,-2
28701,28701,28702,2,6,4
28702,28702,28703,6,4,-2
28703,28703,28704,4,6,2
28704,28704,28705,6,4,-2
28705,28705,28706,4,4,0
28706,28706,28707,4,3,-1
28707,28707,28708,3,6,3
28708,28708,28709,6,3,-3
28709,28709,28710,3,8,5
28710,28710,28711,8,6,-2
28711,28711,28712,6,8,2
28712,28712,28713,8,9,1
28713,28713,28714,9,0,-9
28714,28714,28715,0,9,9
28715,28715,28716,9,3,-6
28716,28716,28717,3,5,2
28717,28717,28718,5,1,-4
28718,28718,28719,1,8,7
28719,28719,28720,8,5,-3
28720,28720,28721,5,6,1
28721,28721,28722,6,9,3
28722,28722,28723,9,7,-2
28723,28723,28724,7,1,-6
28724,28724,28725,1,0,-1
28725,28725,28726,0,8,8
28726,28726,28727,8,6,-2
28727,28727,28728,6,6,0
28728,28728,28729,6,8,2
28729,28729,28730,8,7,-1
28730,28730,28731,7,2,-5
28731,28731,28732,2,5,3
28732,28732,28733,5,6,1
28733,28733,28734,6,3,-3
28734,28734,28735,3,3,0
28735,28735,28736,3,1,-2
28736,28736,28737,1,9,8
28737,28737,28738,9,1,-8
28738,28738,28739,1,8,7
28739,28739,28740,8,0,-8
28740,28740,28741,0,6,6
28741,28741,28742,6,8,2
28742,28742,28743,8,1,-7
28743,28743,28744,1,2,1
28744,28744,28745,2,7,5
28745,28745,28746,7,0,-7
28746,28746,28747,0,4,4
28747,28747,28748,4,5,1
28748,28748,28749,5,8,3
28749,28749,28750,8,9,1
28750,28750,28751,9,8,-1
28751,28751,28752,8,3,-5
28752,28752,28753,3,9,6
28753,28753,28754,9,9,0
28754,28754,28755,9,0,-9
28755,28755,28756,0,6,6
28756,28756,28757,6,3,-3
28757,28757,28758,3,6,3
28758,28758,28759,6,3,-3
28759,28759,28760,3,3,0
28760,28760,28761,3,9,6
28761,28761,28762,9,5,-4
28762,28762,28763,5,0,-5
28763,28763,28764,0,7,7
28764,28764,28765,7,9,2
28765,28765,28766,9,8,-1
28766,28766,28767,8,4,-4
28767,28767,28768,4,6,2
28768,28768,28769,6,1,-5
28769,28769,28770,1,5,4
28770,28770,28771,5,0,-5
28771,28771,28772,0,0,0
28772,28772,28773,0,3,3
28773,28773,28774,3,9,6
28774,28774,28775,9,7,-2
28775,28775,28776,7,6,-1
28776,28776,28777,6,5,-1
28777,28777,28778,5,3,-2
28778,28778,28779,3,8,5
28779,28779,28780,8,2,-6
28780,28780,28781,2,7,5
28781,28781,28782,7,8,1
28782,28782,28783,8,7,-1
28783,28783,28784,7,0,-7
28784,28784,28785,0,8,8
28785,28785,28786,8,2,-6
28786,28786,28787,2,2,0
28787,28787,28788,2,8,6
28788,28788,28789,8,9,1
28789,28789,28790,9,7,-2
28790,28790,28791,7,7,0
28791,28791,28792,7,1,-6
28792,28792,28793,1,1,0
28793,28793,28794,1,1,0
28794,28794,28795,1,2,1
28795,28795,28796,2,3,1
28796,28796,28797,3,6,3
28797,28797,28798,6,6,0
28798,28798,28799,6,4,-2
28799,28799,28800,4,4,0
28800,28800,28801,4,2,-2
28801,28801,28802,2,8,6
28802,28802,28803,8,3,-5
28803,28803,28804,3,1,-2
28804,28804,28805,1,6,5
28805,28805,28806,6,4,-2
28806,28806,28807,4,6,2
28807,28807,28808,6,9,3
28808,28808,28809,9,0,-9
28809,28809,28810,0,6,6
28810,28810,28811,6,2,-4
28811,28811,28812,2,7,5
28812,28812,28813,7,8,1
28813,28813,28814,8,0,-8
28814,28814,28815,0,1,1
28815,28815,28816,1,0,-1
28816,28816,28817,0,6,6
28817,28817,28818,6,0,-6
28818,28818,28819,0,1,1
28819,28819,28820,1,3,2
28820,28820,28821,3,0,-3
28821,28821,28822,0,1,1
28822,28822,28823,1,4,3
28823,28823,28824,4,0,-4
28824,28824,28825,0,3,3
28825,28825,28826,3,3,0
28826,28826,28827,3,1,-2
28827,28827,28828,1,1,0
28828,28828,28829,1,6,5
28829,28829,28830,6,6,0
28830,28830,28831,6,1,-5
28831,28831,28832,1,2,1
28832,28832,28833,2,9,7
28833,28833,28834,9,1,-8
28834,28834,28835,1,0,-1
28835,28835,28836,0,1,1
28836,28836,28837,1,1,0
28837,28837,28838,1,9,8
28838,28838,28839,9,2,-7
28839,28839,28840,2,0,-2
28840,28840,28841,0,3,3
28841,28841,28842,3,2,-1
28842,28842,28843,2,4,2
28843,28843,28844,4,2,-2
28844,28844,28845,2,5,3
28845,28845,28846,5,5,0
28846,28846,28847,5,6,1
28847,28847,28848,6,7,1
28848,28848,28849,7,7,0
28849,28849,28850,7,6,-1
28850,28850,28851,6,8,2
28851,28851,28852,8,7,-1
28852,28852,28853,7,9,2
28853,28853,28854,9,5,-4
28854,28854,28855,5,0,-5
28855,28855,28856,0,8,8
28856,28856,28857,8,1,-7
28857,28857,28858,1,3,2
28858,28858,28859,3,2,-1
28859,28859,28860,2,4,2
28860,28860,28861,4,3,-1
28861,28861,28862,3,1,-2
28862,28862,28863,1,4,3
28863,28863,28864,4,7,3
28864,28864,28865,7,5,-2
28865,28865,28866,5,4,-1
28866,28866,28867,4,6,2
28867,28867,28868,6,2,-4
28868,28868,28869,2,7,5
28869,28869,28870,7,6,-1
28870,28870,28871,6,8,2
28871,28871,28872,8,2,-6
28872,28872,28873,2,9,7
28873,28873,28874,9,5,-4
28874,28874,28875,5,0,-5
28875,28875,28876,0,6,6
28876,28876,28877,6,1,-5
28877,28877,28878,1,1,0
28878,28878,28879,1,2,1
28879,28879,28880,2,7,5
28880,28880,28881,7,3,-4
28881,28881,28882,3,2,-1
28882,28882,28883,2,6,4
28883,28883,28884,6,8,2
28884,28884,28885,8,7,-1
28885,28885,28886,7,5,-2
28886,28886,28887,5,8,3
28887,28887,28888,8,0,-8
28888,28888,28889,0,9,9
28889,28889,28890,9,6,-3
28890,28890,28891,6,8,2
28891,28891,28892,8,8,0
28892,28892,28893,8,1,-7
28893,28893,28894,1,1,0
28894,28894,28895,1,0,-1
28895,28895,28896,0,0,0
28896,28896,28897,0,7,7
28897,28897,28898,7,6,-1
28898,28898,28899,6,5,-1
28899,28899,28900,5,3,-2
28900,28900,28901,3,1,-2
28901,28901,28902,1,8,7
28902,28902,28903,8,8,0
28903,28903,28904,8,0,-8
28904,28904,28905,0,6,6
28905,28905,28906,6,1,-5
28906,28906,28907,1,4,3
28907,28907,28908,4,9,5
28908,28908,28909,9,1,-8
28909,28909,28910,1,0,-1
28910,28910,28911,0,9,9
28911,28911,28912,9,6,-3
28912,28912,28913,6,3,-3
28913,28913,28914,3,4,1
28914,28914,28915,4,8,4
28915,28915,28916,8,3,-5
28916,28916,28917,3,4,1
28917,28917,28918,4,5,1
28918,28918,28919,5,4,-1
28919,28919,28920,4,2,-2
28920,28920,28921,2,7,5
28921,28921,28922,7,1,-6
28922,28922,28923,1,0,-1
28923,28923,28924,0,5,5
28924,28924,28925,5,1,-4
28925,28925,28926,1,7,6
28926,28926,28927,7,9,2
28927,28927,28928,9,9,0
28928,28928,28929,9,2,-7
28929,28929,28930,2,7,5
28930,28930,28931,7,8,1
28931,28931,28932,8,2,-6
28932,28932,28933,2,7,5
28933,28933,28934,7,6,-1
28934,28934,28935,6,8,2
28935,28935,28936,8,3,-5
28936,28936,28937,3,2,-1
28937,28937,28938,2,4,2
28938,28938,28939,4,5,1
28939,28939,28940,5,8,3
28940,28940,28941,8,9,1
28941,28941,28942,9,4,-5
28942,28942,28943,4,6,2
28943,28943,28944,6,2,-4
28944,28944,28945,2,0,-2
28945,28945,28946,0,0,0
28946,28946,28947,0,6,6
28947,28947,28948,6,4,-2
28948,28948,28949,4,5,1
28949,28949,28950,5,2,-3
28950,28950,28951,2,5,3
28951,28951,28952,5,5,0
28952,28952,28953,5,3,-2
28953,28953,28954,3,2,-1
28954,28954,28955,2,3,1
28955,28955,28956,3,7,4
28956,28956,28957,7,3,-4
28957,28957,28958,3,2,-1
28958,28958,28959,2,8,6
28959,28959,28960,8,9,1
28960,28960,28961,9,1,-8
28961,28961,28962,1,8,7
28962,28962,28963,8,4,-4
28963,28963,28964,4,1,-3
28964,28964,28965,1,0,-1
28965,28965,28966,0,6,6
28966,28966,28967,6,6,0
28967,28967,28968,6,0,-6
28968,28968,28969,0,1,1
28969,28969,28970,1,1,0
28970,28970,28971,1,0,-1
28971,28971,28972,0,7,7
28972,28972,28973,7,0,-7
28973,28973,28974,0,5,5
28974,28974,28975,5,6,1
28975,28975,28976,6,4,-2
28976,28976,28977,4,2,-2
28977,28977,28978,2,6,4
28978,28978,28979,6,1,-5
28979,28979,28980,1,4,3
28980,28980,28981,4,1,-3
28981,28981,28982,1,7,6
28982,28982,28983,7,3,-4
28983,28983,28984,3,9,6
28984,28984,28985,9,2,-7
28985,28985,28986,2,7,5
28986,28986,28987,7,8,1
28987,28987,28988,8,7,-1
28988,28988,28989,7,8,1
28989,28989,28990,8,7,-1
28990,28990,28991,7,7,0
28991,28991,28992,7,0,-7
28992,28992,28993,0,0,0
28993,28993,28994,0,5,5
28994,28994,28995,5,3,-2
28995,28995,28996,3,4,1
28996,28996,28997,4,6,2
28997,28997,28998,6,2,-4
28998,28998,28999,2,8,6
28999,28999,29000,8,2,-6
29000,29000,29001,2,9,7
29001,29001,29002,9,7,-2
29002,29002,29003,7,9,2
29003,29003,29004,9,2,-7
29004,29004,29005,2,2,0
29005,29005,29006,2,5,3
29006,29006,29007,5,4,-1
29007,29007,29008,4,5,1
29008,29008,29009,5,9,4
29009,29009,29010,9,9,0
29010,29010,29011,9,4,-5
29011,29011,29012,4,9,5
29012,29012,29013,9,3,-6
29013,29013,29014,3,3,0
29014,29014,29015,3,6,3
29015,29015,29016,6,8,2
29016,29016,29017,8,2,-6
29017,29017,29018,2,9,7
29018,29018,29019,9,2,-7
29019,29019,29020,2,6,4
29020,29020,29021,6,5,-1
29021,29021,29022,5,8,3
29022,29022,29023,8,3,-5
29023,29023,29024,3,4,1
29024,29024,29025,4,2,-2
29025,29025,29026,2,8,6
29026,29026,29027,8,5,-3
29027,29027,29028,5,6,1
29028,29028,29029,6,5,-1
29029,29029,29030,5,1,-4
29030,29030,29031,1,9,8
29031,29031,29032,9,7,-2
29032,29032,29033,7,1,-6
29033,29033,29034,1,0,-1
29034,29034,29035,0,6,6
29035,29035,29036,6,9,3
29036,29036,29037,9,5,-4
29037,29037,29038,5,5,0
29038,29038,29039,5,0,-5
29039,29039,29040,0,1,1
29040,29040,29041,1,1,0
29041,29041,29042,1,3,2
29042,29042,29043,3,2,-1
29043,29043,29044,2,0,-2
29044,29044,29045,0,3,3
29045,29045,29046,3,4,1
29046,29046,29047,4,4,0
29047,29047,29048,4,6,2
29048,29048,29049,6,5,-1
29049,29049,29050,5,2,-3
29050,29050,29051,2,7,5
29051,29051,29052,7,0,-7
29052,29052,29053,0,8,8
29053,29053,29054,8,4,-4
29054,29054,29055,4,0,-4
29055,29055,29056,0,0,0
29056,29056,29057,0,1,1
29057,29057,29058,1,5,4
29058,29058,29059,5,2,-3
29059,29059,29060,2,2,0
29060,29060,29061,2,3,1
29061,29061,29062,3,1,-2
29062,29062,29063,1,4,3
29063,29063,29064,4,2,-2
29064,29064,29065,2,5,3
29065,29065,29066,5,5,0
29066,29066,29067,5,0,-5
29067,29067,29068,0,1,1
29068,29068,29069,1,1,0
29069,29069,29070,1,8,7
29070,29070,29071,8,2,-6
29071,29071,29072,2,9,7
29072,29072,29073,9,3,-6
29073,29073,29074,3,0,-3
29074,29074,29075,0,4,4
29075,29075,29076,4,5,1
29076,29076,29077,5,5,0
29077,29077,29078,5,9,4
29078,29078,29079,9,6,-3
29079,29079,29080,6,1,-5
29080,29080,29081,1,2,1
29081,29081,29082,2,8,6
29082,29082,29083,8,1,-7
29083,29083,29084,1,9,8
29084,29084,29085,9,2,-7
29085,29085,29086,2,1,-1
29086,29086,29087,1,1,0
29087,29087,29088,1,1,0
29088,29088,29089,1,3,2
29089,29089,29090,3,8,5
29090,29090,29091,8,9,1
29091,29091,29092,9,8,-1
29092,29092,29093,8,9,1
29093,29093,29094,9,3,-6
29094,29094,29095,3,8,5
29095,29095,29096,8,6,-2
29096,29096,29097,6,3,-3
29097,29097,29098,3,1,-2
29098,29098,29099,1,7,6
29099,29099,29100,7,5,-2
29100,29100,29101,5,0,-5
29101,29101,29102,0,0,0
29102,29102,29103,0,7,7
29103,29103,29104,7,3,-4
29104,29104,29105,3,7,4
29105,29105,29106,7,2,-5
29106,29106,29107,2,5,3
29107,29107,29108,5,9,4
29108,29108,29109,9,7,-2
29109,29109,29110,7,9,2
29110,29110,29111,9,9,0
29111,29111,29112,9,5,-4
29112,29112,29113,5,9,4
29113,29113,29114,9,1,-8
29114,29114,29115,1,4,3
29115,29115,29116,4,8,4
29116,29116,29117,8,7,-1
29117,29117,29118,7,8,1
29118,29118,29119,8,0,-8
29119,29119,29120,0,5,5
29120,29120,29121,5,3,-2
29121,29121,29122,3,4,1
29122,29122,29123,4,4,0
29123,29123,29124,4,9,5
29124,29124,29125,9,1,-8
29125,29125,29126,1,8,7
29126,29126,29127,8,7,-1
29127,29127,29128,7,0,-7
29128,29128,29129,0,5,5
29129,29129,29130,5,4,-1
29130,29130,29131,4,8,4
29131,29131,29132,8,8,0
29132,29132,29133,8,1,-7
29133,29133,29134,1,9,8
29134,29134,29135,9,4,-5
29135,29135,29136,4,6,2
29136,29136,29137,6,9,3
29137,29137,29138,9,6,-3
29138,29138,29139,6,8,2
29139,29139,29140,8,6,-2
29140,29140,29141,6,4,-2
29141,29141,29142,4,8,4
29142,29142,29143,8,1,-7
29143,29143,29144,1,7,6
29144,29144,29145,7,8,1
29145,29145,29146,8,3,-5
29146,29146,29147,3,6,3
29147,29147,29148,6,0,-6
29148,29148,29149,0,6,6
29149,29149,29150,6,5,-1
29150,29150,29151,5,0,-5
29151,29151,29152,0,2,2
29152,29152,29153,2,3,1
29153,29153,29154,3,9,6
29154,29154,29155,9,5,-4
29155,29155,29156,5,5,0
29156,29156,29157,5,5,0
29157,29157,29158,5,3,-2
29158,29158,29159,3,7,4
29159,29159,29160,7,6,-1
29160,29160,29161,6,9,3
29161,29161,29162,9,8,-1
29162,29162,29163,8,6,-2
29163,29163,29164,6,8,2
29164,29164,29165,8,9,1
29165,29165,29166,9,4,-5
29166,29166,29167,4,2,-2
29167,29167,29168,2,9,7
29168,29168,29169,9,6,-3
29169,29169,29170,6,9,3
29170,29170,29171,9,2,-7
29171,29171,29172,2,8,6
29172,29172,29173,8,1,-7
29173,29173,29174,1,5,4
29174,29174,29175,5,2,-3
29175,29175,29176,2,2,0
29176,29176,29177,2,0,-2
29177,29177,29178,0,8,8
29178,29178,29179,8,8,0
29179,29179,29180,8,9,1
29180,29180,29181,9,3,-6
29181,29181,29182,3,3,0
29182,29182,29183,3,8,5
29183,29183,29184,8,7,-1
29184,29184,29185,7,3,-4
29185,29185,29186,3,7,4
29186,29186,29187,7,0,-7
29187,29187,29188,0,2,2
29188,29188,29189,2,8,6
29189,29189,29190,8,0,-8
29190,29190,29191,0,7,7
29191,29191,29192,7,8,1
29192,29192,29193,8,4,-4
29193,29193,29194,4,8,4
29194,29194,29195,8,9,1
29195,29195,29196,9,4,-5
29196,29196,29197,4,5,1
29197,29197,29198,5,8,3
29198,29198,29199,8,0,-8
29199,29199,29200,0,2,2
29200,29200,29201,2,9,7
29201,29201,29202,9,7,-2
29202,29202,29203,7,0,-7
29203,29203,29204,0,5,5
29204,29204,29205,5,0,-5
29205,29205,29206,0,4,4
29206,29206,29207,4,4,0
29207,29207,29208,4,8,4
29208,29208,29209,8,6,-2
29209,29209,29210,6,7,1
29210,29210,29211,7,0,-7
29211,29211,29212,0,7,7
29212,29212,29213,7,9,2
29213,29213,29214,9,1,-8
29214,29214,29215,1,1,0
29215,29215,29216,1,6,5
29216,29216,29217,6,6,0
29217,29217,29218,6,4,-2
29218,29218,29219,4,2,-2
29219,29219,29220,2,2,0
29220,29220,29221,2,6,4
29221,29221,29222,6,1,-5
29222,29222,29223,1,8,7
29223,29223,29224,8,3,-5
29224,29224,29225,3,3,0
29225,29225,29226,3,6,3
29226,29226,29227,6,1,-5
29227,29227,29228,1,4,3
29228,29228,29229,4,8,4
29229,29229,29230,8,0,-8
29230,29230,29231,0,3,3
29231,29231,29232,3,3,0
29232,29232,29233,3,1,-2
29233,29233,29234,1,9,8
29234,29234,29235,9,0,-9
29235,29235,29236,0,9,9
29236,29236,29237,9,3,-6
29237,29237,29238,3,7,4
29238,29238,29239,7,1,-6
29239,29239,29240,1,2,1
29240,29240,29241,2,4,2
29241,29241,29242,4,1,-3
29242,29242,29243,1,0,-1
29243,29243,29244,0,2,2
29244,29244,29245,2,1,-1
29245,29245,29246,1,3,2
29246,29246,29247,3,2,-1
29247,29247,29248,2,5,3
29248,29248,29249,5,3,-2
29249,29249,29250,3,0,-3
29250,29250,29251,0,4,4
29251,29251,29252,4,4,0
29252,29252,29253,4,5,1
29253,29253,29254,5,8,3
29254,29254,29255,8,6,-2
29255,29255,29256,6,4,-2
29256,29256,29257,4,7,3
29257,29257,29258,7,4,-3
29258,29258,29259,4,8,4
29259,29259,29260,8,1,-7
29260,29260,29261,1,9,8
29261,29261,29262,9,0,-9
29262,29262,29263,0,0,0
29263,29263,29264,0,5,5
29264,29264,29265,5,1,-4
29265,29265,29266,1,3,2
29266,29266,29267,3,2,-1
29267,29267,29268,2,5,3
29268,29268,29269,5,3,-2
29269,29269,29270,3,3,0
29270,29270,29271,3,4,1
29271,29271,29272,4,6,2
29272,29272,29273,6,5,-1
29273,29273,29274,5,1,-4
29274,29274,29275,1,6,5
29275,29275,29276,6,8,2
29276,29276,29277,8,7,-1
29277,29277,29278,7,1,-6
29278,29278,29279,1,8,7
29279,29279,29280,8,8,0
29280,29280,29281,8,9,1
29281,29281,29282,9,7,-2
29282,29282,29283,7,0,-7
29283,29283,29284,0,1,1
29284,29284,29285,1,1,0
29285,29285,29286,1,9,8
29286,29286,29287,9,2,-7
29287,29287,29288,2,1,-1
29288,29288,29289,1,3,2
29289,29289,29290,3,2,-1
29290,29290,29291,2,4,2
29291,29291,29292,4,9,5
29292,29292,29293,9,5,-4
29293,29293,29294,5,3,-2
29294,29294,29295,3,6,3
29295,29295,29296,6,7,1
29296,29296,29297,7,7,0
29297,29297,29298,7,7,0
29298,29298,29299,7,8,1
29299,29299,29300,8,3,-5
29300,29300,29301,3,9,6
29301,29301,29302,9,9,0
29302,29302,29303,9,8,-1
29303,29303,29304,8,3,-5
29304,29304,29305,3,9,6
29305,29305,29306,9,8,-1
29306,29306,29307,8,5,-3
29307,29307,29308,5,5,0
29308,29308,29309,5,7,2
29309,29309,29310,7,5,-2
29310,29310,29311,5,0,-5
29311,29311,29312,0,2,2
29312,29312,29313,2,3,1
29313,29313,29314,3,2,-1
29314,29314,29315,2,1,-1
29315,29315,29316,1,5,4
29316,29316,29317,5,6,1
29317,29317,29318,6,9,3
29318,29318,29319,9,8,-1
29319,29319,29320,8,1,-7
29320,29320,29321,1,4,3
29321,29321,29322,4,9,5
29322,29322,29323,9,1,-8
29323,29323,29324,1,7,6
29324,29324,29325,7,7,0
29325,29325,29326,7,7,0
29326,29326,29327,7,6,-1
29327,29327,29328,6,9,3
29328,29328,29329,9,5,-4
29329,29329,29330,5,6,1
29330,29330,29331,6,6,0
29331,29331,29332,6,9,3
29332,29332,29333,9,7,-2
29333,29333,29334,7,2,-5
29334,29334,29335,2,8,6
29335,29335,29336,8,0,-8
29336,29336,29337,0,1,1
29337,29337,29338,1,7,6
29338,29338,29339,7,4,-3
29339,29339,29340,4,4,0
29340,29340,29341,4,0,-4
29341,29341,29342,0,8,8
29342,29342,29343,8,5,-3
29343,29343,29344,5,5,0
29344,29344,29345,5,0,-5
29345,29345,29346,0,9,9
29346,29346,29347,9,1,-8
29347,29347,29348,1,5,4
29348,29348,29349,5,9,4
29349,29349,29350,9,6,-3
29350,29350,29351,6,2,-4
29351,29351,29352,2,3,1
29352,29352,29353,3,3,0
29353,29353,29354,3,5,2
29354,29354,29355,5,2,-3
29355,29355,29356,2,3,1
29356,29356,29357,3,3,0
29357,29357,29358,3,4,1
29358,29358,29359,4,5,1
29359,29359,29360,5,8,3
29360,29360,29361,8,5,-3
29361,29361,29362,5,6,1
29362,29362,29363,6,7,1
29363,29363,29364,7,0,-7
29364,29364,29365,0,8,8
29365,29365,29366,8,3,-5
29366,29366,29367,3,4,1
29367,29367,29368,4,0,-4
29368,29368,29369,0,9,9
29369,29369,29370,9,6,-3
29370,29370,29371,6,9,3
29371,29371,29372,9,4,-5
29372,29372,29373,4,7,3
29373,29373,29374,7,0,-7
29374,29374,29375,0,1,1
29375,29375,29376,1,7,6
29376,29376,29377,7,1,-6
29377,29377,29378,1,0,-1
29378,29378,29379,0,9,9
29379,29379,29380,9,6,-3
29380,29380,29381,6,8,2
29381,29381,29382,8,7,-1
29382,29382,29383,7,3,-4
29383,29383,29384,3,5,2
29384,29384,29385,5,4,-1
29385,29385,29386,4,0,-4
29386,29386,29387,0,8,8
29387,29387,29388,8,0,-8
29388,29388,29389,0,6,6
29389,29389,29390,6,9,3
29390,29390,29391,9,3,-6
29391,29391,29392,3,6,3
29392,29392,29393,6,8,2
29393,29393,29394,8,0,-8
29394,29394,29395,0,0,0
29395,29395,29396,0,1,1
29396,29396,29397,1,9,8
29397,29397,29398,9,3,-6
29398,29398,29399,3,6,3
29399,29399,29400,6,9,3
29400,29400,29401,9,2,-7
29401,29401,29402,2,8,6
29402,29402,29403,8,1,-7
29403,29403,29404,1,5,4
29404,29404,29405,5,0,-5
29405,29405,29406,0,9,9
29406,29406,29407,9,1,-8
29407,29407,29408,1,2,1
29408,29408,29409,2,0,-2
29409,29409,29410,0,5,5
29410,29410,29411,5,6,1
29411,29411,29412,6,7,1
29412,29412,29413,7,2,-5
29413,29413,29414,2,0,-2
29414,29414,29415,0,3,3
29415,29415,29416,3,1,-2
29416,29416,29417,1,8,7
29417,29417,29418,8,4,-4
29418,29418,29419,4,9,5
29419,29419,29420,9,0,-9
29420,29420,29421,0,0,0
29421,29421,29422,0,8,8
29422,29422,29423,8,7,-1
29423,29423,29424,7,6,-1
29424,29424,29425,6,2,-4
29425,29425,29426,2,9,7
29426,29426,29427,9,3,-6
29427,29427,29428,3,1,-2
29428,29428,29429,1,4,3
29429,29429,29430,4,1,-3
29430,29430,29431,1,8,7
29431,29431,29432,8,7,-1
29432,29432,29433,7,5,-2
29433,29433,29434,5,1,-4
29434,29434,29435,1,4,3
29435,29435,29436,4,7,3
29436,29436,29437,7,6,-1
29437,29437,29438,6,0,-6
29438,29438,29439,0,6,6
29439,29439,29440,6,7,1
29440,29440,29441,7,6,-1
29441,29441,29442,6,4,-2
29442,29442,29443,4,7,3
29443,29443,29444,7,4,-3
29444,29444,29445,4,9,5
29445,29445,29446,9,0,-9
29446,29446,29447,0,1,1
29447,29447,29448,1,1,0
29448,29448,29449,1,2,1
29449,29449,29450,2,7,5
29450,29450,29451,7,1,-6
29451,29451,29452,1,7,6
29452,29452,29453,7,2,-5
29453,29453,29454,2,6,4
29454,29454,29455,6,6,0
29455,29455,29456,6,0,-6
29456,29456,29457,0,5,5
29457,29457,29458,5,3,-2
29458,29458,29459,3,3,0
29459,29459,29460,3,6,3
29460,29460,29461,6,4,-2
29461,29461,29462,4,5,1
29462,29462,29463,5,7,2
29463,29463,29464,7,3,-4
29464,29464,29465,3,9,6
29465,29465,29466,9,2,-7
29466,29466,29467,2,4,2
29467,29467,29468,4,0,-4
29468,29468,29469,0,0,0
29469,29469,29470,0,7,7
29470,29470,29471,7,0,-7
29471,29471,29472,0,9,9
29472,29472,29473,9,5,-4
29473,29473,29474,5,0,-5
29474,29474,29475,0,9,9
29475,29475,29476,9,3,-6
29476,29476,29477,3,0,-3
29477,29477,29478,0,0,0
29478,29478,29479,0,1,1
29479,29479,29480,1,1,0
29480,29480,29481,1,2,1
29481,29481,29482,2,7,5
29482,29482,29483,7,3,-4
29483,29483,29484,3,4,1
29484,29484,29485,4,4,0
29485,29485,29486,4,9,5
29486,29486,29487,9,5,-4
29487,29487,29488,5,0,-5
29488,29488,29489,0,6,6
29489,29489,29490,6,0,-6
29490,29490,29491,0,7,7
29491,29491,29492,7,9,2
29492,29492,29493,9,8,-1
29493,29493,29494,8,8,0
29494,29494,29495,8,9,1
29495,29495,29496,9,2,-7
29496,29496,29497,2,0,-2
29497,29497,29498,0,0,0
29498,29498,29499,0,1,1
29499,29499,29500,1,2,1
29500,29500,29501,2,2,0
29501,29501,29502,2,9,7
29502,29502,29503,9,4,-5
29503,29503,29504,4,3,-1
29504,29504,29505,3,5,2
29505,29505,29506,5,3,-2
29506,29506,29507,3,6,3
29507,29507,29508,6,7,1
29508,29508,29509,7,7,0
29509,29509,29510,7,2,-5
29510,29510,29511,2,8,6
29511,29511,29512,8,7,-1
29512,29512,29513,7,9,2
29513,29513,29514,9,1,-8
29514,29514,29515,1,0,-1
29515,29515,29516,0,7,7
29516,29516,29517,7,1,-6
29517,29517,29518,1,1,0
29518,29518,29519,1,2,1
29519,29519,29520,2,0,-2
29520,29520,29521,0,3,3
29521,29521,29522,3,1,-2
29522,29522,29523,1,4,3
29523,29523,29524,4,5,1
29524,29524,29525,5,5,0
29525,29525,29526,5,6,1
29526,29526,29527,6,6,0
29527,29527,29528,6,3,-3
29528,29528,29529,3,7,4
29529,29529,29530,7,4,-3
29530,29530,29531,4,8,4
29531,29531,29532,8,1,-7
29532,29532,29533,1,9,8
29533,29533,29534,9,5,-4
29534,29534,29535,5,8,3
29535,29535,29536,8,9,1
29536,29536,29537,9,6,-3
29537,29537,29538,6,4,-2
29538,29538,29539,4,5,1
29539,29539,29540,5,0,-5
29540,29540,29541,0,0,0
29541,29541,29542,0,4,4
29542,29542,29543,4,6,2
29543,29543,29544,6,1,-5
29544,29544,29545,1,8,7
29545,29545,29546,8,2,-6
29546,29546,29547,2,9,7
29547,29547,29548,9,6,-3
29548,29548,29549,6,4,-2
29549,29549,29550,4,4,0
29550,29550,29551,4,1,-3
29551,29551,29552,1,9,8
29552,29552,29553,9,9,0
29553,29553,29554,9,6,-3
29554,29554,29555,6,5,-1
29555,29555,29556,5,1,-4
29556,29556,29557,1,3,2
29557,29557,29558,3,4,1
29558,29558,29559,4,0,-4
29559,29559,29560,0,0,0
29560,29560,29561,0,4,4
29561,29561,29562,4,0,-4
29562,29562,29563,0,8,8
29563,29563,29564,8,0,-8
29564,29564,29565,0,9,9
29565,29565,29566,9,4,-5
29566,29566,29567,4,1,-3
29567,29567,29568,1,6,5
29568,29568,29569,6,5,-1
29569,29569,29570,5,0,-5
29570,29570,29571,0,5,5
29571,29571,29572,5,5,0
29572,29572,29573,5,2,-3
29573,29573,29574,2,4,2
29574,29574,29575,4,1,-3
29575,29575,29576,1,8,7
29576,29576,29577,8,4,-4
29577,29577,29578,4,0,-4
29578,29578,29579,0,0,0
29579,29579,29580,0,9,9
29580,29580,29581,9,7,-2
29581,29581,29582,7,7,0
29582,29582,29583,7,6,-1
29583,29583,29584,6,4,-2
29584,29584,29585,4,0,-4
29585,29585,29586,0,1,1
29586,29586,29587,1,1,0
29587,29587,29588,1,4,3
29588,29588,29589,4,8,4
29589,29589,29590,8,4,-4
29590,29590,29591,4,9,5
29591,29591,29592,9,7,-2
29592,29592,29593,7,4,-3
29593,29593,29594,4,2,-2
29594,29594,29595,2,7,5
29595,29595,29596,7,8,1
29596,29596,29597,8,6,-2
29597,29597,29598,6,1,-5
29598,29598,29599,1,0,-1
29599,29599,29600,0,4,4
29600,29600,29601,4,8,4
29601,29601,29602,8,3,-5
29602,29602,29603,3,1,-2
29603,29603,29604,1,8,7
29604,29604,29605,8,7,-1
29605,29605,29606,7,4,-3
29606,29606,29607,4,7,3
29607,29607,29608,7,3,-4
29608,29608,29609,3,1,-2
29609,29609,29610,1,3,2
29610,29610,29611,3,2,-1
29611,29611,29612,2,2,0
29612,29612,29613,2,3,1
29613,29613,29614,3,0,-3
29614,29614,29615,0,1,1
29615,29615,29616,1,5,4
29616,29616,29617,5,4,-1
29617,29617,29618,4,8,4
29618,29618,29619,8,2,-6
29619,29619,29620,2,6,4
29620,29620,29621,6,0,-6
29621,29621,29622,0,6,6
29622,29622,29623,6,0,-6
29623,29623,29624,0,2,2
29624,29624,29625,2,7,5
29625,29625,29626,7,2,-5
29626,29626,29627,2,8,6
29627,29627,29628,8,1,-7
29628,29628,29629,1,8,7
29629,29629,29630,8,6,-2
29630,29630,29631,6,4,-2
29631,29631,29632,4,7,3
29632,29632,29633,7,7,0
29633,29633,29634,7,8,1
29634,29634,29635,8,2,-6
29635,29635,29636,2,3,1
29636,29636,29637,3,5,2
29637,29637,29638,5,4,-1
29638,29638,29639,4,6,2
29639,29639,29640,6,2,-4
29640,29640,29641,2,3,1
29641,29641,29642,3,3,0
29642,29642,29643,3,6,3
29643,29643,29644,6,6,0
29644,29644,29645,6,4,-2
29645,29645,29646,4,2,-2
29646,29646,29647,2,6,4
29647,29647,29648,6,5,-1
29648,29648,29649,5,5,0
29649,29649,29650,5,3,-2
29650,29650,29651,3,1,-2
29651,29651,29652,1,7,6
29652,29652,29653,7,3,-4
29653,29653,29654,3,2,-1
29654,29654,29655,2,9,7
29655,29655,29656,9,8,-1
29656,29656,29657,8,2,-6
29657,29657,29658,2,1,-1
29658,29658,29659,1,5,4
29659,29659,29660,5,9,4
29660,29660,29661,9,7,-2
29661,29661,29662,7,2,-5
29662,29662,29663,2,9,7
29663,29663,29664,9,0,-9
29664,29664,29665,0,8,8
29665,29665,29666,8,1,-7
29666,29666,29667,1,2,1
29667,29667,29668,2,1,-1
29668,29668,29669,1,1,0
29669,29669,29670,1,3,2
29670,29670,29671,3,3,0
29671,29671,29672,3,9,6
29672,29672,29673,9,1,-8
29673,29673,29674,1,2,1
29674,29674,29675,2,3,1
29675,29675,29676,3,0,-3
29676,29676,29677,0,0,0
29677,29677,29678,0,8,8
29678,29678,29679,8,1,-7
29679,29679,29680,1,8,7
29680,29680,29681,8,2,-6
29681,29681,29682,2,6,4
29682,29682,29683,6,4,-2
29683,29683,29684,4,0,-4
29684,29684,29685,0,5,5
29685,29685,29686,5,6,1
29686,29686,29687,6,6,0
29687,29687,29688,6,4,-2
29688,29688,29689,4,7,3
29689,29689,29690,7,4,-3
29690,29690,29691,4,8,4
29691,29691,29692,8,4,-4
29692,29692,29693,4,9,5
29693,29693,29694,9,7,-2
29694,29694,29695,7,0,-7
29695,29695,29696,0,5,5
29696,29696,29697,5,1,-4
29697,29697,29698,1,2,1
29698,29698,29699,2,2,0
29699,29699,29700,2,8,6
29700,29700,29701,8,3,-5
29701,29701,29702,3,8,5
29702,29702,29703,8,4,-4
29703,29703,29704,4,0,-4
29704,29704,29705,0,5,5
29705,29705,29706,5,0,-5
29706,29706,29707,0,6,6
29707,29707,29708,6,5,-1
29708,29708,29709,5,7,2
29709,29709,29710,7,9,2
29710,29710,29711,9,8,-1
29711,29711,29712,8,5,-3
29712,29712,29713,5,0,-5
29713,29713,29714,0,7,7
29714,29714,29715,7,1,-6
29715,29715,29716,1,2,1
29716,29716,29717,2,2,0
29717,29717,29718,2,0,-2
29718,29718,29719,0,3,3
29719,29719,29720,3,2,-1
29720,29720,29721,2,4,2
29721,29721,29722,4,8,4
29722,29722,29723,8,5,-3
29723,29723,29724,5,9,4
29724,29724,29725,9,6,-3
29725,29725,29726,6,2,-4
29726,29726,29727,2,7,5
29727,29727,29728,7,6,-1
29728,29728,29729,6,8,2
29729,29729,29730,8,7,-1
29730,29730,29731,7,9,2
29731,29731,29732,9,0,-9
29732,29732,29733,0,7,7
29733,29733,29734,7,2,-5
29734,29734,29735,2,2,0
29735,29735,29736,2,0,-2
29736,29736,29737,0,9,9
29737,29737,29738,9,9,0
29738,29738,29739,9,4,-5
29739,29739,29740,4,1,-3
29740,29740,29741,1,2,1
29741,29741,29742,2,4,2
29742,29742,29743,4,9,5
29743,29743,29744,9,4,-5
29744,29744,29745,4,8,4
29745,29745,29746,8,1,-7
29746,29746,29747,1,4,3
29747,29747,29748,4,5,1
29748,29748,29749,5,5,0
29749,29749,29750,5,0,-5
29750,29750,29751,0,8,8
29751,29751,29752,8,9,1
29752,29752,29753,9,8,-1
29753,29753,29754,8,4,-4
29754,29754,29755,4,0,-4
29755,29755,29756,0,7,7
29756,29756,29757,7,3,-4
29757,29757,29758,3,6,3
29758,29758,29759,6,5,-1
29759,29759,29760,5,5,0
29760,29760,29761,5,4,-1
29761,29761,29762,4,7,3
29762,29762,29763,7,3,-4
29763,29763,29764,3,4,1
29764,29764,29765,4,3,-1
29765,29765,29766,3,6,3
29766,29766,29767,6,4,-2
29767,29767,29768,4,6,2
29768,29768,29769,6,6,0
29769,29769,29770,6,2,-4
29770,29770,29771,2,5,3
29771,29771,29772,5,0,-5
29772,29772,29773,0,1,1
29773,29773,29774,1,6,5
29774,29774,29775,6,7,1
29775,29775,29776,7,6,-1
29776,29776,29777,6,8,2
29777,29777,29778,8,9,1
29778,29778,29779,9,4,-5
29779,29779,29780,4,8,4
29780,29780,29781,8,5,-3
29781,29781,29782,5,8,3
29782,29782,29783,8,7,-1
29783,29783,29784,7,2,-5
29784,29784,29785,2,3,1
29785,29785,29786,3,7,4
29786,29786,29787,7,5,-2
29787,29787,29788,5,4,-1
29788,29788,29789,4,2,-2
29789,29789,29790,2,5,3
29790,29790,29791,5,3,-2
29791,29791,29792,3,4,1
29792,29792,29793,4,6,2
29793,29793,29794,6,4,-2
29794,29794,29795,4,6,2
29795,29795,29796,6,7,1
29796,29796,29797,7,7,0
29797,29797,29798,7,8,1
29798,29798,29799,8,7,-1
29799,29799,29800,7,3,-4
29800,29800,29801,3,7,4
29801,29801,29802,7,9,2
29802,29802,29803,9,6,-3
29803,29803,29804,6,5,-1
29804,29804,29805,5,0,-5
29805,29805,29806,0,7,7
29806,29806,29807,7,1,-6
29807,29807,29808,1,9,8
29808,29808,29809,9,0,-9
29809,29809,29810,0,1,1
29810,29810,29811,1,1,0
29811,29811,29812,1,1,0
29812,29812,29813,1,6,5
29813,29813,29814,6,4,-2
29814,29814,29815,4,5,1
29815,29815,29816,5,3,-2
29816,29816,29817,3,5,2
29817,29817,29818,5,4,-1
29818,29818,29819,4,2,-2
29819,29819,29820,2,4,2
29820,29820,29821,4,9,5
29821,29821,29822,9,9,0
29822,29822,29823,9,3,-6
29823,29823,29824,3,9,6
29824,29824,29825,9,1,-8
29825,29825,29826,1,7,6
29826,29826,29827,7,4,-3
29827,29827,29828,4,1,-3
29828,29828,29829,1,8,7
29829,29829,29830,8,5,-3
29830,29830,29831,5,8,3
29831,29831,29832,8,6,-2
29832,29832,29833,6,7,1
29833,29833,29834,7,5,-2
29834,29834,29835,5,6,1
29835,29835,29836,6,6,0
29836,29836,29837,6,2,-4
29837,29837,29838,2,6,4
29838,29838,29839,6,2,-4
29839,29839,29840,2,1,-1
29840,29840,29841,1,9,8
29841,29841,29842,9,5,-4
29842,29842,29843,5,6,1
29843,29843,29844,6,3,-3
29844,29844,29845,3,5,2
29845,29845,29846,5,9,4
29846,29846,29847,9,9,0
29847,29847,29848,9,0,-9
29848,29848,29849,0,1,1
29849,29849,29850,1,7,6
29850,29850,29851,7,2,-5
29851,29851,29852,2,5,3
29852,29852,29853,5,2,-3
29853,29853,29854,2,4,2
29854,29854,29855,4,7,3
29855,29855,29856,7,9,2
29856,29856,29857,9,9,0
29857,29857,29858,9,8,-1
29858,29858,29859,8,7,-1
29859,29859,29860,7,0,-7
29860,29860,29861,0,9,9
29861,29861,29862,9,0,-9
29862,29862,29863,0,8,8
29863,29863,29864,8,4,-4
29864,29864,29865,4,9,5
29865,29865,29866,9,4,-5
29866,29866,29867,4,7,3
29867,29867,29868,7,9,2
29868,29868,29869,9,0,-9
29869,29869,29870,0,5,5
29870,29870,29871,5,5,0
29871,29871,29872,5,6,1
29872,29872,29873,6,0,-6
29873,29873,29874,0,9,9
29874,29874,29875,9,3,-6
29875,29875,29876,3,2,-1
29876,29876,29877,2,8,6
29877,29877,29878,8,9,1
29878,29878,29879,9,4,-5
29879,29879,29880,4,5,1
29880,29880,29881,5,6,1
29881,29881,29882,6,3,-3
29882,29882,29883,3,1,-2
29883,29883,29884,1,4,3
29884,29884,29885,4,4,0
29885,29885,29886,4,8,4
29886,29886,29887,8,0,-8
29887,29887,29888,0,7,7
29888,29888,29889,7,3,-4
29889,29889,29890,3,5,2
29890,29890,29891,5,6,1
29891,29891,29892,6,5,-1
29892,29892,29893,5,2,-3
29893,29893,29894,2,3,1
29894,29894,29895,3,0,-3
29895,29895,29896,0,3,3
29896,29896,29897,3,1,-2
29897,29897,29898,1,4,3
29898,29898,29899,4,3,-1
29899,29899,29900,3,7,4
29900,29900,29901,7,1,-6
29901,29901,29902,1,1,0
29902,29902,29903,1,0,-1
29903,29903,29904,0,2,2
29904,29904,29905,2,9,7
29905,29905,29906,9,2,-7
29906,29906,29907,2,0,-2
29907,29907,29908,0,7,7
29908,29908,29909,7,1,-6
29909,29909,29910,1,4,3
29910,29910,29911,4,2,-2
29911,29911,29912,2,5,3
29912,29912,29913,5,3,-2
29913,29913,29914,3,4,1
29914,29914,29915,4,5,1
29915,29915,29916,5,5,0
29916,29916,29917,5,6,1
29917,29917,29918,6,0,-6
29918,29918,29919,0,7,7
29919,29919,29920,7,7,0
29920,29920,29921,7,8,1
29921,29921,29922,8,4,-4
29922,29922,29923,4,9,5
29923,29923,29924,9,5,-4
29924,29924,29925,5,0,-5
29925,29925,29926,0,0,0
29926,29926,29927,0,1,1
29927,29927,29928,1,6,5
29928,29928,29929,6,4,-2
29929,29929,29930,4,2,-2
29930,29930,29931,2,7,5
29931,29931,29932,7,2,-5
29932,29932,29933,2,8,6
29933,29933,29934,8,0,-8
29934,29934,29935,0,9,9
29935,29935,29936,9,3,-6
29936,29936,29937,3,0,-3
29937,29937,29938,0,9,9
29938,29938,29939,9,1,-8
29939,29939,29940,1,5,4
29940,29940,29941,5,4,-1
29941,29941,29942,4,4,0
29942,29942,29943,4,7,3
29943,29943,29944,7,6,-1
29944,29944,29945,6,8,2
29945,29945,29946,8,4,-4
29946,29946,29947,4,9,5
29947,29947,29948,9,7,-2
29948,29948,29949,7,1,-6
29949,29949,29950,1,6,5
29950,29950,29951,6,7,1
29951,29951,29952,7,1,-6
29952,29952,29953,1,9,8
29953,29953,29954,9,7,-2
29954,29954,29955,7,5,-2
29955,29955,29956,5,9,4
29956,29956,29957,9,1,-8
29957,29957,29958,1,3,2
29958,29958,29959,3,9,6
29959,29959,29960,9,4,-5
29960,29960,29961,4,1,-3
29961,29961,29962,1,3,2
29962,29962,29963,3,7,4
29963,29963,29964,7,7,0
29964,29964,29965,7,8,1
29965,29965,29966,8,6,-2
29966,29966,29967,6,2,-4
29967,29967,29968,2,1,-1
29968,29968,29969,1,3,2
29969,29969,29970,3,6,3
29970,29970,29971,6,6,0
29971,29971,29972,6,3,-3
29972,29972,29973,3,9,6
29973,29973,29974,9,1,-8
29974,29974,29975,1,9,8
29975,29975,29976,9,1,-8
29976,29976,29977,1,5,4
29977,29977,29978,5,9,4
29978,29978,29979,9,8,-1
29979,29979,29980,8,9,1
29980,29980,29981,9,6,-3
29981,29981,29982,6,7,1
29982,29982,29983,7,7,0
29983,29983,29984,7,7,0
29984,29984,29985,7,0,-7
29985,29985,29986,0,1,1
29986,29986,29987,1,6,5
29987,29987,29988,6,8,2
29988,29988,29989,8,8,0
29989,29989,29990,8,2,-6
29990,29990,29991,2,3,1
29991,29991,29992,3,4,1
29992,29992,29993,4,9,5
29993,29993,29994,9,0,-9
29994,29994,29995,0,8,8
29995,29995,29996,8,9,1
29996,29996,29997,9,6,-3
29997,29997,29998,6,7,1
29998,29998,29999,7,1,-6
29999,29999,30000,1,3,2
30000,30000,30001,3,7,4
30001,30001,30002,7,3,-4
30002,30002,30003,3,9,6
30003,30003,30004,9,6,-3
30004,30004,30005,6,4,-2
30005,30005,30006,4,4,0
30006,30006,30007,4,1,-3
30007,30007,30008,1,7,6
30008,30008,30009,7,0,-7
30009,30009,30010,0,9,9
30010,30010,30011,9,3,-6
30011,30011,30012,3,5,2
30012,30012,30013,5,8,3
30013,30013,30014,8,2,-6
30014,30014,30015,2,7,5
30015,30015,30016,7,4,-3
30016,30016,30017,4,7,3
30017,30017,30018,7,7,0
30018,30018,30019,7,8,1
30019,30019,30020,8,5,-3
30020,30020,30021,5,7,2
30021,30021,30022,7,9,2
30022,30022,30023,9,6,-3
30023,30023,30024,6,6,0
30024,30024,30025,6,6,0
30025,30025,30026,6,8,2
30026,30026,30027,8,2,-6
30027,30027,30028,2,5,3
30028,30028,30029,5,8,3
30029,30029,30030,8,5,-3
30030,30030,30031,5,1,-4
30031,30031,30032,1,2,1
30032,30032,30033,2,6,4
30033,30033,30034,6,0,-6
30034,30034,30035,0,1,1
30035,30035,30036,1,6,5
30036,30036,30037,6,0,-6
30037,30037,30038,0,8,8
30038,30038,30039,8,4,-4
30039,30039,30040,4,3,-1
30040,30040,30041,3,3,0
30041,30041,30042,3,5,2
30042,30042,30043,5,1,-4
30043,30043,30044,1,0,-1
30044,30044,30045,0,6,6
30045,30045,30046,6,5,-1
30046,30046,30047,5,1,-4
30047,30047,30048,1,3,2
30048,30048,30049,3,9,6
30049,30049,30050,9,8,-1
30050,30050,30051,8,0,-8
30051,30051,30052,0,4,4
30052,30052,30053,4,1,-3
30053,30053,30054,1,2,1
30054,30054,30055,2,2,0
30055,30055,30056,2,2,0
30056,30056,30057,2,3,1
30057,30057,30058,3,0,-3
30058,30058,30059,0,4,4
30059,30059,30060,4,7,3
30060,30060,30061,7,5,-2
30061,30061,30062,5,3,-2
30062,30062,30063,3,6,3
30063,30063,30064,6,2,-4
30064,30064,30065,2,7,5
30065,30065,30066,7,4,-3
30066,30066,30067,4,8,4
30067,30067,30068,8,1,-7
30068,30068,30069,1,9,8
30069,30069,30070,9,3,-6
30070,30070,30071,3,0,-3
30071,30071,30072,0,3,3
30072,30072,30073,3,1,-2
30073,30073,30074,1,6,5
30074,30074,30075,6,2,-4
30075,30075,30076,2,2,0
30076,30076,30077,2,3,1
30077,30077,30078,3,2,-1
30078,30078,30079,2,4,2
30079,30079,30080,4,0,-4
30080,30080,30081,0,5,5
30081,30081,30082,5,5,0
30082,30082,30083,5,6,1
30083,30083,30084,6,3,-3
30084,30084,30085,3,9,6
30085,30085,30086,9,5,-4
30086,30086,30087,5,0,-5
30087,30087,30088,0,0,0
30088,30088,30089,0,1,1
30089,30089,30090,1,3,2
30090,30090,30091,3,2,-1
30091,30091,30092,2,8,6
30092,30092,30093,8,3,-5
30093,30093,30094,3,2,-1
30094,30094,30095,2,9,7
30095,30095,30096,9,9,0
30096,30096,30097,9,0,-9
30097,30097,30098,0,8,8
30098,30098,30099,8,9,1
30099,30099,30100,9,1,-8
30100,30100,30101,1,0,-1
30101,30101,30102,0,2,2
30102,30102,30103,2,9,7
30103,30103,30104,9,1,-8
30104,30104,30105,1,3,2
30105,30105,30106,3,6,3
30106,30106,30107,6,2,-4
30107,30107,30108,2,4,2
30108,30108,30109,4,7,3
30109,30109,30110,7,9,2
30110,30110,30111,9,8,-1
30111,30111,30112,8,5,-3
30112,30112,30113,5,4,-1
30113,30113,30114,4,6,2
30114,30114,30115,6,6,0
30115,30115,30116,6,8,2
30116,30116,30117,8,1,-7
30117,30117,30118,1,7,6
30118,30118,30119,7,0,-7
30119,30119,30120,0,2,2
30120,30120,30121,2,4,2
30121,30121,30122,4,2,-2
30122,30122,30123,2,0,-2
30123,30123,30124,0,3,3
30124,30124,30125,3,5,2
30125,30125,30126,5,1,-4
30126,30126,30127,1,0,-1
30127,30127,30128,0,6,6
30128,30128,30129,6,1,-5
30129,30129,30130,1,3,2
30130,30130,30131,3,3,0
30131,30131,30132,3,5,2
30132,30132,30133,5,2,-3
30133,30133,30134,2,4,2
30134,30134,30135,4,9,5
30135,30135,30136,9,3,-6
30136,30136,30137,3,1,-2
30137,30137,30138,1,9,8
30138,30138,30139,9,6,-3
30139,30139,30140,6,1,-5
30140,30140,30141,1,0,-1
30141,30141,30142,0,6,6
30142,30142,30143,6,1,-5
30143,30143,30144,1,9,8
30144,30144,30145,9,1,-8
30145,30145,30146,1,1,0
30146,30146,30147,1,8,7
30147,30147,30148,8,1,-7
30148,30148,30149,1,0,-1
30149,30149,30150,0,6,6
30150,30150,30151,6,4,-2
30151,30151,30152,4,6,2
30152,30152,30153,6,7,1
30153,30153,30154,7,7,0
30154,30154,30155,7,7,0
30155,30155,30156,7,0,-7
30156,30156,30157,0,6,6
30157,30157,30158,6,1,-5
30158,30158,30159,1,3,2
30159,30159,30160,3,0,-3
30160,30160,30161,0,6,6
30161,30161,30162,6,8,2
30162,30162,30163,8,0,-8
30163,30163,30164,0,4,4
30164,30164,30165,4,7,3
30165,30165,30166,7,7,0
30166,30166,30167,7,4,-3
30167,30167,30168,4,6,2
30168,30168,30169,6,4,-2
30169,30169,30170,4,0,-4
30170,30170,30171,0,1,1
30171,30171,30172,1,8,7
30172,30172,30173,8,8,0
30173,30173,30174,8,4,-4
30174,30174,30175,4,3,-1
30175,30175,30176,3,1,-2
30176,30176,30177,1,7,6
30177,30177,30178,7,6,-1
30178,30178,30179,6,1,-5
30179,30179,30180,1,4,3
30180,30180,30181,4,9,5
30181,30181,30182,9,6,-3
30182,30182,30183,6,3,-3
30183,30183,30184,3,9,6
30184,30184,30185,9,8,-1
30185,30185,30186,8,4,-4
30186,30186,30187,4,0,-4
30187,30187,30188,0,7,7
30188,30188,30189,7,1,-6
30189,30189,30190,1,7,6
30190,30190,30191,7,2,-5
30191,30191,30192,2,6,4
30192,30192,30193,6,3,-3
30193,30193,30194,3,1,-2
30194,30194,30195,1,4,3
30195,30195,30196,4,0,-4
30196,30196,30197,0,5,5
30197,30197,30198,5,4,-1
30198,30198,30199,4,6,2
30199,30199,30200,6,1,-5
30200,30200,30201,1,7,6
30201,30201,30202,7,7,0
30202,30202,30203,7,8,1
30203,30203,30204,8,9,1
30204,30204,30205,9,9,0
30205,30205,30206,9,3,-6
30206,30206,30207,3,0,-3
30207,30207,30208,0,9,9
30208,30208,30209,9,1,-8
30209,30209,30210,1,1,0
30210,30210,30211,1,2,1
30211,30211,30212,2,0,-2
30212,30212,30213,0,3,3
30213,30213,30214,3,1,-2
30214,30214,30215,1,4,3
30215,30215,30216,4,5,1
30216,30216,30217,5,5,0
30217,30217,30218,5,1,-4
30218,30218,30219,1,8,7
30219,30219,30220,8,0,-8
30220,30220,30221,0,9,9
30221,30221,30222,9,0,-9
30222,30222,30223,0,0,0
30223,30223,30224,0,7,7
30224,30224,30225,7,1,-6
30225,30225,30226,1,3,2
30226,30226,30227,3,2,-1
30227,30227,30228,2,2,0
30228,30228,30229,2,3,1
30229,30229,30230,3,6,3
30230,30230,30231,6,4,-2
30231,30231,30232,4,6,2
30232,30232,30233,6,5,-1
30233,30233,30234,5,4,-1
30234,30234,30235,4,8,4
30235,30235,30236,8,8,0
30236,30236,30237,8,9,1
30237,30237,30238,9,1,-8
30238,30238,30239,1,8,7
30239,30239,30240,8,0,-8
30240,30240,30241,0,3,3
30241,30241,30242,3,8,5
30242,30242,30243,8,4,-4
30243,30243,30244,4,1,-3
30244,30244,30245,1,7,6
30245,30245,30246,7,0,-7
30246,30246,30247,0,8,8
30247,30247,30248,8,8,0
30248,30248,30249,8,6,-2
30249,30249,30250,6,7,1
30250,30250,30251,7,3,-4
30251,30251,30252,3,6,3
30252,30252,30253,6,4,-2
30253,30253,30254,4,3,-1
30254,30254,30255,3,0,-3
30255,30255,30256,0,3,3
30256,30256,30257,3,9,6
30257,30257,30258,9,3,-6
30258,30258,30259,3,7,4
30259,30259,30260,7,7,0
30260,30260,30261,7,1,-6
30261,30261,30262,1,5,4
30262,30262,30263,5,9,4
30263,30263,30264,9,7,-2
30264,30264,30265,7,3,-4
30265,30265,30266,3,4,1
30266,30266,30267,4,8,4
30267,30267,30268,8,8,0
30268,30268,30269,8,4,-4
30269,30269,30270,4,1,-3
30270,30270,30271,1,7,6
30271,30271,30272,7,4,-3
30272,30272,30273,4,3,-1
30273,30273,30274,3,1,-2
30274,30274,30275,1,0,-1
30275,30275,30276,0,4,4
30276,30276,30277,4,9,5
30277,30277,30278,9,5,-4
30278,30278,30279,5,6,1
30279,30279,30280,6,5,-1
30280,30280,30281,5,1,-4
30281,30281,30282,1,3,2
30282,30282,30283,3,4,1
30283,30283,30284,4,3,-1
30284,30284,30285,3,5,2
30285,30285,30286,5,7,2
30286,30286,30287,7,4,-3
30287,30287,30288,4,5,1
30288,30288,30289,5,6,1
30289,30289,30290,6,7,1
30290,30290,30291,7,2,-5
30291,30291,30292,2,1,-1
30292,30292,30293,1,0,-1
30293,30293,30294,0,7,7
30294,30294,30295,7,6,-1
30295,30295,30296,6,9,3
30296,30296,30297,9,2,-7
30297,30297,30298,2,4,2
30298,30298,30299,4,1,-3
30299,30299,30300,1,0,-1
30300,30300,30301,0,1,1
30301,30301,30302,1,7,6
30302,30302,30303,7,1,-6
30303,30303,30304,1,3,2
30304,30304,30305,3,1,-2
30305,30305,30306,1,3,2
30306,30306,30307,3,7,4
30307,30307,30308,7,9,2
30308,30308,30309,9,2,-7
30309,30309,30310,2,7,5
30310,30310,30311,7,4,-3
30311,30311,30312,4,6,2
30312,30312,30313,6,7,1
30313,30313,30314,7,6,-1
30314,30314,30315,6,5,-1
30315,30315,30316,5,4,-1
30316,30316,30317,4,2,-2
30317,30317,30318,2,8,6
30318,30318,30319,8,9,1
30319,30319,30320,9,0,-9
30320,30320,30321,0,4,4
30321,30321,30322,4,8,4
30322,30322,30323,8,5,-3
30323,30323,30324,5,8,3
30324,30324,30325,8,8,0
30325,30325,30326,8,4,-4
30326,30326,30327,4,4,0
30327,30327,30328,4,9,5
30328,30328,30329,9,2,-7
30329,30329,30330,2,8,6
30330,30330,30331,8,0,-8
30331,30331,30332,0,6,6
30332,30332,30333,6,5,-1
30333,30333,30334,5,9,4
30334,30334,30335,9,1,-8
30335,30335,30336,1,2,1
30336,30336,30337,2,1,-1
30337,30337,30338,1,6,5
30338,30338,30339,6,7,1
30339,30339,30340,7,0,-7
30340,30340,30341,0,6,6
30341,30341,30342,6,9,3
30342,30342,30343,9,6,-3
30343,30343,30344,6,2,-4
30344,30344,30345,2,6,4
30345,30345,30346,6,2,-4
30346,30346,30347,2,8,6
30347,30347,30348,8,7,-1
30348,30348,30349,7,2,-5
30349,30349,30350,2,6,4
30350,30350,30351,6,5,-1
30351,30351,30352,5,0,-5
30352,30352,30353,0,2,2
30353,30353,30354,2,3,1
30354,30354,30355,3,2,-1
30355,30355,30356,2,2,0
30356,30356,30357,2,7,5
30357,30357,30358,7,9,2
30358,30358,30359,9,7,-2
30359,30359,30360,7,9,2
30360,30360,30361,9,4,-5
30361,30361,30362,4,3,-1
30362,30362,30363,3,0,-3
30363,30363,30364,0,1,1
30364,30364,30365,1,2,1
30365,30365,30366,2,1,-1
30366,30366,30367,1,4,3
30367,30367,30368,4,1,-3
30368,30368,30369,1,2,1
30369,30369,30370,2,0,-2
30370,30370,30371,0,5,5
30371,30371,30372,5,1,-4
30372,30372,30373,1,0,-1
30373,30373,30374,0,8,8
30374,30374,30375,8,3,-5
30375,30375,30376,3,2,-1
30376,30376,30377,2,3,1
30377,30377,30378,3,9,6
30378,30378,30379,9,3,-6
30379,30379,30380,3,7,4
30380,30380,30381,7,1,-6
30381,30381,30382,1,0,-1
30382,30382,30383,0,8,8
30383,30383,30384,8,0,-8
30384,30384,30385,0,9,9
30385,30385,30386,9,3,-6
30386,30386,30387,3,6,3
30387,30387,30388,6,0,-6
30388,30388,30389,0,1,1
30389,30389,30390,1,5,4
30390,30390,30391,5,0,-5
30391,30391,30392,0,6,6
30392,30392,30393,6,5,-1
30393,30393,30394,5,9,4
30394,30394,30395,9,9,0
30395,30395,30396,9,5,-4
30396,30396,30397,5,8,3
30397,30397,30398,8,3,-5
30398,30398,30399,3,5,2
30399,30399,30400,5,3,-2
30400,30400,30401,3,8,5
30401,30401,30402,8,5,-3
30402,30402,30403,5,5,0
30403,30403,30404,5,1,-4
30404,30404,30405,1,5,4
30405,30405,30406,5,9,4
30406,30406,30407,9,8,-1
30407,30407,30408,8,1,-7
30408,30408,30409,1,0,-1
30409,30409,30410,0,5,5
30410,30410,30411,5,3,-2
30411,30411,30412,3,8,5
30412,30412,30413,8,0,-8
30413,30413,30414,0,7,7
30414,30414,30415,7,8,1
30415,30415,30416,8,8,0
30416,30416,30417,8,3,-5
30417,30417,30418,3,8,5
30418,30418,30419,8,9,1
30419,30419,30420,9,2,-7
30420,30420,30421,2,6,4
30421,30421,30422,6,4,-2
30422,30422,30423,4,3,-1
30423,30423,30424,3,0,-3
30424,30424,30425,0,0,0
30425,30425,30426,0,6,6
30426,30426,30427,6,1,-5
30427,30427,30428,1,7,6
30428,30428,30429,7,2,-5
30429,30429,30430,2,1,-1
30430,30430,30431,1,3,2
30431,30431,30432,3,7,4
30432,30432,30433,7,7,0
30433,30433,30434,7,0,-7
30434,30434,30435,0,8,8
30435,30435,30436,8,1,-7
30436,30436,30437,1,9,8
30437,30437,30438,9,0,-9
30438,30438,30439,0,0,0
30439,30439,30440,0,6,6
30440,30440,30441,6,1,-5
30441,30441,30442,1,7,6
30442,30442,30443,7,2,-5
30443,30443,30444,2,6,4
30444,30444,30445,6,3,-3
30445,30445,30446,3,9,6
30446,30446,30447,9,4,-5
30447,30447,30448,4,5,1
30448,30448,30449,5,7,2
30449,30449,30450,7,8,1
30450,30450,30451,8,8,0
30451,30451,30452,8,9,1
30452,30452,30453,9,9,0
30453,30453,30454,9,6,-3
30454,30454,30455,6,0,-6
30455,30455,30456,0,5,5
30456,30456,30457,5,1,-4
30457,30457,30458,1,4,3
30458,30458,30459,4,2,-2
30459,30459,30460,2,8,6
30460,30460,30461,8,3,-5
30461,30461,30462,3,7,4
30462,30462,30463,7,4,-3
30463,30463,30464,4,4,0
30464,30464,30465,4,7,3
30465,30465,30466,7,6,-1
30466,30466,30467,6,8,2
30467,30467,30468,8,3,-5
30468,30468,30469,3,9,6
30469,30469,30470,9,9,0
30470,30470,30471,9,1,-8
30471,30471,30472,1,4,3
30472,30472,30473,4,0,-4
30473,30473,30474,0,6,6
30474,30474,30475,6,1,-5
30475,30475,30476,1,5,4
30476,30476,30477,5,2,-3
30477,30477,30478,2,8,6
30478,30478,30479,8,7,-1
30479,30479,30480,7,0,-7
30480,30480,30481,0,7,7
30481,30481,30482,7,5,-2
30482,30482,30483,5,3,-2
30483,30483,30484,3,0,-3
30484,30484,30485,0,2,2
30485,30485,30486,2,1,-1
30486,30486,30487,1,2,1
30487,30487,30488,2,5,3
30488,30488,30489,5,3,-2
30489,30489,30490,3,6,3
30490,30490,30491,6,9,3
30491,30491,30492,9,2,-7
30492,30492,30493,2,1,-1
30493,30493,30494,1,8,7
30494,30494,30495,8,7,-1
30495,30495,30496,7,0,-7
30496,30496,30497,0,9,9
30497,30497,30498,9,9,0
30498,30498,30499,9,5,-4
30499,30499,30500,5,9,4
30500,30500,30501,9,7,-2
30501,30501,30502,7,7,0
30502,30502,30503,7,2,-5
30503,30503,30504,2,7,5
30504,30504,30505,7,9,2
30505,30505,30506,9,4,-5
30506,30506,30507,4,6,2
30507,30507,30508,6,1,-5
30508,30508,30509,1,1,0
30509,30509,30510,1,8,7
30510,30510,30511,8,3,-5
30511,30511,30512,3,1,-2
30512,30512,30513,1,7,6
30513,30513,30514,7,5,-2
30514,30514,30515,5,3,-2
30515,30515,30516,3,8,5
30516,30516,30517,8,9,1
30517,30517,30518,9,6,-3
30518,30518,30519,6,8,2
30519,30519,30520,8,9,1
30520,30520,30521,9,8,-1
30521,30521,30522,8,2,-6
30522,30522,30523,2,8,6
30523,30523,30524,8,1,-7
30524,30524,30525,1,8,7
30525,30525,30526,8,6,-2
30526,30526,30527,6,8,2
30527,30527,30528,8,5,-3
30528,30528,30529,5,4,-1
30529,30529,30530,4,2,-2
30530,30530,30531,2,7,5
30531,30531,30532,7,7,0
30532,30532,30533,7,2,-5
30533,30533,30534,2,2,0
30534,30534,30535,2,1,-1
30535,30535,30536,1,4,3
30536,30536,30537,4,9,5
30537,30537,30538,9,7,-2
30538,30538,30539,7,8,1
30539,30539,30540,8,3,-5
30540,30540,30541,3,7,4
30541,30541,30542,7,4,-3
30542,30542,30543,4,8,4
30543,30543,30544,8,5,-3
30544,30544,30545,5,8,3
30545,30545,30546,8,8,0
30546,30546,30547,8,0,-8
30547,30547,30548,0,0,0
30548,30548,30549,0,7,7
30549,30549,30550,7,1,-6
30550,30550,30551,1,9,8
30551,30551,30552,9,4,-5
30552,30552,30553,4,5,1
30553,30553,30554,5,4,-1
30554,30554,30555,4,0,-4
30555,30555,30556,0,1,1
30556,30556,30557,1,6,5
30557,30557,30558,6,7,1
30558,30558,30559,7,8,1
30559,30559,30560,8,7,-1
30560,30560,30561,7,2,-5
30561,30561,30562,2,9,7
30562,30562,30563,9,6,-3
30563,30563,30564,6,1,-5
30564,30564,30565,1,0,-1
30565,30565,30566,0,5,5
30566,30566,30567,5,1,-4
30567,30567,30568,1,8,7
30568,30568,30569,8,2,-6
30569,30569,30570,2,2,0
30570,30570,30571,2,3,1
30571,30571,30572,3,5,2
30572,30572,30573,5,4,-1
30573,30573,30574,4,3,-1
30574,30574,30575,3,5,2
30575,30575,30576,5,6,1
30576,30576,30577,6,6,0
30577,30577,30578,6,0,-6
30578,30578,30579,0,7,7
30579,30579,30580,7,2,-5
30580,30580,30581,2,8,6
30581,30581,30582,8,6,-2
30582,30582,30583,6,9,3
30583,30583,30584,9,8,-1
30584,30584,30585,8,0,-8
30585,30585,30586,0,0,0
30586,30586,30587,0,1,1
30587,30587,30588,1,4,3
30588,30588,30589,4,2,-2
30589,30589,30590,2,4,2
30590,30590,30591,4,3,-1
30591,30591,30592,3,1,-2
30592,30592,30593,1,4,3
30593,30593,30594,4,2,-2
30594,30594,30595,2,5,3
30595,30595,30596,5,2,-3
30596,30596,30597,2,6,4
30597,30597,30598,6,9,3
30598,30598,30599,9,7,-2
30599,30599,30600,7,2,-5
30600,30600,30601,2,8,6
30601,30601,30602,8,4,-4
30602,30602,30603,4,9,5
30603,30603,30604,9,7,-2
30604,30604,30605,7,0,-7
30605,30605,30606,0,1,1
30606,30606,30607,1,1,0
30607,30607,30608,1,6,5
30608,30608,30609,6,2,-4
30609,30609,30610,2,7,5
30610,30610,30611,7,3,-4
30611,30611,30612,3,1,-2
30612,30612,30613,1,4,3
30613,30613,30614,4,1,-3
30614,30614,30615,1,5,4
30615,30615,30616,5,1,-4
30616,30616,30617,1,6,5
30617,30617,30618,6,0,-6
30618,30618,30619,0,7,7
30619,30619,30620,7,9,2
30620,30620,30621,9,8,-1
30621,30621,30622,8,5,-3
30622,30622,30623,5,9,4
30623,30623,30624,9,0,-9
30624,30624,30625,0,0,0
30625,30625,30626,0,5,5
30626,30626,30627,5,9,4
30627,30627,30628,9,1,-8
30628,30628,30629,1,9,8
30629,30629,30630,9,6,-3
30630,30630,30631,6,8,2
30631,30631,30632,8,6,-2
30632,30632,30633,6,9,3
30633,30633,30634,9,2,-7
30634,30634,30635,2,8,6
30635,30635,30636,8,9,1
30636,30636,30637,9,4,-5
30637,30637,30638,4,6,2
30638,30638,30639,6,1,-5
30639,30639,30640,1,2,1
30640,30640,30641,2,7,5
30641,30641,30642,7,3,-4
30642,30642,30643,3,7,4
30643,30643,30644,7,3,-4
30644,30644,30645,3,3,0
30645,30645,30646,3,9,6
30646,30646,30647,9,5,-4
30647,30647,30648,5,6,1
30648,30648,30649,6,1,-5
30649,30649,30650,1,3,2
30650,30650,30651,3,0,-3
30651,30651,30652,0,7,7
30652,30652,30653,7,0,-7
30653,30653,30654,0,8,8
30654,30654,30655,8,2,-6
30655,30655,30656,2,8,6
30656,30656,30657,8,7,-1
30657,30657,30658,7,4,-3
30658,30658,30659,4,7,3
30659,30659,30660,7,9,2
30660,30660,30661,9,8,-1
30661,30661,30662,8,3,-5
30662,30662,30663,3,2,-1
30663,30663,30664,2,7,5
30664,30664,30665,7,0,-7
30665,30665,30666,0,4,4
30666,30666,30667,4,1,-3
30667,30667,30668,1,0,-1
30668,30668,30669,0,2,2
30669,30669,30670,2,7,5
30670,30670,30671,7,6,-1
30671,30671,30672,6,7,1
30672,30672,30673,7,3,-4
30673,30673,30674,3,7,4
30674,30674,30675,7,3,-4
30675,30675,30676,3,5,2
30676,30676,30677,5,7,2
30677,30677,30678,7,0,-7
30678,30678,30679,0,3,3
30679,30679,30680,3,6,3
30680,30680,30681,6,3,-3
30681,30681,30682,3,4,1
30682,30682,30683,4,4,0
30683,30683,30684,4,1,-3
30684,30684,30685,1,6,5
30685,30685,30686,6,9,3
30686,30686,30687,9,6,-3
30687,30687,30688,6,8,2
30688,30688,30689,8,6,-2
30689,30689,30690,6,2,-4
30690,30690,30691,2,4,2
30691,30691,30692,4,3,-1
30692,30692,30693,3,9,6
30693,30693,30694,9,9,0
30694,30694,30695,9,1,-8
30695,30695,30696,1,9,8
30696,30696,30697,9,5,-4
30697,30697,30698,5,9,4
30698,30698,30699,9,0,-9
30699,30699,30700,0,0,0
30700,30700,30701,0,9,9
30701,30701,30702,9,4,-5
30702,30702,30703,4,8,4
30703,30703,30704,8,9,1
30704,30704,30705,9,2,-7
30705,30705,30706,2,0,-2
30706,30706,30707,0,0,0
30707,30707,30708,0,4,4
30708,30708,30709,4,0,-4
30709,30709,30710,0,2,2
30710,30710,30711,2,1,-1
30711,30711,30712,1,9,8
30712,30712,30713,9,7,-2
30713,30713,30714,7,5,-2
30714,30714,30715,5,6,1
30715,30715,30716,6,6,0
30716,30716,30717,6,3,-3
30717,30717,30718,3,7,4
30718,30718,30719,7,2,-5
30719,30719,30720,2,3,1
30720,30720,30721,3,1,-2
30721,30721,30722,1,7,6
30722,30722,30723,7,7,0
30723,30723,30724,7,2,-5
30724,30724,30725,2,4,2
30725,30725,30726,4,2,-2
30726,30726,30727,2,6,4
30727,30727,30728,6,7,1
30728,30728,30729,7,3,-4
30729,30729,30730,3,2,-1
30730,30730,30731,2,1,-1
30731,30731,30732,1,8,7
30732,30732,30733,8,3,-5
30733,30733,30734,3,0,-3
30734,30734,30735,0,9,9
30735,30735,30736,9,4,-5
30736,30736,30737,4,1,-3
30737,30737,30738,1,8,7
30738,30738,30739,8,7,-1
30739,30739,30740,7,3,-4
30740,30740,30741,3,6,3
30741,30741,30742,6,1,-5
30742,30742,30743,1,8,7
30743,30743,30744,8,6,-2
30744,30744,30745,6,4,-2
30745,30745,30746,4,2,-2
30746,30746,30747,2,3,1
30747,30747,30748,3,0,-3
30748,30748,30749,0,1,1
30749,30749,30750,1,9,8
30750,30750,30751,9,0,-9
30751,30751,30752,0,2,2
30752,30752,30753,2,9,7
30753,30753,30754,9,3,-6
30754,30754,30755,3,6,3
30755,30755,30756,6,9,3
30756,30756,30757,9,1,-8
30757,30757,30758,1,9,8
30758,30758,30759,9,7,-2
30759,30759,30760,7,3,-4
30760,30760,30761,3,5,2
30761,30761,30762,5,2,-3
30762,30762,30763,2,4,2
30763,30763,30764,4,7,3
30764,30764,30765,7,4,-3
30765,30765,30766,4,5,1
30766,30766,30767,5,7,2
30767,30767,30768,7,7,0
30768,30768,30769,7,2,-5
30769,30769,30770,2,6,4
30770,30770,30771,6,8,2
30771,30771,30772,8,2,-6
30772,30772,30773,2,4,2
30773,30773,30774,4,3,-1
30774,30774,30775,3,8,5
30775,30775,30776,8,9,1
30776,30776,30777,9,8,-1
30777,30777,30778,8,9,1
30778,30778,30779,9,4,-5
30779,30779,30780,4,3,-1
30780,30780,30781,3,8,5
30781,30781,30782,8,9,1
30782,30782,30783,9,9,0
30783,30783,30784,9,6,-3
30784,30784,30785,6,8,2
30785,30785,30786,8,7,-1
30786,30786,30787,7,0,-7
30787,30787,30788,0,6,6
30788,30788,30789,6,1,-5
30789,30789,30790,1,0,-1
30790,30790,30791,0,2,2
30791,30791,30792,2,4,2
30792,30792,30793,4,3,-1
30793,30793,30794,3,2,-1
30794,30794,30795,2,4,2
30795,30795,30796,4,6,2
30796,30796,30797,6,5,-1
30797,30797,30798,5,7,2
30798,30798,30799,7,6,-1
30799,30799,30800,6,0,-6
30800,30800,30801,0,7,7
30801,30801,30802,7,2,-5
30802,30802,30803,2,8,6
30803,30803,30804,8,9,1
30804,30804,30805,9,9,0
30805,30805,30806,9,8,-1
30806,30806,30807,8,0,-8
30807,30807,30808,0,9,9
30808,30808,30809,9,1,-8
30809,30809,30810,1,2,1
30810,30810,30811,2,2,0
30811,30811,30812,2,6,4
30812,30812,30813,6,3,-3
30813,30813,30814,3,9,6
30814,30814,30815,9,4,-5
30815,30815,30816,4,2,-2
30816,30816,30817,2,5,3
30817,30817,30818,5,6,1
30818,30818,30819,6,6,0
30819,30819,30820,6,6,0
30820,30820,30821,6,7,1
30821,30821,30822,7,6,-1
30822,30822,30823,6,8,2
30823,30823,30824,8,3,-5
30824,30824,30825,3,9,6
30825,30825,30826,9,2,-7
30826,30826,30827,2,0,-2
30827,30827,30828,0,0,0
30828,30828,30829,0,1,1
30829,30829,30830,1,4,3
30830,30830,30831,4,2,-2
30831,30831,30832,2,2,0
30832,30832,30833,2,3,1
30833,30833,30834,3,9,6
30834,30834,30835,9,4,-5
30835,30835,30836,4,9,5
30836,30836,30837,9,5,-4
30837,30837,30838,5,9,4
30838,30838,30839,9,6,-3
30839,30839,30840,6,2,-4
30840,30840,30841,2,7,5
30841,30841,30842,7,5,-2
30842,30842,30843,5,8,3
30843,30843,30844,8,8,0
30844,30844,30845,8,9,1
30845,30845,30846,9,4,-5
30846,30846,30847,4,1,-3
30847,30847,30848,1,1,0
30848,30848,30849,1,0,-1
30849,30849,30850,0,9,9
30850,30850,30851,9,4,-5
30851,30851,30852,4,1,-3
30852,30852,30853,1,5,4
30853,30853,30854,5,1,-4
30854,30854,30855,1,6,5
30855,30855,30856,6,6,0
30856,30856,30857,6,6,0
30857,30857,30858,6,5,-1
30858,30858,30859,5,3,-2
30859,30859,30860,3,2,-1
30860,30860,30861,2,4,2
30861,30861,30862,4,8,4
30862,30862,30863,8,4,-4
30863,30863,30864,4,5,1
30864,30864,30865,5,2,-3
30865,30865,30866,2,1,-1
30866,30866,30867,1,8,7
30867,30867,30868,8,4,-4
30868,30868,30869,4,1,-3
30869,30869,30870,1,8,7
30870,30870,30871,8,0,-8
30871,30871,30872,0,2,2
30872,30872,30873,2,6,4
30873,30873,30874,6,8,2
30874,30874,30875,8,4,-4
30875,30875,30876,4,4,0
30876,30876,30877,4,9,5
30877,30877,30878,9,6,-3
30878,30878,30879,6,7,1
30879,30879,30880,7,2,-5
30880,30880,30881,2,2,0
30881,30881,30882,2,6,4
30882,30882,30883,6,3,-3
30883,30883,30884,3,2,-1
30884,30884,30885,2,3,1
30885,30885,30886,3,4,1
30886,30886,30887,4,9,5
30887,30887,30888,9,4,-5
30888,30888,30889,4,2,-2
30889,30889,30890,2,4,2
30890,30890,30891,4,0,-4
30891,30891,30892,0,8,8
30892,30892,30893,8,9,1
30893,30893,30894,9,1,-8
30894,30894,30895,1,3,2
30895,30895,30896,3,5,2
30896,30896,30897,5,3,-2
30897,30897,30898,3,1,-2
30898,30898,30899,1,9,8
30899,30899,30900,9,5,-4
30900,30900,30901,5,1,-4
30901,30901,30902,1,7,6
30902,30902,30903,7,5,-2
30903,30903,30904,5,6,1
30904,30904,30905,6,2,-4
30905,30905,30906,2,1,-1
30906,30906,30907,1,3,2
30907,30907,30908,3,4,1
30908,30908,30909,4,1,-3
30909,30909,30910,1,9,8
30910,30910,30911,9,6,-3
30911,30911,30912,6,7,1
30912,30912,30913,7,7,0
30913,30913,30914,7,8,1
30914,30914,30915,8,3,-5
30915,30915,30916,3,6,3
30916,30916,30917,6,7,1
30917,30917,30918,7,5,-2
30918,30918,30919,5,8,3
30919,30919,30920,8,1,-7
30920,30920,30921,1,4,3
30921,30921,30922,4,9,5
30922,30922,30923,9,0,-9
30923,30923,30924,0,7,7
30924,30924,30925,7,2,-5
30925,30925,30926,2,0,-2
30926,30926,30927,0,4,4
30927,30927,30928,4,5,1
30928,30928,30929,5,0,-5
30929,30929,30930,0,6,6
30930,30930,30931,6,2,-4
30931,30931,30932,2,0,-2
30932,30932,30933,0,4,4
30933,30933,30934,4,3,-1
30934,30934,30935,3,7,4
30935,30935,30936,7,7,0
30936,30936,30937,7,8,1
30937,30937,30938,8,1,-7
30938,30938,30939,1,0,-1
30939,30939,30940,0,1,1
30940,30940,30941,1,7,6
30941,30941,30942,7,9,2
30942,30942,30943,9,0,-9
30943,30943,30944,0,9,9
30944,30944,30945,9,6,-3
30945,30945,30946,6,7,1
30946,30946,30947,7,9,2
30947,30947,30948,9,0,-9
30948,30948,30949,0,3,3
30949,30949,30950,3,6,3
30950,30950,30951,6,2,-4
30951,30951,30952,2,7,5
30952,30952,30953,7,4,-3
30953,30953,30954,4,4,0
30954,30954,30955,4,0,-4
30955,30955,30956,0,6,6
30956,30956,30957,6,5,-1
30957,30957,30958,5,1,-4
30958,30958,30959,1,7,6
30959,30959,30960,7,3,-4
30960,30960,30961,3,5,2
30961,30961,30962,5,3,-2
30962,30962,30963,3,1,-2
30963,30963,30964,1,8,7
30964,30964,30965,8,0,-8
30965,30965,30966,0,1,1
30966,30966,30967,1,8,7
30967,30967,30968,8,6,-2
30968,30968,30969,6,1,-5
30969,30969,30970,1,2,1
30970,30970,30971,2,6,4
30971,30971,30972,6,2,-4
30972,30972,30973,2,7,5
30973,30973,30974,7,3,-4
30974,30974,30975,3,2,-1
30975,30975,30976,2,2,0
30976,30976,30977,2,9,7
30977,30977,30978,9,1,-8
30978,30978,30979,1,7,6
30979,30979,30980,7,5,-2
30980,30980,30981,5,9,4
30981,30981,30982,9,7,-2
30982,30982,30983,7,5,-2
30983,30983,30984,5,3,-2
30984,30984,30985,3,8,5
30985,30985,30986,8,3,-5
30986,30986,30987,3,9,6
30987,30987,30988,9,7,-2
30988,30988,30989,7,6,-1
30989,30989,30990,6,7,1
30990,30990,30991,7,5,-2
30991,30991,30992,5,0,-5
30992,30992,30993,0,2,2
30993,30993,30994,2,8,6
30994,30994,30995,8,6,-2
30995,30995,30996,6,1,-5
30996,30996,30997,1,2,1
30997,30997,30998,2,7,5
30998,30998,30999,7,8,1
30999,30999,31000,8,6,-2
31000,31000,31001,6,1,-5
31001,31001,31002,1,2,1
31002,31002,31003,2,7,5
31003,31003,31004,7,9,2
31004,31004,31005,9,5,-4
31005,31005,31006,5,4,-1
31006,31006,31007,4,5,1
31007,31007,31008,5,5,0
31008,31008,31009,5,7,2
31009,31009,31010,7,5,-2
31010,31010,31011,5,3,-2
31011,31011,31012,3,1,-2
31012,31012,31013,1,5,4
31013,31013,31014,5,8,3
31014,31014,31015,8,0,-8
31015,31015,31016,0,2,2
31016,31016,31017,2,1,-1
31017,31017,31018,1,9,8
31018,31018,31019,9,1,-8
31019,31019,31020,1,0,-1
31020,31020,31021,0,3,3
31021,31021,31022,3,5,2
31022,31022,31023,5,8,3
31023,31023,31024,8,2,-6
31024,31024,31025,2,4,2
31025,31025,31026,4,0,-4
31026,31026,31027,0,9,9
31027,31027,31028,9,5,-4
31028,31028,31029,5,4,-1
31029,31029,31030,4,8,4
31030,31030,31031,8,5,-3
31031,31031,31032,5,3,-2
31032,31032,31033,3,1,-2
31033,31033,31034,1,8,7
31034,31034,31035,8,8,0
31035,31035,31036,8,4,-4
31036,31036,31037,4,6,2
31037,31037,31038,6,1,-5
31038,31038,31039,1,8,7
31039,31039,31040,8,6,-2
31040,31040,31041,6,9,3
31041,31041,31042,9,3,-6
31042,31042,31043,3,0,-3
31043,31043,31044,0,3,3
31044,31044,31045,3,1,-2
31045,31045,31046,1,6,5
31046,31046,31047,6,2,-4
31047,31047,31048,2,1,-1
31048,31048,31049,1,3,2
31049,31049,31050,3,4,1
31050,31050,31051,4,4,0
31051,31051,31052,4,4,0
31052,31052,31053,4,5,1
31053,31053,31054,5,6,1
31054,31054,31055,6,7,1
31055,31055,31056,7,2,-5
31056,31056,31057,2,9,7
31057,31057,31058,9,1,-8
31058,31058,31059,1,0,-1
31059,31059,31060,0,8,8
31060,31060,31061,8,1,-7
31061,31061,31062,1,7,6
31062,31062,31063,7,2,-5
31063,31063,31064,2,7,5
31064,31064,31065,7,3,-4
31065,31065,31066,3,7,4
31066,31066,31067,7,4,-3
31067,31067,31068,4,2,-2
31068,31068,31069,2,5,3
31069,31069,31070,5,2,-3
31070,31070,31071,2,6,4
31071,31071,31072,6,9,3
31072,31072,31073,9,7,-2
31073,31073,31074,7,9,2
31074,31074,31075,9,8,-1
31075,31075,31076,8,7,-1
31076,31076,31077,7,9,2
31077,31077,31078,9,5,-4
31078,31078,31079,5,0,-5
31079,31079,31080,0,8,8
31080,31080,31081,8,1,-7
31081,31081,31082,1,0,-1
31082,31082,31083,0,4,4
31083,31083,31084,4,1,-3
31084,31084,31085,1,7,6
31085,31085,31086,7,5,-2
31086,31086,31087,5,8,3
31087,31087,31088,8,9,1
31088,31088,31089,9,9,0
31089,31089,31090,9,4,-5
31090,31090,31091,4,8,4
31091,31091,31092,8,2,-6
31092,31092,31093,2,1,-1
31093,31093,31094,1,9,8
31094,31094,31095,9,0,-9
31095,31095,31096,0,2,2
31096,31096,31097,2,9,7
31097,31097,31098,9,3,-6
31098,31098,31099,3,5,2
31099,31099,31100,5,7,2
31100,31100,31101,7,7,0
31101,31101,31102,7,4,-3
31102,31102,31103,4,8,4
31103,31103,31104,8,6,-2
31104,31104,31105,6,6,0
31105,31105,31106,6,4,-2
31106,31106,31107,4,9,5
31107,31107,31108,9,3,-6
31108,31108,31109,3,0,-3
31109,31109,31110,0,6,6
31110,31110,31111,6,4,-2
31111,31111,31112,4,0,-4
31112,31112,31113,0,1,1
31113,31113,31114,1,4,3
31114,31114,31115,4,9,5
31115,31115,31116,9,0,-9
31116,31116,31117,0,3,3
31117,31117,31118,3,6,3
31118,31118,31119,6,8,2
31119,31119,31120,8,9,1
31120,31120,31121,9,4,-5
31121,31121,31122,4,1,-3
31122,31122,31123,1,4,3
31123,31123,31124,4,8,4
31124,31124,31125,8,7,-1
31125,31125,31126,7,4,-3
31126,31126,31127,4,0,-4
31127,31127,31128,0,9,9
31128,31128,31129,9,1,-8
31129,31129,31130,1,9,8
31130,31130,31131,9,9,0
31131,31131,31132,9,9,0
31132,31132,31133,9,2,-7
31133,31133,31134,2,1,-1
31134,31134,31135,1,8,7
31135,31135,31136,8,3,-5
31136,31136,31137,3,7,4
31137,31137,31138,7,0,-7
31138,31138,31139,0,8,8
31139,31139,31140,8,3,-5
31140,31140,31141,3,9,6
31141,31141,31142,9,9,0
31142,31142,31143,9,6,-3
31143,31143,31144,6,1,-5
31144,31144,31145,1,0,-1
31145,31145,31146,0,2,2
31146,31146,31147,2,6,4
31147,31147,31148,6,2,-4
31148,31148,31149,2,5,3
31149,31149,31150,5,2,-3
31150,31150,31151,2,5,3
31151,31151,31152,5,6,1
31152,31152,31153,6,3,-3
31153,31153,31154,3,0,-3
31154,31154,31155,0,3,3
31155,31155,31156,3,7,4
31156,31156,31157,7,3,-4
31157,31157,31158,3,5,2
31158,31158,31159,5,4,-1
31159,31159,31160,4,7,3
31160,31160,31161,7,9,2
31161,31161,31162,9,8,-1
31162,31162,31163,8,4,-4
31163,31163,31164,4,4,0
31164,31164,31165,4,0,-4
31165,31165,31166,0,1,1
31166,31166,31167,1,6,5
31167,31167,31168,6,8,2
31168,31168,31169,8,1,-7
31169,31169,31170,1,9,8
31170,31170,31171,9,0,-9
31171,31171,31172,0,0,0
31172,31172,31173,0,0,0
31173,31173,31174,0,1,1
31174,31174,31175,1,6,5
31175,31175,31176,6,7,1
31176,31176,31177,7,2,-5
31177,31177,31178,2,3,1
31178,31178,31179,3,1,-2
31179,31179,31180,1,0,-1
31180,31180,31181,0,1,1
31181,31181,31182,1,8,7
31182,31182,31183,8,3,-5
31183,31183,31184,3,9,6
31184,31184,31185,9,2,-7
31185,31185,31186,2,5,3
31186,31186,31187,5,7,2
31187,31187,31188,7,2,-5
31188,31188,31189,2,7,5
31189,31189,31190,7,5,-2
31190,31190,31191,5,8,3
31191,31191,31192,8,7,-1
31192,31192,31193,7,6,-1
31193,31193,31194,6,0,-6
31194,31194,31195,0,0,0
31195,31195,31196,0,7,7
31196,31196,31197,7,2,-5
31197,31197,31198,2,1,-1
31198,31198,31199,1,0,-1
31199,31199,31200,0,9,9
31200,31200,31201,9,3,-6
31201,31201,31202,3,0,-3
31202,31202,31203,0,6,6
31203,31203,31204,6,6,0
31204,31204,31205,6,8,2
31205,31205,31206,8,8,0
31206,31206,31207,8,7,-1
31207,31207,31208,7,6,-1
31208,31208,31209,6,1,-5
31209,31209,31210,1,7,6
31210,31210,31211,7,5,-2
31211,31211,31212,5,6,1
31212,31212,31213,6,9,3
31213,31213,31214,9,5,-4
31214,31214,31215,5,9,4
31215,31215,31216,9,2,-7
31216,31216,31217,2,3,1
31217,31217,31218,3,9,6
31218,31218,31219,9,7,-2
31219,31219,31220,7,6,-1
31220,31220,31221,6,2,-4
31221,31221,31222,2,5,3
31222,31222,31223,5,4,-1
31223,31223,31224,4,4,0
31224,31224,31225,4,9,5
31225,31225,31226,9,9,0
31226,31226,31227,9,4,-5
31227,31227,31228,4,6,2
31228,31228,31229,6,3,-3
31229,31229,31230,3,5,2
31230,31230,31231,5,6,1
31231,31231,31232,6,6,0
31232,31232,31233,6,2,-4
31233,31233,31234,2,0,-2
31234,31234,31235,0,4,4
31235,31235,31236,4,8,4
31236,31236,31237,8,1,-7
31237,31237,31238,1,1,0
31238,31238,31239,1,7,6
31239,31239,31240,7,2,-5
31240,31240,31241,2,2,0
31241,31241,31242,2,5,3
31242,31242,31243,5,0,-5
31243,31243,31244,0,9,9
31244,31244,31245,9,1,-8
31245,31245,31246,1,4,3
31246,31246,31247,4,2,-2
31247,31247,31248,2,8,6
31248,31248,31249,8,3,-5
31249,31249,31250,3,1,-2
31250,31250,31251,1,4,3
31251,31251,31252,4,5,1
31252,31252,31253,5,5,0
31253,31253,31254,5,3,-2
31254,31254,31255,3,6,3
31255,31255,31256,6,9,3
31256,31256,31257,9,7,-2
31257,31257,31258,7,2,-5
31258,31258,31259,2,8,6
31259,31259,31260,8,8,0
31260,31260,31261,8,9,1
31261,31261,31262,9,9,0
31262,31262,31263,9,0,-9
31263,31263,31264,0,1,1
31264,31264,31265,1,1,0
31265,31265,31266,1,5,4
31266,31266,31267,5,2,-3
31267,31267,31268,2,6,4
31268,31268,31269,6,3,-3
31269,31269,31270,3,6,3
31270,31270,31271,6,7,1
31271,31271,31272,7,0,-7
31272,31272,31273,0,8,8
31273,31273,31274,8,3,-5
31274,31274,31275,3,9,6
31275,31275,31276,9,2,-7
31276,31276,31277,2,0,-2
31277,31277,31278,0,1,1
31278,31278,31279,1,1,0
31279,31279,31280,1,1,0
31280,31280,31281,1,2,1
31281,31281,31282,2,1,-1
31282,31282,31283,1,3,2
31283,31283,31284,3,7,4
31284,31284,31285,7,4,-3
31285,31285,31286,4,1,-3
31286,31286,31287,1,5,4
31287,31287,31288,5,0,-5
31288,31288,31289,0,6,6
31289,31289,31290,6,5,-1
31290,31290,31291,5,7,2
31291,31291,31292,7,8,1
31292,31292,31293,8,8,0
31293,31293,31294,8,6,-2
31294,31294,31295,6,9,3
31295,31295,31296,9,1,-8
31296,31296,31297,1,0,-1
31297,31297,31298,0,8,8
31298,31298,31299,8,9,1
31299,31299,31300,9,7,-2
31300,31300,31301,7,5,-2
31301,31301,31302,5,5,0
31302,31302,31303,5,6,1
31303,31303,31304,6,2,-4
31304,31304,31305,2,4,2
31305,31305,31306,4,8,4
31306,31306,31307,8,1,-7
31307,31307,31308,1,8,7
31308,31308,31309,8,9,1
31309,31309,31310,9,0,-9
31310,31310,31311,0,3,3
31311,31311,31312,3,9,6
31312,31312,31313,9,8,-1
31313,31313,31314,8,0,-8
31314,31314,31315,0,4,4
31315,31315,31316,4,5,1
31316,31316,31317,5,4,-1
31317,31317,31318,4,1,-3
31318,31318,31319,1,7,6
31319,31319,31320,7,9,2
31320,31320,31321,9,0,-9
31321,31321,31322,0,4,4
31322,31322,31323,4,1,-3
31323,31323,31324,1,4,3
31324,31324,31325,4,9,5
31325,31325,31326,9,9,0
31326,31326,31327,9,2,-7
31327,31327,31328,2,5,3
31328,31328,31329,5,8,3
31329,31329,31330,8,7,-1
31330,31330,31331,7,7,0
31331,31331,31332,7,1,-6
31332,31332,31333,1,8,7
31333,31333,31334,8,8,0
31334,31334,31335,8,5,-3
31335,31335,31336,5,9,4
31336,31336,31337,9,9,0
31337,31337,31338,9,2,-7
31338,31338,31339,2,6,4
31339,31339,31340,6,4,-2
31340,31340,31341,4,0,-4
31341,31341,31342,0,6,6
31342,31342,31343,6,6,0
31343,31343,31344,6,5,-1
31344,31344,31345,5,3,-2
31345,31345,31346,3,5,2
31346,31346,31347,5,3,-2
31347,31347,31348,3,1,-2
31348,31348,31349,1,3,2
31349,31349,31350,3,0,-3
31350,31350,31351,0,9,9
31351,31351,31352,9,5,-4
31352,31352,31353,5,9,4
31353,31353,31354,9,2,-7
31354,31354,31355,2,8,6
31355,31355,31356,8,0,-8
31356,31356,31357,0,1,1
31357,31357,31358,1,9,8
31358,31358,31359,9,4,-5
31359,31359,31360,4,2,-2
31360,31360,31361,2,0,-2
31361,31361,31362,0,7,7
31362,31362,31363,7,6,-1
31363,31363,31364,6,9,3
31364,31364,31365,9,1,-8
31365,31365,31366,1,1,0
31366,31366,31367,1,0,-1
31367,31367,31368,0,6,6
31368,31368,31369,6,0,-6
31369,31369,31370,0,1,1
31370,31370,31371,1,6,5
31371,31371,31372,6,2,-4
31372,31372,31373,2,2,0
31373,31373,31374,2,7,5
31374,31374,31375,7,1,-6
31375,31375,31376,1,9,8
31376,31376,31377,9,1,-8
31377,31377,31378,1,4,3
31378,31378,31379,4,3,-1
31379,31379,31380,3,8,5
31380,31380,31381,8,2,-6
31381,31381,31382,2,7,5
31382,31382,31383,7,7,0
31383,31383,31384,7,1,-6
31384,31384,31385,1,7,6
31385,31385,31386,7,1,-6
31386,31386,31387,1,7,6
31387,31387,31388,7,2,-5
31388,31388,31389,2,0,-2
31389,31389,31390,0,8,8
31390,31390,31391,8,7,-1
31391,31391,31392,7,0,-7
31392,31392,31393,0,0,0
31393,31393,31394,0,9,9
31394,31394,31395,9,3,-6
31395,31395,31396,3,7,4
31396,31396,31397,7,6,-1
31397,31397,31398,6,7,1
31398,31398,31399,7,8,1
31399,31399,31400,8,9,1
31400,31400,31401,9,2,-7
31401,31401,31402,2,5,3
31402,31402,31403,5,4,-1
31403,31403,31404,4,3,-1
31404,31404,31405,3,9,6
31405,31405,31406,9,1,-8
31406,31406,31407,1,4,3
31407,31407,31408,4,7,3
31408,31408,31409,7,3,-4
31409,31409,31410,3,0,-3
31410,31410,31411,0,6,6
31411,31411,31412,6,4,-2
31412,31412,31413,4,5,1
31413,31413,31414,5,8,3
31414,31414,31415,8,5,-3
31415,31415,31416,5,4,-1
31416,31416,31417,4,9,5
31417,31417,31418,9,5,-4
31418,31418,31419,5,4,-1
31419,31419,31420,4,1,-3
31420,31420,31421,1,1,0
31421,31421,31422,1,2,1
31422,31422,31423,2,7,5
31423,31423,31424,7,5,-2
31424,31424,31425,5,0,-5
31425,31425,31426,0,9,9
31426,31426,31427,9,1,-8
31427,31427,31428,1,3,2
31428,31428,31429,3,2,-1
31429,31429,31430,2,0,-2
31430,31430,31431,0,3,3
31431,31431,31432,3,1,-2
31432,31432,31433,1,4,3
31433,31433,31434,4,5,1
31434,31434,31435,5,5,0
31435,31435,31436,5,4,-1
31436,31436,31437,4,6,2
31437,31437,31438,6,4,-2
31438,31438,31439,4,7,3
31439,31439,31440,7,8,1
31440,31440,31441,8,8,0
31441,31441,31442,8,5,-3
31442,31442,31443,5,9,4
31443,31443,31444,9,8,-1
31444,31444,31445,8,0,-8
31445,31445,31446,0,3,3
31446,31446,31447,3,1,-2
31447,31447,31448,1,4,3
31448,31448,31449,4,2,-2
31449,31449,31450,2,3,1
31450,31450,31451,3,3,0
31451,31451,31452,3,3,0
31452,31452,31453,3,4,1
31453,31453,31454,4,2,-2
31454,31454,31455,2,5,3
31455,31455,31456,5,9,4
31456,31456,31457,9,6,-3
31457,31457,31458,6,4,-2
31458,31458,31459,4,7,3
31459,31459,31460,7,7,0
31460,31460,31461,7,8,1
31461,31461,31462,8,2,-6
31462,31462,31463,2,0,-2
31463,31463,31464,0,6,6
31464,31464,31465,6,1,-5
31465,31465,31466,1,0,-1
31466,31466,31467,0,2,2
31467,31467,31468,2,8,6
31468,31468,31469,8,3,-5
31469,31469,31470,3,0,-3
31470,31470,31471,0,4,4
31471,31471,31472,4,5,1
31472,31472,31473,5,5,0
31473,31473,31474,5,8,3
31474,31474,31475,8,6,-2
31475,31475,31476,6,0,-6
31476,31476,31477,0,7,7
31477,31477,31478,7,1,-6
31478,31478,31479,1,8,7
31479,31479,31480,8,9,1
31480,31480,31481,9,6,-3
31481,31481,31482,6,3,-3
31482,31482,31483,3,2,-1
31483,31483,31484,2,4,2
31484,31484,31485,4,7,3
31485,31485,31486,7,8,1
31486,31486,31487,8,1,-7
31487,31487,31488,1,3,2
31488,31488,31489,3,5,2
31489,31489,31490,5,0,-5
31490,31490,31491,0,6,6
31491,31491,31492,6,2,-4
31492,31492,31493,2,2,0
31493,31493,31494,2,1,-1
31494,31494,31495,1,5,4
31495,31495,31496,5,5,0
31496,31496,31497,5,0,-5
31497,31497,31498,0,1,1
31498,31498,31499,1,5,4
31499,31499,31500,5,6,1
31500,31500,31501,6,4,-2
31501,31501,31502,4,0,-4
31502,31502,31503,0,2,2
31503,31503,31504,2,3,1
31504,31504,31505,3,0,-3
31505,31505,31506,0,2,2
31506,31506,31507,2,8,6
31507,31507,31508,8,2,-6
31508,31508,31509,2,0,-2
31509,31509,31510,0,7,7
31510,31510,31511,7,1,-6
31511,31511,31512,1,2,1
31512,31512,31513,2,2,0
31513,31513,31514,2,4,2
31514,31514,31515,4,3,-1
31515,31515,31516,3,6,3
31516,31516,31517,6,4,-2
31517,31517,31518,4,0,-4
31518,31518,31519,0,5,5
31519,31519,31520,5,5,0
31520,31520,31521,5,6,1
31521,31521,31522,6,4,-2
31522,31522,31523,4,7,3
31523,31523,31524,7,9,2
31524,31524,31525,9,8,-1
31525,31525,31526,8,1,-7
31526,31526,31527,1,7,6
31527,31527,31528,7,8,1
31528,31528,31529,8,1,-7
31529,31529,31530,1,8,7
31530,31530,31531,8,7,-1
31531,31531,31532,7,9,2
31532,31532,31533,9,7,-2
31533,31533,31534,7,1,-6
31534,31534,31535,1,0,-1
31535,31535,31536,0,4,4
31536,31536,31537,4,1,-3
31537,31537,31538,1,3,2
31538,31538,31539,3,4,1
31539,31539,31540,4,8,4
31540,31540,31541,8,4,-4
31541,31541,31542,4,7,3
31542,31542,31543,7,4,-3
31543,31543,31544,4,3,-1
31544,31544,31545,3,5,2
31545,31545,31546,5,2,-3
31546,31546,31547,2,7,5
31547,31547,31548,7,3,-4
31548,31548,31549,3,4,1
31549,31549,31550,4,7,3
31550,31550,31551,7,9,2
31551,31551,31552,9,4,-5
31552,31552,31553,4,7,3
31553,31553,31554,7,5,-2
31554,31554,31555,5,2,-3
31555,31555,31556,2,1,-1
31556,31556,31557,1,6,5
31557,31557,31558,6,7,1
31558,31558,31559,7,3,-4
31559,31559,31560,3,7,4
31560,31560,31561,7,9,2
31561,31561,31562,9,3,-6
31562,31562,31563,3,4,1
31563,31563,31564,4,3,-1
31564,31564,31565,3,9,6
31565,31565,31566,9,9,0
31566,31566,31567,9,0,-9
31567,31567,31568,0,6,6
31568,31568,31569,6,8,2
31569,31569,31570,8,1,-7
31570,31570,31571,1,7,6
31571,31571,31572,7,6,-1
31572,31572,31573,6,9,3
31573,31573,31574,9,4,-5
31574,31574,31575,4,0,-4
31575,31575,31576,0,7,7
31576,31576,31577,7,6,-1
31577,31577,31578,6,1,-5
31578,31578,31579,1,3,2
31579,31579,31580,3,4,1
31580,31580,31581,4,0,-4
31581,31581,31582,0,3,3
31582,31582,31583,3,4,1
31583,31583,31584,4,5,1
31584,31584,31585,5,6,1
31585,31585,31586,6,6,0
31586,31586,31587,6,3,-3
31587,31587,31588,3,6,3
31588,31588,31589,6,7,1
31589,31589,31590,7,5,-2
31590,31590,31591,5,8,3
31591,31591,31592,8,1,-7
31592,31592,31593,1,9,8
31593,31593,31594,9,7,-2
31594,31594,31595,7,3,-4
31595,31595,31596,3,3,0
31596,31596,31597,3,1,-2
31597,31597,31598,1,4,3
31598,31598,31599,4,8,4
31599,31599,31600,8,8,0
31600,31600,31601,8,4,-4
31601,31601,31602,4,3,-1
31602,31602,31603,3,2,-1
31603,31603,31604,2,0,-2
31604,31604,31605,0,9,9
31605,31605,31606,9,6,-3
31606,31606,31607,6,8,2
31607,31607,31608,8,2,-6
31608,31608,31609,2,2,0
31609,31609,31610,2,3,1
31610,31610,31611,3,8,5
31611,31611,31612,8,6,-2
31612,31612,31613,6,6,0
31613,31613,31614,6,7,1
31614,31614,31615,7,5,-2
31615,31615,31616,5,2,-3
31616,31616,31617,2,2,0
31617,31617,31618,2,5,3
31618,31618,31619,5,6,1
31619,31619,31620,6,6,0
31620,31620,31621,6,9,3
31621,31621,31622,9,8,-1
31622,31622,31623,8,6,-2
31623,31623,31624,6,9,3
31624,31624,31625,9,0,-9
31625,31625,31626,0,6,6
31626,31626,31627,6,3,-3
31627,31627,31628,3,0,-3
31628,31628,31629,0,6,6
31629,31629,31630,6,8,2
31630,31630,31631,8,3,-5
31631,31631,31632,3,4,1
31632,31632,31633,4,1,-3
31633,31633,31634,1,2,1
31634,31634,31635,2,2,0
31635,31635,31636,2,3,1
31636,31636,31637,3,5,2
31637,31637,31638,5,2,-3
31638,31638,31639,2,0,-2
31639,31639,31640,0,1,1
31640,31640,31641,1,3,2
31641,31641,31642,3,1,-2
31642,31642,31643,1,7,6
31643,31643,31644,7,5,-2
31644,31644,31645,5,6,1
31645,31645,31646,6,6,0
31646,31646,31647,6,1,-5
31647,31647,31648,1,7,6
31648,31648,31649,7,5,-2
31649,31649,31650,5,5,0
31650,31650,31651,5,5,0
31651,31651,31652,5,9,4
31652,31652,31653,9,9,0
31653,31653,31654,9,6,-3
31654,31654,31655,6,8,2
31655,31655,31656,8,8,0
31656,31656,31657,8,0,-8
31657,31657,31658,0,2,2
31658,31658,31659,2,9,7
31659,31659,31660,9,4,-5
31660,31660,31661,4,0,-4
31661,31661,31662,0,2,2
31662,31662,31663,2,1,-1
31663,31663,31664,1,3,2
31664,31664,31665,3,2,-1
31665,31665,31666,2,2,0
31666,31666,31667,2,3,1
31667,31667,31668,3,4,1
31668,31668,31669,4,4,0
31669,31669,31670,4,6,2
31670,31670,31671,6,7,1
31671,31671,31672,7,6,-1
31672,31672,31673,6,8,2
31673,31673,31674,8,7,-1
31674,31674,31675,7,9,2
31675,31675,31676,9,9,0
31676,31676,31677,9,0,-9
31677,31677,31678,0,7,7
31678,31678,31679,7,1,-6
31679,31679,31680,1,3,2
31680,31680,31681,3,2,-1
31681,31681,31682,2,5,3
31682,31682,31683,5,0,-5
31683,31683,31684,0,7,7
31684,31684,31685,7,1,-6
31685,31685,31686,1,6,5
31686,31686,31687,6,5,-1
31687,31687,31688,5,2,-3
31688,31688,31689,2,1,-1
31689,31689,31690,1,7,6
31690,31690,31691,7,3,-4
31691,31691,31692,3,4,1
31692,31692,31693,4,9,5
31693,31693,31694,9,5,-4
31694,31694,31695,5,0,-5
31695,31695,31696,0,2,2
31696,31696,31697,2,9,7
31697,31697,31698,9,7,-2
31698,31698,31699,7,7,0
31699,31699,31700,7,9,2
31700,31700,31701,9,1,-8
31701,31701,31702,1,5,4
31702,31702,31703,5,3,-2
31703,31703,31704,3,8,5
31704,31704,31705,8,6,-2
31705,31705,31706,6,8,2
31706,31706,31707,8,9,1
31707,31707,31708,9,6,-3
31708,31708,31709,6,2,-4
31709,31709,31710,2,8,6
31710,31710,31711,8,4,-4
31711,31711,31712,4,7,3
31712,31712,31713,7,7,0
31713,31713,31714,7,6,-1
31714,31714,31715,6,7,1
31715,31715,31716,7,0,-7
31716,31716,31717,0,4,4
31717,31717,31718,4,1,-3
31718,31718,31719,1,3,2
31719,31719,31720,3,3,0
31720,31720,31721,3,8,5
31721,31721,31722,8,3,-5
31722,31722,31723,3,3,0
31723,31723,31724,3,3,0
31724,31724,31725,3,7,4
31725,31725,31726,7,8,1
31726,31726,31727,8,1,-7
31727,31727,31728,1,4,3
31728,31728,31729,4,1,-3
31729,31729,31730,1,7,6
31730,31730,31731,7,7,0
31731,31731,31732,7,8,1
31732,31732,31733,8,9,1
31733,31733,31734,9,5,-4
31734,31734,31735,5,3,-2
31735,31735,31736,3,6,3
31736,31736,31737,6,9,3
31737,31737,31738,9,8,-1
31738,31738,31739,8,1,-7
31739,31739,31740,1,2,1
31740,31740,31741,2,6,4
31741,31741,31742,6,7,1
31742,31742,31743,7,4,-3
31743,31743,31744,4,9,5
31744,31744,31745,9,3,-6
31745,31745,31746,3,5,2
31746,31746,31747,5,9,4
31747,31747,31748,9,3,-6
31748,31748,31749,3,8,5
31749,31749,31750,8,4,-4
31750,31750,31751,4,1,-3
31751,31751,31752,1,6,5
31752,31752,31753,6,0,-6
31753,31753,31754,0,6,6
31754,31754,31755,6,1,-5
31755,31755,31756,1,5,4
31756,31756,31757,5,2,-3
31757,31757,31758,2,8,6
31758,31758,31759,8,3,-5
31759,31759,31760,3,8,5
31760,31760,31761,8,4,-4
31761,31761,31762,4,1,-3
31762,31762,31763,1,5,4
31763,31763,31764,5,1,-4
31764,31764,31765,1,8,7
31765,31765,31766,8,1,-7
31766,31766,31767,1,9,8
31767,31767,31768,9,5,-4
31768,31768,31769,5,0,-5
31769,31769,31770,0,8,8
31770,31770,31771,8,1,-7
31771,31771,31772,1,5,4
31772,31772,31773,5,2,-3
31773,31773,31774,2,4,2
31774,31774,31775,4,3,-1
31775,31775,31776,3,4,1
31776,31776,31777,4,4,0
31777,31777,31778,4,0,-4
31778,31778,31779,0,5,5
31779,31779,31780,5,1,-4
31780,31780,31781,1,8,7
31781,31781,31782,8,5,-3
31782,31782,31783,5,9,4
31783,31783,31784,9,1,-8
31784,31784,31785,1,0,-1
31785,31785,31786,0,9,9
31786,31786,31787,9,1,-8
31787,31787,31788,1,3,2
31788,31788,31789,3,2,-1
31789,31789,31790,2,4,2
31790,31790,31791,4,3,-1
31791,31791,31792,3,7,4
31792,31792,31793,7,4,-3
31793,31793,31794,4,2,-2
31794,31794,31795,2,5,3
31795,31795,31796,5,7,2
31796,31796,31797,7,6,-1
31797,31797,31798,6,9,3
31798,31798,31799,9,7,-2
31799,31799,31800,7,8,1
31800,31800,31801,8,8,0
31801,31801,31802,8,2,-6
31802,31802,31803,2,9,7
31803,31803,31804,9,7,-2
31804,31804,31805,7,3,-4
31805,31805,31806,3,6,3
31806,31806,31807,6,2,-4
31807,31807,31808,2,0,-2
31808,31808,31809,0,9,9
31809,31809,31810,9,8,-1
31810,31810,31811,8,3,-5
31811,31811,31812,3,7,4
31812,31812,31813,7,2,-5
31813,31813,31814,2,4,2
31814,31814,31815,4,1,-3
31815,31815,31816,1,8,7
31816,31816,31817,8,4,-4
31817,31817,31818,4,9,5
31818,31818,31819,9,5,-4
31819,31819,31820,5,5,0
31820,31820,31821,5,5,0
31821,31821,31822,5,9,4
31822,31822,31823,9,2,-7
31823,31823,31824,2,7,5
31824,31824,31825,7,3,-4
31825,31825,31826,3,7,4
31826,31826,31827,7,2,-5
31827,31827,31828,2,9,7
31828,31828,31829,9,1,-8
31829,31829,31830,1,0,-1
31830,31830,31831,0,3,3
31831,31831,31832,3,8,5
31832,31832,31833,8,9,1
31833,31833,31834,9,9,0
31834,31834,31835,9,7,-2
31835,31835,31836,7,0,-7
31836,31836,31837,0,2,2
31837,31837,31838,2,5,3
31838,31838,31839,5,1,-4
31839,31839,31840,1,9,8
31840,31840,31841,9,9,0
31841,31841,31842,9,9,0
31842,31842,31843,9,1,-8
31843,31843,31844,1,7,6
31844,31844,31845,7,8,1
31845,31845,31846,8,1,-7
31846,31846,31847,1,8,7
31847,31847,31848,8,1,-7
31848,31848,31849,1,7,6
31849,31849,31850,7,7,0
31850,31850,31851,7,8,1
31851,31851,31852,8,2,-6
31852,31852,31853,2,1,-1
31853,31853,31854,1,9,8
31854,31854,31855,9,0,-9
31855,31855,31856,0,6,6
31856,31856,31857,6,0,-6
31857,31857,31858,0,4,4
31858,31858,31859,4,6,2
31859,31859,31860,6,4,-2
31860,31860,31861,4,7,3
31861,31861,31862,7,1,-6
31862,31862,31863,1,5,4
31863,31863,31864,5,1,-4
31864,31864,31865,1,0,-1
31865,31865,31866,0,9,9
31866,31866,31867,9,6,-3
31867,31867,31868,6,3,-3
31868,31868,31869,3,1,-2
31869,31869,31870,1,1,0
31870,31870,31871,1,1,0
31871,31871,31872,1,4,3
31872,31872,31873,4,2,-2
31873,31873,31874,2,2,0
31874,31874,31875,2,5,3
31875,31875,31876,5,9,4
31876,31876,31877,9,0,-9
31877,31877,31878,0,9,9
31878,31878,31879,9,7,-2
31879,31879,31880,7,8,1
31880,31880,31881,8,8,0
31881,31881,31882,8,7,-1
31882,31882,31883,7,4,-3
31883,31883,31884,4,2,-2
31884,31884,31885,2,4,2
31885,31885,31886,4,5,1
31886,31886,31887,5,1,-4
31887,31887,31888,1,9,8
31888,31888,31889,9,8,-1
31889,31889,31890,8,2,-6
31890,31890,31891,2,5,3
31891,31891,31892,5,6,1
31892,31892,31893,6,9,3
31893,31893,31894,9,1,-8
31894,31894,31895,1,0,-1
31895,31895,31896,0,9,9
31896,31896,31897,9,3,-6
31897,31897,31898,3,6,3
31898,31898,31899,6,7,1
31899,31899,31900,7,5,-2
31900,31900,31901,5,1,-4
31901,31901,31902,1,7,6
31902,31902,31903,7,6,-1
31903,31903,31904,6,0,-6
31904,31904,31905,0,2,2
31905,31905,31906,2,8,6
31906,31906,31907,8,6,-2
31907,31907,31908,6,1,-5
31908,31908,31909,1,6,5
31909,31909,31910,6,7,1
31910,31910,31911,7,1,-6
31911,31911,31912,1,7,6
31912,31912,31913,7,3,-4
31913,31913,31914,3,7,4
31914,31914,31915,7,8,1
31915,31915,31916,8,1,-7
31916,31916,31917,1,9,8
31917,31917,31918,9,9,0
31918,31918,31919,9,9,0
31919,31919,31920,9,1,-8
31920,31920,31921,1,5,4
31921,31921,31922,5,9,4
31922,31922,31923,9,9,0
31923,31923,31924,9,6,-3
31924,31924,31925,6,3,-3
31925,31925,31926,3,5,2
31926,31926,31927,5,7,2
31927,31927,31928,7,2,-5
31928,31928,31929,2,5,3
31929,31929,31930,5,1,-4
31930,31930,31931,1,6,5
31931,31931,31932,6,1,-5
31932,31932,31933,1,2,1
31933,31933,31934,2,9,7
31934,31934,31935,9,2,-7
31935,31935,31936,2,3,1
31936,31936,31937,3,0,-3
31937,31937,31938,0,8,8
31938,31938,31939,8,9,1
31939,31939,31940,9,4,-5
31940,31940,31941,4,4,0
31941,31941,31942,4,9,5
31942,31942,31943,9,0,-9
31943,31943,31944,0,5,5
31944,31944,31945,5,1,-4
31945,31945,31946,1,5,4
31946,31946,31947,5,2,-3
31947,31947,31948,2,6,4
31948,31948,31949,6,3,-3
31949,31949,31950,3,1,-2
31950,31950,31951,1,4,3
31951,31951,31952,4,3,-1
31952,31952,31953,3,5,2
31953,31953,31954,5,6,1
31954,31954,31955,6,6,0
31955,31955,31956,6,2,-4
31956,31956,31957,2,7,5
31957,31957,31958,7,2,-5
31958,31958,31959,2,8,6
31959,31959,31960,8,3,-5
31960,31960,31961,3,9,6
31961,31961,31962,9,3,-6
31962,31962,31963,3,1,-2
31963,31963,31964,1,7,6
31964,31964,31965,7,4,-3
31965,31965,31966,4,1,-3
31966,31966,31967,1,7,6
31967,31967,31968,7,8,1
31968,31968,31969,8,0,-8
31969,31969,31970,0,2,2
31970,31970,31971,2,1,-1
31971,31971,31972,1,8,7
31972,31972,31973,8,2,-6
31973,31973,31974,2,6,4
31974,31974,31975,6,3,-3
31975,31975,31976,3,5,2
31976,31976,31977,5,4,-1
31977,31977,31978,4,2,-2
31978,31978,31979,2,5,3
31979,31979,31980,5,1,-4
31980,31980,31981,1,6,5
31981,31981,31982,6,5,-1
31982,31982,31983,5,7,2
31983,31983,31984,7,4,-3
31984,31984,31985,4,8,4
31985,31985,31986,8,9,1
31986,31986,31987,9,9,0
31987,31987,31988,9,3,-6
31988,31988,31989,3,3,0
31989,31989,31990,3,1,-2
31990,31990,31991,1,7,6
31991,31991,31992,7,7,0
31992,31992,31993,7,1,-6
31993,31993,31994,1,4,3
31994,31994,31995,4,0,-4
31995,31995,31996,0,7,7
31996,31996,31997,7,7,0
31997,31997,31998,7,6,-1
31998,31998,31999,6,5,-1
31999,31999,32000,5,8,3
32000,32000,32001,8,5,-3
32001,32001,32002,5,6,1
32002,32002,32003,6,6,0
32003,32003,32004,6,7,1
32004,32004,32005,7,1,-6
32005,32005,32006,1,6,5
32006,32006,32007,6,0,-6
32007,32007,32008,0,2,2
32008,32008,32009,2,0,-2
32009,32009,32010,0,2,2
32010,32010,32011,2,8,6
32011,32011,32012,8,8,0
32012,32012,32013,8,3,-5
32013,32013,32014,3,4,1
32014,32014,32015,4,4,0
32015,32015,32016,4,9,5
32016,32016,32017,9,3,-6
32017,32017,32018,3,8,5
32018,32018,32019,8,1,-7
32019,32019,32020,1,4,3
32020,32020,32021,4,9,5
32021,32021,32022,9,2,-7
32022,32022,32023,2,5,3
32023,32023,32024,5,2,-3
32024,32024,32025,2,3,1
32025,32025,32026,3,5,2
32026,32026,32027,5,4,-1
32027,32027,32028,4,7,3
32028,32028,32029,7,9,2
32029,32029,32030,9,8,-1
32030,32030,32031,8,3,-5
32031,32031,32032,3,4,1
32032,32032,32033,4,9,5
32033,32033,32034,9,1,-8
32034,32034,32035,1,2,1
32035,32035,32036,2,0,-2
32036,32036,32037,0,4,4
32037,32037,32038,4,1,-3
32038,32038,32039,1,5,4
32039,32039,32040,5,5,0
32040,32040,32041,5,1,-4
32041,32041,32042,1,3,2
32042,32042,32043,3,6,3
32043,32043,32044,6,3,-3
32044,32044,32045,3,4,1
32045,32045,32046,4,8,4
32046,32046,32047,8,9,1
32047,32047,32048,9,7,-2
32048,32048,32049,7,4,-3
32049,32049,32050,4,6,2
32050,32050,32051,6,9,3
32051,32051,32052,9,5,-4
32052,32052,32053,5,4,-1
32053,32053,32054,4,1,-3
32054,32054,32055,1,1,0
32055,32055,32056,1,4,3
32056,32056,32057,4,2,-2
32057,32057,32058,2,6,4
32058,32058,32059,6,5,-1
32059,32059,32060,5,5,0
32060,32060,32061,5,8,3
32061,32061,32062,8,0,-8
32062,32062,32063,0,1,1
32063,32063,32064,1,9,8
32064,32064,32065,9,2,-7
32065,32065,32066,2,9,7
32066,32066,32067,9,9,0
32067,32067,32068,9,9,0
32068,32068,32069,9,4,-5
32069,32069,32070,4,1,-3
32070,32070,32071,1,3,2
32071,32071,32072,3,8,5
32072,32072,32073,8,8,0
32073,32073,32074,8,5,-3
32074,32074,32075,5,2,-3
32075,32075,32076,2,8,6
32076,32076,32077,8,2,-6
32077,32077,32078,2,8,6
32078,32078,32079,8,1,-7
32079,32079,32080,1,5,4
32080,32080,32081,5,2,-3
32081,32081,32082,2,6,4
32082,32082,32083,6,1,-5
32083,32083,32084,1,4,3
32084,32084,32085,4,1,-3
32085,32085,32086,1,0,-1
32086,32086,32087,0,3,3
32087,32087,32088,3,4,1
32088,32088,32089,4,9,5
32089,32089,32090,9,5,-4
32090,32090,32091,5,3,-2
32091,32091,32092,3,0,-3
32092,32092,32093,0,8,8
32093,32093,32094,8,4,-4
32094,32094,32095,4,7,3
32095,32095,32096,7,1,-6
32096,32096,32097,1,0,-1
32097,32097,32098,0,0,0
32098,32098,32099,0,7,7
32099,32099,32100,7,9,2
32100,32100,32101,9,4,-5
32101,32101,32102,4,8,4
32102,32102,32103,8,8,0
32103,32103,32104,8,7,-1
32104,32104,32105,7,8,1
32105,32105,32106,8,3,-5
32106,32106,32107,3,5,2
32107,32107,32108,5,4,-1
32108,32108,32109,4,0,-4
32109,32109,32110,0,8,8
32110,32110,32111,8,6,-2
32111,32111,32112,6,4,-2
32112,32112,32113,4,6,2
32113,32113,32114,6,3,-3
32114,32114,32115,3,3,0
32115,32115,32116,3,8,5
32116,32116,32117,8,7,-1
32117,32117,32118,7,6,-1
32118,32118,32119,6,6,0
32119,32119,32120,6,7,1
32120,32120,32121,7,9,2
32121,32121,32122,9,7,-2
32122,32122,32123,7,9,2
32123,32123,32124,9,4,-5
32124,32124,32125,4,4,0
32125,32125,32126,4,4,0
32126,32126,32127,4,8,4
32127,32127,32128,8,9,1
32128,32128,32129,9,1,-8
32129,32129,32130,1,0,-1
32130,32130,32131,0,0,0
32131,32131,32132,0,5,5
32132,32132,32133,5,1,-4
32133,32133,32134,1,5,4
32134,32134,32135,5,2,-3
32135,32135,32136,2,5,3
32136,32136,32137,5,3,-2
32137,32137,32138,3,1,-2
32138,32138,32139,1,4,3
32139,32139,32140,4,6,2
32140,32140,32141,6,5,-1
32141,32141,32142,5,2,-3
32142,32142,32143,2,6,4
32143,32143,32144,6,0,-6
32144,32144,32145,0,7,7
32145,32145,32146,7,2,-5
32146,32146,32147,2,8,6
32147,32147,32148,8,2,-6
32148,32148,32149,2,9,7
32149,32149,32150,9,7,-2
32150,32150,32151,7,0,-7
32151,32151,32152,0,9,9
32152,32152,32153,9,1,-8
32153,32153,32154,1,5,4
32154,32154,32155,5,2,-3
32155,32155,32156,2,5,3
32156,32156,32157,5,3,-2
32157,32157,32158,3,1,-2
32158,32158,32159,1,7,6
32159,32159,32160,7,0,-7
32160,32160,32161,0,8,8
32161,32161,32162,8,0,-8
32162,32162,32163,0,9,9
32163,32163,32164,9,4,-5
32164,32164,32165,4,0,-4
32165,32165,32166,0,8,8
32166,32166,32167,8,1,-7
32167,32167,32168,1,5,4
32168,32168,32169,5,2,-3
32169,32169,32170,2,2,0
32170,32170,32171,2,3,1
32171,32171,32172,3,4,1
32172,32172,32173,4,7,3
32173,32173,32174,7,7,0
32174,32174,32175,7,8,1
32175,32175,32176,8,3,-5
32176,32176,32177,3,9,6
32177,32177,32178,9,4,-5
32178,32178,32179,4,1,-3
32179,32179,32180,1,6,5
32180,32180,32181,6,8,2
32181,32181,32182,8,4,-4
32182,32182,32183,4,6,2
32183,32183,32184,6,0,-6
32184,32184,32185,0,7,7
32185,32185,32186,7,4,-3
32186,32186,32187,4,1,-3
32187,32187,32188,1,4,3
32188,32188,32189,4,1,-3
32189,32189,32190,1,7,6
32190,32190,32191,7,4,-3
32191,32191,32192,4,3,-1
32192,32192,32193,3,3,0
32193,32193,32194,3,3,0
32194,32194,32195,3,7,4
32195,32195,32196,7,9,2
32196,32196,32197,9,7,-2
32197,32197,32198,7,5,-2
32198,32198,32199,5,8,3
32199,32199,32200,8,5,-3
32200,32200,32201,5,9,4
32201,32201,32202,9,2,-7
32202,32202,32203,2,3,1
32203,32203,32204,3,1,-2
32204,32204,32205,1,6,5
32205,32205,32206,6,8,2
32206,32206,32207,8,0,-8
32207,32207,32208,0,7,7
32208,32208,32209,7,3,-4
32209,32209,32210,3,0,-3
32210,32210,32211,0,6,6
32211,32211,32212,6,2,-4
32212,32212,32213,2,4,2
32213,32213,32214,4,5,1
32214,32214,32215,5,7,2
32215,32215,32216,7,2,-5
32216,32216,32217,2,5,3
32217,32217,32218,5,8,3
32218,32218,32219,8,6,-2
32219,32219,32220,6,7,1
32220,32220,32221,7,0,-7
32221,32221,32222,0,6,6
32222,32222,32223,6,3,-3
32223,32223,32224,3,1,-2
32224,32224,32225,1,8,7
32225,32225,32226,8,8,0
32226,32226,32227,8,3,-5
32227,32227,32228,3,6,3
32228,32228,32229,6,1,-5
32229,32229,32230,1,6,5
32230,32230,32231,6,1,-5
32231,32231,32232,1,4,3
32232,32232,32233,4,5,1
32233,32233,32234,5,3,-2
32234,32234,32235,3,9,6
32235,32235,32236,9,7,-2
32236,32236,32237,7,0,-7
32237,32237,32238,0,4,4
32238,32238,32239,4,9,5
32239,32239,32240,9,6,-3
32240,32240,32241,6,6,0
32241,32241,32242,6,6,0
32242,32242,32243,6,2,-4
32243,32243,32244,2,8,6
32244,32244,32245,8,1,-7
32245,32245,32246,1,1,0
32246,32246,32247,1,7,6
32247,32247,32248,7,5,-2
32248,32248,32249,5,9,4
32249,32249,32250,9,2,-7
32250,32250,32251,2,9,7
32251,32251,32252,9,7,-2
32252,32252,32253,7,8,1
32253,32253,32254,8,5,-3
32254,32254,32255,5,6,1
32255,32255,32256,6,9,3
32256,32256,32257,9,6,-3
32257,32257,32258,6,5,-1
32258,32258,32259,5,8,3
32259,32259,32260,8,9,1
32260,32260,32261,9,8,-1
32261,32261,32262,8,4,-4
32262,32262,32263,4,2,-2
32263,32263,32264,2,2,0
32264,32264,32265,2,6,4
32265,32265,32266,6,7,1
32266,32266,32267,7,3,-4
32267,32267,32268,3,0,-3
32268,32268,32269,0,2,2
32269,32269,32270,2,8,6
32270,32270,32271,8,9,1
32271,32271,32272,9,4,-5
32272,32272,32273,4,0,-4
32273,32273,32274,0,0,0
32274,32274,32275,0,3,3
32275,32275,32276,3,3,0
32276,32276,32277,3,5,2
32277,32277,32278,5,4,-1
32278,32278,32279,4,8,4
32279,32279,32280,8,2,-6
32280,32280,32281,2,3,1
32281,32281,32282,3,7,4
32282,32282,32283,7,5,-2
32283,32283,32284,5,3,-2
32284,32284,32285,3,8,5
32285,32285,32286,8,4,-4
32286,32286,32287,4,5,1
32287,32287,32288,5,2,-3
32288,32288,32289,2,7,5
32289,32289,32290,7,5,-2
32290,32290,32291,5,7,2
32291,32291,32292,7,2,-5
32292,32292,32293,2,0,-2
32293,32293,32294,0,7,7
32294,32294,32295,7,1,-6
32295,32295,32296,1,1,0
32296,32296,32297,1,2,1
32297,32297,32298,2,0,-2
32298,32298,32299,0,3,3
32299,32299,32300,3,8,5
32300,32300,32301,8,4,-4
32301,32301,32302,4,6,2
32302,32302,32303,6,5,-1
32303,32303,32304,5,9,4
32304,32304,32305,9,6,-3
32305,32305,32306,6,1,-5
32306,32306,32307,1,7,6
32307,32307,32308,7,4,-3
32308,32308,32309,4,8,4
32309,32309,32310,8,4,-4
32310,32310,32311,4,9,5
32311,32311,32312,9,6,-3
32312,32312,32313,6,0,-6
32313,32313,32314,0,3,3
32314,32314,32315,3,1,-2
32315,32315,32316,1,9,8
32316,32316,32317,9,2,-7
32317,32317,32318,2,2,0
32318,32318,32319,2,3,1
32319,32319,32320,3,6,3
32320,32320,32321,6,4,-2
32321,32321,32322,4,5,1
32322,32322,32323,5,5,0
32323,32323,32324,5,5,0
32324,32324,32325,5,6,1
32325,32325,32326,6,1,-5
32326,32326,32327,1,7,6
32327,32327,32328,7,4,-3
32328,32328,32329,4,8,4
32329,32329,32330,8,3,-5
32330,32330,32331,3,9,6
32331,32331,32332,9,1,-8
32332,32332,32333,1,0,-1
32333,32333,32334,0,1,1
32334,32334,32335,1,1,0
32335,32335,32336,1,0,-1
32336,32336,32337,0,2,2
32337,32337,32338,2,1,-1
32338,32338,32339,1,3,2
32339,32339,32340,3,4,1
32340,32340,32341,4,4,0
32341,32341,32342,4,9,5
32342,32342,32343,9,5,-4
32343,32343,32344,5,5,0
32344,32344,32345,5,6,1
32345,32345,32346,6,7,1
32346,32346,32347,7,7,0
32347,32347,32348,7,5,-2
32348,32348,32349,5,8,3
32349,32349,32350,8,9,1
32350,32350,32351,9,9,0
32351,32351,32352,9,8,-1
32352,32352,32353,8,1,-7
32353,32353,32354,1,5,4
32354,32354,32355,5,8,3
32355,32355,32356,8,9,1
32356,32356,32357,9,6,-3
32357,32357,32358,6,1,-5
32358,32358,32359,1,7,6
32359,32359,32360,7,9,2
32360,32360,32361,9,2,-7
32361,32361,32362,2,5,3
32362,32362,32363,5,7,2
32363,32363,32364,7,7,0
32364,32364,32365,7,1,-6
32365,32365,32366,1,9,8
32366,32366,32367,9,1,-8
32367,32367,32368,1,9,8
32368,32368,32369,9,4,-5
32369,32369,32370,4,6,2
32370,32370,32371,6,3,-3
32371,32371,32372,3,5,2
32372,32372,32373,5,7,2
32373,32373,32374,7,9,2
32374,32374,32375,9,8,-1
32375,32375,32376,8,3,-5
32376,32376,32377,3,9,6
32377,32377,32378,9,1,-8
32378,32378,32379,1,3,2
32379,32379,32380,3,9,6
32380,32380,32381,9,6,-3
32381,32381,32382,6,2,-4
32382,32382,32383,2,0,-2
32383,32383,32384,0,4,4
32384,32384,32385,4,3,-1
32385,32385,32386,3,5,2
32386,32386,32387,5,4,-1
32387,32387,32388,4,0,-4
32388,32388,32389,0,8,8
32389,32389,32390,8,8,0
32390,32390,32391,8,4,-4
32391,32391,32392,4,1,-3
32392,32392,32393,1,5,4
32393,32393,32394,5,5,0
32394,32394,32395,5,7,2
32395,32395,32396,7,9,2
32396,32396,32397,9,5,-4
32397,32397,32398,5,3,-2
32398,32398,32399,3,0,-3
32399,32399,32400,0,8,8
32400,32400,32401,8,3,-5
32401,32401,32402,3,6,3
32402,32402,32403,6,9,3
32403,32403,32404,9,8,-1
32404,32404,32405,8,2,-6
32405,32405,32406,2,1,-1
32406,32406,32407,1,8,7
32407,32407,32408,8,2,-6
32408,32408,32409,2,3,1
32409,32409,32410,3,9,6
32410,32410,32411,9,1,-8
32411,32411,32412,1,4,3
32412,32412,32413,4,1,-3
32413,32413,32414,1,3,2
32414,32414,32415,3,5,2
32415,32415,32416,5,7,2
32416,32416,32417,7,9,2
32417,32417,32418,9,2,-7
32418,32418,32419,2,4,2
32419,32419,32420,4,3,-1
32420,32420,32421,3,3,0
32421,32421,32422,3,3,0
32422,32422,32423,3,0,-3
32423,32423,32424,0,2,2
32424,32424,32425,2,4,2
32425,32425,32426,4,8,4
32426,32426,32427,8,0,-8
32427,32427,32428,0,7,7
32428,32428,32429,7,9,2
32429,32429,32430,9,2,-7
32430,32430,32431,2,6,4
32431,32431,32432,6,7,1
32432,32432,32433,7,9,2
32433,32433,32434,9,3,-6
32434,32434,32435,3,2,-1
32435,32435,32436,2,6,4
32436,32436,32437,6,2,-4
32437,32437,32438,2,2,0
32438,32438,32439,2,1,-1
32439,32439,32440,1,1,0
32440,32440,32441,1,7,6
32441,32441,32442,7,4,-3
32442,32442,32443,4,9,5
32443,32443,32444,9,3,-6
32444,32444,32445,3,5,2
32445,32445,32446,5,1,-4
32446,32446,32447,1,1,0
32447,32447,32448,1,4,3
32448,32448,32449,4,1,-3
32449,32449,32450,1,2,1
32450,32450,32451,2,9,7
32451,32451,32452,9,8,-1
32452,32452,32453,8,8,0
32453,32453,32454,8,0,-8
32454,32454,32455,0,6,6
32455,32455,32456,6,8,2
32456,32456,32457,8,9,1
32457,32457,32458,9,4,-5
32458,32458,32459,4,0,-4
32459,32459,32460,0,7,7
32460,32460,32461,7,0,-7
32461,32461,32462,0,1,1
32462,32462,32463,1,0,-1
32463,32463,32464,0,6,6
32464,32464,32465,6,1,-5
32465,32465,32466,1,4,3
32466,32466,32467,4,8,4
32467,32467,32468,8,8,0
32468,32468,32469,8,4,-4
32469,32469,32470,4,7,3
32470,32470,32471,7,8,1
32471,32471,32472,8,1,-7
32472,32472,32473,1,8,7
32473,32473,32474,8,1,-7
32474,32474,32475,1,2,1
32475,32475,32476,2,3,1
32476,32476,32477,3,6,3
32477,32477,32478,6,8,2
32478,32478,32479,8,3,-5
32479,32479,32480,3,8,5
32480,32480,32481,8,2,-6
32481,32481,32482,2,1,-1
32482,32482,32483,1,9,8
32483,32483,32484,9,3,-6
32484,32484,32485,3,2,-1
32485,32485,32486,2,1,-1
32486,32486,32487,1,4,3
32487,32487,32488,4,5,1
32488,32488,32489,5,0,-5
32489,32489,32490,0,3,3
32490,32490,32491,3,9,6
32491,32491,32492,9,5,-4
32492,32492,32493,5,0,-5
32493,32493,32494,0,0,0
32494,32494,32495,0,3,3
32495,32495,32496,3,1,-2
32496,32496,32497,1,7,6
32497,32497,32498,7,4,-3
32498,32498,32499,4,4,0
32499,32499,32500,4,6,2
32500,32500,32501,6,5,-1
32501,32501,32502,5,8,3
32502,32502,32503,8,8,0
32503,32503,32504,8,9,1
32504,32504,32505,9,3,-6
32505,32505,32506,3,5,2
32506,32506,32507,5,5,0
32507,32507,32508,5,2,-3
32508,32508,32509,2,8,6
32509,32509,32510,8,2,-6
32510,32510,32511,2,5,3
32511,32511,32512,5,4,-1
32512,32512,32513,4,4,0
32513,32513,32514,4,0,-4
32514,32514,32515,0,7,7
32515,32515,32516,7,8,1
32516,32516,32517,8,6,-2
32517,32517,32518,6,4,-2
32518,32518,32519,4,5,1
32519,32519,32520,5,0,-5
32520,32520,32521,0,2,2
32521,32521,32522,2,6,4
32522,32522,32523,6,2,-4
32523,32523,32524,2,4,2
32524,32524,32525,4,2,-2
32525,32525,32526,2,0,-2
32526,32526,32527,0,7,7
32527,32527,32528,7,1,-6
32528,32528,32529,1,7,6
32529,32529,32530,7,1,-6
32530,32530,32531,1,0,-1
32531,32531,32532,0,9,9
32532,32532,32533,9,5,-4
32533,32533,32534,5,1,-4
32534,32534,32535,1,1,0
32535,32535,32536,1,1,0
32536,32536,32537,1,5,4
32537,32537,32538,5,7,2
32538,32538,32539,7,3,-4
32539,32539,32540,3,1,-2
32540,32540,32541,1,0,-1
32541,32541,32542,0,7,7
32542,32542,32543,7,1,-6
32543,32543,32544,1,8,7
32544,32544,32545,8,2,-6
32545,32545,32546,2,6,4
32546,32546,32547,6,5,-1
32547,32547,32548,5,5,0
32548,32548,32549,5,6,1
32549,32549,32550,6,0,-6
32550,32550,32551,0,7,7
32551,32551,32552,7,9,2
32552,32552,32553,9,8,-1
32553,32553,32554,8,1,-7
32554,32554,32555,1,9,8
32555,32555,32556,9,4,-5
32556,32556,32557,4,0,-4
32557,32557,32558,0,4,4
32558,32558,32559,4,1,-3
32559,32559,32560,1,4,3
32560,32560,32561,4,2,-2
32561,32561,32562,2,1,-1
32562,32562,32563,1,3,2
32563,32563,32564,3,0,-3
32564,32564,32565,0,4,4
32565,32565,32566,4,5,1
32566,32566,32567,5,5,0
32567,32567,32568,5,0,-5
32568,32568,32569,0,6,6
32569,32569,32570,6,5,-1
32570,32570,32571,5,7,2
32571,32571,32572,7,6,-1
32572,32572,32573,6,8,2
32573,32573,32574,8,0,-8
32574,32574,32575,0,0,0
32575,32575,32576,0,6,6
32576,32576,32577,6,1,-5
32577,32577,32578,1,4,3
32578,32578,32579,4,2,-2
32579,32579,32580,2,7,5
32580,32580,32581,7,3,-4
32581,32581,32582,3,5,2
32582,32582,32583,5,4,-1
32583,32583,32584,4,7,3
32584,32584,32585,7,5,-2
32585,32585,32586,5,3,-2
32586,32586,32587,3,6,3
32587,32587,32588,6,3,-3
32588,32588,32589,3,7,4
32589,32589,32590,7,2,-5
32590,32590,32591,2,8,6
32591,32591,32592,8,6,-2
32592,32592,32593,6,9,3
32593,32593,32594,9,9,0
32594,32594,32595,9,2,-7
32595,32595,32596,2,8,6
32596,32596,32597,8,1,-7
32597,32597,32598,1,5,4
32598,32598,32599,5,7,2
32599,32599,32600,7,5,-2
32600,32600,32601,5,2,-3
32601,32601,32602,2,4,2
32602,32602,32603,4,5,1
32603,32603,32604,5,7,2
32604,32604,32605,7,0,-7
32605,32605,32606,0,2,2
32606,32606,32607,2,8,6
32607,32607,32608,8,7,-1
32608,32608,32609,7,0,-7
32609,32609,32610,0,3,3
32610,32610,32611,3,2,-1
32611,32611,32612,2,1,-1
32612,32612,32613,1,7,6
32613,32613,32614,7,5,-2
32614,32614,32615,5,8,3
32615,32615,32616,8,5,-3
32616,32616,32617,5,8,3
32617,32617,32618,8,9,1
32618,32618,32619,9,3,-6
32619,32619,32620,3,7,4
32620,32620,32621,7,0,-7
32621,32621,32622,0,8,8
32622,32622,32623,8,6,-2
32623,32623,32624,6,6,0
32624,32624,32625,6,0,-6
32625,32625,32626,0,7,7
32626,32626,32627,7,2,-5
32627,32627,32628,2,4,2
32628,32628,32629,4,7,3
32629,32629,32630,7,2,-5
32630,32630,32631,2,6,4
32631,32631,32632,6,1,-5
32632,32632,32633,1,6,5
32633,32633,32634,6,2,-4
32634,32634,32635,2,1,-1
32635,32635,32636,1,8,7
32636,32636,32637,8,2,-6
32637,32637,32638,2,8,6
32638,32638,32639,8,8,0
32639,32639,32640,8,2,-6
32640,32640,32641,2,8,6
32641,32641,32642,8,3,-5
32642,32642,32643,3,7,4
32643,32643,32644,7,3,-4
32644,32644,32645,3,7,4
32645,32645,32646,7,5,-2
32646,32646,32647,5,4,-1
32647,32647,32648,4,9,5
32648,32648,32649,9,7,-2
32649,32649,32650,7,2,-5
32650,32650,32651,2,7,5
32651,32651,32652,7,3,-4
32652,32652,32653,3,3,0
32653,32653,32654,3,2,-1
32654,32654,32655,2,7,5
32655,32655,32656,7,3,-4
32656,32656,32657,3,4,1
32657,32657,32658,4,6,2
32658,32658,32659,6,5,-1
32659,32659,32660,5,1,-4
32660,32660,32661,1,4,3
32661,32661,32662,4,7,3
32662,32662,32663,7,3,-4
32663,32663,32664,3,3,0
32664,32664,32665,3,3,0
32665,32665,32666,3,0,-3
32666,32666,32667,0,8,8
32667,32667,32668,8,9,1
32668,32668,32669,9,4,-5
32669,32669,32670,4,6,2
32670,32670,32671,6,5,-1
32671,32671,32672,5,9,4
32672,32672,32673,9,4,-5
32673,32673,32674,4,5,1
32674,32674,32675,5,1,-4
32675,32675,32676,1,9,8
32676,32676,32677,9,1,-8
32677,32677,32678,1,2,1
32678,32678,32679,2,9,7
32679,32679,32680,9,3,-6
32680,32680,32681,3,7,4
32681,32681,32682,7,0,-7
32682,32682,32683,0,4,4
32683,32683,32684,4,5,1
32684,32684,32685,5,3,-2
32685,32685,32686,3,5,2
32686,32686,32687,5,7,2
32687,32687,32688,7,3,-4
32688,32688,32689,3,3,0
32689,32689,32690,3,0,-3
32690,32690,32691,0,3,3
32691,32691,32692,3,6,3
32692,32692,32693,6,0,-6
32693,32693,32694,0,6,6
32694,32694,32695,6,2,-4
32695,32695,32696,2,6,4
32696,32696,32697,6,5,-1
32697,32697,32698,5,5,0
32698,32698,32699,5,5,0
32699,32699,32700,5,7,2
32700,32700,32701,7,6,-1
32701,32701,32702,6,5,-1
32702,32702,32703,5,3,-2
32703,32703,32704,3,1,-2
32704,32704,32705,1,1,0
32705,32705,32706,1,9,8
32706,32706,32707,9,5,-4
32707,32707,32708,5,0,-5
32708,32708,32709,0,2,2
32709,32709,32710,2,1,-1
32710,32710,32711,1,5,4
32711,32711,32712,5,8,3
32712,32712,32713,8,9,1
32713,32713,32714,9,9,0
32714,32714,32715,9,9,0
32715,32715,32716,9,7,-2
32716,32716,32717,7,8,1
32717,32717,32718,8,1,-7
32718,32718,32719,1,4,3
32719,32719,32720,4,5,1
32720,32720,32721,5,1,-4
32721,32721,32722,1,8,7
32722,32722,32723,8,0,-8
32723,32723,32724,0,5,5
32724,32724,32725,5,6,1
32725,32725,32726,6,2,-4
32726,32726,32727,2,0,-2
32727,32727,32728,0,7,7
32728,32728,32729,7,9,2
32729,32729,32730,9,3,-6
32730,32730,32731,3,6,3
32731,32731,32732,6,9,3
32732,32732,32733,9,8,-1
32733,32733,32734,8,6,-2
32734,32734,32735,6,8,2
32735,32735,32736,8,6,-2
32736,32736,32737,6,5,-1
32737,32737,32738,5,7,2
32738,32738,32739,7,6,-1
32739,32739,32740,6,7,1
32740,32740,32741,7,1,-6
32741,32741,32742,1,8,7
32742,32742,32743,8,1,-7
32743,32743,32744,1,2,1
32744,32744,32745,2,9,7
32745,32745,32746,9,0,-9
32746,32746,32747,0,8,8
32747,32747,32748,8,5,-3
32748,32748,32749,5,9,4
32749,32749,32750,9,5,-4
32750,32750,32751,5,2,-3
32751,32751,32752,2,6,4
32752,32752,32753,6,3,-3
32753,32753,32754,3,6,3
32754,32754,32755,6,5,-1
32755,32755,32756,5,1,-4
32756,32756,32757,1,5,4
32757,32757,32758,5,5,0
32758,32758,32759,5,9,4
32759,32759,32760,9,8,-1
32760,32760,32761,8,4,-4
32761,32761,32762,4,4,0
32762,32762,32763,4,2,-2
32763,32763,32764,2,3,1
32764,32764,32765,3,1,-2
32765,32765,32766,1,8,7
32766,32766,32767,8,9,1
32767,32767,32768,9,2,-7
32768,32768,32769,2,4,2
32769,32769,32770,4,8,4
32770,32770,32771,8,9,1
32771,32771,32772,9,4,-5
32772,32772,32773,4,1,-3
32773,32773,32774,1,8,7
32774,32774,32775,8,3,-5
32775,32775,32776,3,4,1
32776,32776,32777,4,9,5
32777,32777,32778,9,0,-9
32778,32778,32779,0,2,2
32779,32779,32780,2,2,0
32780,32780,32781,2,0,-2
32781,32781,32782,0,6,6
32782,32782,32783,6,6,0
32783,32783,32784,6,8,2
32784,32784,32785,8,0,-8
32785,32785,32786,0,3,3
32786,32786,32787,3,4,1
32787,32787,32788,4,5,1
32788,32788,32789,5,0,-5
32789,32789,32790,0,3,3
32790,32790,32791,3,6,3
32791,32791,32792,6,2,-4
32792,32792,32793,2,0,-2
32793,32793,32794,0,3,3
32794,32794,32795,3,1,-2
32795,32795,32796,1,8,7
32796,32796,32797,8,2,-6
32797,32797,32798,2,4,2
32798,32798,32799,4,3,-1
32799,32799,32800,3,0,-3
32800,32800,32801,0,4,4
32801,32801,32802,4,4,0
32802,32802,32803,4,6,2
32803,32803,32804,6,3,-3
32804,32804,32805,3,8,5
32805,32805,32806,8,8,0
32806,32806,32807,8,1,-7
32807,32807,32808,1,1,0
32808,32808,32809,1,2,1
32809,32809,32810,2,0,-2
32810,32810,32811,0,3,3
32811,32811,32812,3,7,4
32812,32812,32813,7,4,-3
32813,32813,32814,4,1,-3
32814,32814,32815,1,5,4
32815,32815,32816,5,9,4
32816,32816,32817,9,6,-3
32817,32817,32818,6,2,-4
32818,32818,32819,2,7,5
32819,32819,32820,7,7,0
32820,32820,32821,7,9,2
32821,32821,32822,9,5,-4
32822,32822,32823,5,1,-4
32823,32823,32824,1,1,0
32824,32824,32825,1,2,1
32825,32825,32826,2,6,4
32826,32826,32827,6,3,-3
32827,32827,32828,3,5,2
32828,32828,32829,5,4,-1
32829,32829,32830,4,4,0
32830,32830,32831,4,5,1
32831,32831,32832,5,4,-1
32832,32832,32833,4,6,2
32833,32833,32834,6,0,-6
32834,32834,32835,0,7,7
32835,32835,32836,7,2,-5
32836,32836,32837,2,8,6
32837,32837,32838,8,4,-4
32838,32838,32839,4,6,2
32839,32839,32840,6,5,-1
32840,32840,32841,5,6,1
32841,32841,32842,6,1,-5
32842,32842,32843,1,0,-1
32843,32843,32844,0,7,7
32844,32844,32845,7,2,-5
32845,32845,32846,2,0,-2
32846,32846,32847,0,3,3
32847,32847,32848,3,9,6
32848,32848,32849,9,7,-2
32849,32849,32850,7,3,-4
32850,32850,32851,3,4,1
32851,32851,32852,4,1,-3
32852,32852,32853,1,7,6
32853,32853,32854,7,2,-5
32854,32854,32855,2,1,-1
32855,32855,32856,1,2,1
32856,32856,32857,2,9,7
32857,32857,32858,9,0,-9
32858,32858,32859,0,1,1
32859,32859,32860,1,9,8
32860,32860,32861,9,7,-2
32861,32861,32862,7,4,-3
32862,32862,32863,4,1,-3
32863,32863,32864,1,8,7
32864,32864,32865,8,4,-4
32865,32865,32866,4,6,2
32866,32866,32867,6,0,-6
32867,32867,32868,0,6,6
32868,32868,32869,6,0,-6
32869,32869,32870,0,5,5
32870,32870,32871,5,1,-4
32871,32871,32872,1,2,1
32872,32872,32873,2,7,5
32873,32873,32874,7,8,1
32874,32874,32875,8,5,-3
32875,32875,32876,5,6,1
32876,32876,32877,6,7,1
32877,32877,32878,7,9,2
32878,32878,32879,9,1,-8
32879,32879,32880,1,0,-1
32880,32880,32881,0,3,3
32881,32881,32882,3,9,6
32882,32882,32883,9,3,-6
32883,32883,32884,3,8,5
32884,32884,32885,8,3,-5
32885,32885,32886,3,1,-2
32886,32886,32887,1,1,0
32887,32887,32888,1,7,6
32888,32888,32889,7,6,-1
32889,32889,32890,6,1,-5
32890,32890,32891,1,9,8
32891,32891,32892,9,1,-8
32892,32892,32893,1,7,6
32893,32893,32894,7,6,-1
32894,32894,32895,6,4,-2
32895,32895,32896,4,7,3
32896,32896,32897,7,3,-4
32897,32897,32898,3,9,6
32898,32898,32899,9,0,-9
32899,32899,32900,0,3,3
32900,32900,32901,3,2,-1
32901,32901,32902,2,5,3
32902,32902,32903,5,6,1
32903,32903,32904,6,9,3
32904,32904,32905,9,0,-9
32905,32905,32906,0,7,7
32906,32906,32907,7,8,1
32907,32907,32908,8,9,1
32908,32908,32909,9,9,0
32909,32909,32910,9,9,0
32910,32910,32911,9,4,-5
32911,32911,32912,4,6,2
32912,32912,32913,6,3,-3
32913,32913,32914,3,1,-2
32914,32914,32915,1,5,4
32915,32915,32916,5,9,4
32916,32916,32917,9,4,-5
32917,32917,32918,4,2,-2
32918,32918,32919,2,8,6
32919,32919,32920,8,7,-1
32920,32920,32921,7,1,-6
32921,32921,32922,1,6,5
32922,32922,32923,6,5,-1
32923,32923,32924,5,7,2
32924,32924,32925,7,0,-7
32925,32925,32926,0,8,8
32926,32926,32927,8,6,-2
32927,32927,32928,6,2,-4
32928,32928,32929,2,6,4
32929,32929,32930,6,9,3
32930,32930,32931,9,3,-6
32931,32931,32932,3,6,3
32932,32932,32933,6,3,-3
32933,32933,32934,3,2,-1
32934,32934,32935,2,8,6
32935,32935,32936,8,8,0
32936,32936,32937,8,1,-7
32937,32937,32938,1,6,5
32938,32938,32939,6,4,-2
32939,32939,32940,4,3,-1
32940,32940,32941,3,7,4
32941,32941,32942,7,6,-1
32942,32942,32943,6,5,-1
32943,32943,32944,5,3,-2
32944,32944,32945,3,7,4
32945,32945,32946,7,0,-7
32946,32946,32947,0,2,2
32947,32947,32948,2,8,6
32948,32948,32949,8,2,-6
32949,32949,32950,2,0,-2
32950,32950,32951,0,0,0
32951,32951,32952,0,0,0
32952,32952,32953,0,0,0
32953,32953,32954,0,5,5
32954,32954,32955,5,7,2
32955,32955,32956,7,7,0
32956,32956,32957,7,7,0
32957,32957,32958,7,1,-6
32958,32958,32959,1,9,8
32959,32959,32960,9,3,-6
32960,32960,32961,3,5,2
32961,32961,32962,5,8,3
32962,32962,32963,8,9,1
32963,32963,32964,9,3,-6
32964,32964,32965,3,8,5
32965,32965,32966,8,0,-8
32966,32966,32967,0,9,9
32967,32967,32968,9,8,-1
32968,32968,32969,8,6,-2
32969,32969,32970,6,9,3
32970,32970,32971,9,8,-1
32971,32971,32972,8,9,1
32972,32972,32973,9,2,-7
32973,32973,32974,2,1,-1
32974,32974,32975,1,3,2
32975,32975,32976,3,4,1
32976,32976,32977,4,6,2
32977,32977,32978,6,6,0
32978,32978,32979,6,1,-5
32979,32979,32980,1,7,6
32980,32980,32981,7,2,-5
32981,32981,32982,2,8,6
32982,32982,32983,8,9,1
32983,32983,32984,9,3,-6
32984,32984,32985,3,2,-1
32985,32985,32986,2,1,-1
32986,32986,32987,1,5,4
32987,32987,32988,5,7,2
32988,32988,32989,7,2,-5
32989,32989,32990,2,3,1
32990,32990,32991,3,2,-1
32991,32991,32992,2,5,3
32992,32992,32993,5,4,-1
32993,32993,32994,4,6,2
32994,32994,32995,6,8,2
32995,32995,32996,8,5,-3
32996,32996,32997,5,4,-1
32997,32997,32998,4,2,-2
32998,32998,32999,2,6,4
32999,32999,33000,6,3,-3
33000,33000,33001,3,5,2
33001,33001,33002,5,3,-2
33002,33002,33003,3,0,-3
33003,33003,33004,0,3,3
33004,33004,33005,3,1,-2
33005,33005,33006,1,6,5
33006,33006,33007,6,2,-4
33007,33007,33008,2,2,0
33008,33008,33009,2,3,1
33009,33009,33010,3,6,3
33010,33010,33011,6,4,-2
33011,33011,33012,4,1,-3
33012,33012,33013,1,5,4
33013,33013,33014,5,9,4
33014,33014,33015,9,6,-3
33015,33015,33016,6,2,-4
33016,33016,33017,2,7,5
33017,33017,33018,7,8,1
33018,33018,33019,8,8,0
33019,33019,33020,8,0,-8
33020,33020,33021,0,9,9
33021,33021,33022,9,3,-6
33022,33022,33023,3,0,-3
33023,33023,33024,0,1,1
33024,33024,33025,1,1,0
33025,33025,33026,1,8,7
33026,33026,33027,8,2,-6
33027,33027,33028,2,3,1
33028,33028,33029,3,3,0
33029,33029,33030,3,6,3
33030,33030,33031,6,4,-2
33031,33031,33032,4,6,2
33032,33032,33033,6,5,-1
33033,33033,33034,5,6,1
33034,33034,33035,6,6,0
33035,33035,33036,6,8,2
33036,33036,33037,8,7,-1
33037,33037,33038,7,8,1
33038,33038,33039,8,8,0
33039,33039,33040,8,6,-2
33040,33040,33041,6,9,3
33041,33041,33042,9,0,-9
33042,33042,33043,0,0,0
33043,33043,33044,0,5,5
33044,33044,33045,5,1,-4
33045,33045,33046,1,5,4
33046,33046,33047,5,2,-3
33047,33047,33048,2,1,-1
33048,33048,33049,1,3,2
33049,33049,33050,3,7,4
33050,33050,33051,7,4,-3
33051,33051,33052,4,9,5
33052,33052,33053,9,5,-4
33053,33053,33054,5,3,-2
33054,33054,33055,3,6,3
33055,33055,33056,6,6,0
33056,33056,33057,6,7,1
33057,33057,33058,7,6,-1
33058,33058,33059,6,8,2
33059,33059,33060,8,2,-6
33060,33060,33061,2,9,7
33061,33061,33062,9,7,-2
33062,33062,33063,7,6,-1
33063,33063,33064,6,4,-2
33064,33064,33065,4,2,-2
33065,33065,33066,2,0,-2
33066,33066,33067,0,7,7
33067,33067,33068,7,2,-5
33068,33068,33069,2,1,-1
33069,33069,33070,1,4,3
33070,33070,33071,4,5,1
33071,33071,33072,5,8,3
33072,33072,33073,8,6,-2
33073,33073,33074,6,8,2
33074,33074,33075,8,2,-6
33075,33075,33076,2,6,4
33076,33076,33077,6,5,-1
33077,33077,33078,5,0,-5
33078,33078,33079,0,0,0
33079,33079,33080,0,3,3
33080,33080,33081,3,5,2
33081,33081,33082,5,7,2
33082,33082,33083,7,4,-3
33083,33083,33084,4,1,-3
33084,33084,33085,1,2,1
33085,33085,33086,2,1,-1
33086,33086,33087,1,0,-1
33087,33087,33088,0,2,2
33088,33088,33089,2,8,6
33089,33089,33090,8,2,-6
33090,33090,33091,2,1,-1
33091,33091,33092,1,1,0
33092,33092,33093,1,7,6
33093,33093,33094,7,2,-5
33094,33094,33095,2,1,-1
33095,33095,33096,1,2,1
33096,33096,33097,2,8,6
33097,33097,33098,8,9,1
33098,33098,33099,9,3,-6
33099,33099,33100,3,6,3
33100,33100,33101,6,8,2
33101,33101,33102,8,6,-2
33102,33102,33103,6,7,1
33103,33103,33104,7,7,0
33104,33104,33105,7,1,-6
33105,33105,33106,1,4,3
33106,33106,33107,4,7,3
33107,33107,33108,7,1,-6
33108,33108,33109,1,7,6
33109,33109,33110,7,1,-6
33110,33110,33111,1,0,-1
33111,33111,33112,0,0,0
33112,33112,33113,0,1,1
33113,33113,33114,1,3,2
33114,33114,33115,3,4,1
33115,33115,33116,4,6,2
33116,33116,33117,6,4,-2
33117,33117,33118,4,0,-4
33118,33118,33119,0,4,4
33119,33119,33120,4,2,-2
33120,33120,33121,2,5,3
33121,33121,33122,5,1,-4
33122,33122,33123,1,7,6
33123,33123,33124,7,1,-6
33124,33124,33125,1,4,3
33125,33125,33126,4,9,5
33126,33126,33127,9,4,-5
33127,33127,33128,4,7,3
33128,33128,33129,7,9,2
33129,33129,33130,9,9,0
33130,33130,33131,9,7,-2
33131,33131,33132,7,3,-4
33132,33132,33133,3,2,-1
33133,33133,33134,2,7,5
33134,33134,33135,7,6,-1
33135,33135,33136,6,0,-6
33136,33136,33137,0,5,5
33137,33137,33138,5,5,0
33138,33138,33139,5,3,-2
33139,33139,33140,3,1,-2
33140,33140,33141,1,9,8
33141,33141,33142,9,0,-9
33142,33142,33143,0,4,4
33143,33143,33144,4,9,5
33144,33144,33145,9,3,-6
33145,33145,33146,3,3,0
33146,33146,33147,3,9,6
33147,33147,33148,9,0,-9
33148,33148,33149,0,0,0
33149,33149,33150,0,8,8
33150,33150,33151,8,8,0
33151,33151,33152,8,8,0
33152,33152,33153,8,7,-1
33153,33153,33154,7,6,-1
33154,33154,33155,6,9,3
33155,33155,33156,9,9,0
33156,33156,33157,9,0,-9
33157,33157,33158,0,2,2
33158,33158,33159,2,6,4
33159,33159,33160,6,2,-4
33160,33160,33161,2,3,1
33161,33161,33162,3,8,5
33162,33162,33163,8,0,-8
33163,33163,33164,0,7,7
33164,33164,33165,7,4,-3
33165,33165,33166,4,1,-3
33166,33166,33167,1,6,5
33167,33167,33168,6,2,-4
33168,33168,33169,2,3,1
33169,33169,33170,3,7,4
33170,33170,33171,7,7,0
33171,33171,33172,7,0,-7
33172,33172,33173,0,0,0
33173,33173,33174,0,9,9
33174,33174,33175,9,1,-8
33175,33175,33176,1,1,0
33176,33176,33177,1,4,3
33177,33177,33178,4,6,2
33178,33178,33179,6,8,2
33179,33179,33180,8,2,-6
33180,33180,33181,2,8,6
33181,33181,33182,8,9,1
33182,33182,33183,9,1,-8
33183,33183,33184,1,2,1
33184,33184,33185,2,2,0
33185,33185,33186,2,3,1
33186,33186,33187,3,9,6
33187,33187,33188,9,1,-8
33188,33188,33189,1,3,2
33189,33189,33190,3,1,-2
33190,33190,33191,1,1,0
33191,33191,33192,1,0,-1
33192,33192,33193,0,8,8
33193,33193,33194,8,3,-5
33194,33194,33195,3,4,1
33195,33195,33196,4,7,3
33196,33196,33197,7,2,-5
33197,33197,33198,2,8,6
33198,33198,33199,8,9,1
33199,33199,33200,9,5,-4
33200,33200,33201,5,8,3
33201,33201,33202,8,8,0
33202,33202,33203,8,2,-6
33203,33203,33204,2,4,2
33204,33204,33205,4,8,4
33205,33205,33206,8,5,-3
33206,33206,33207,5,6,1
33207,33207,33208,6,3,-3
33208,33208,33209,3,6,3
33209,33209,33210,6,2,-4
33210,33210,33211,2,9,7
33211,33211,33212,9,9,0
33212,33212,33213,9,2,-7
33213,33213,33214,2,0,-2
33214,33214,33215,0,9,9
33215,33215,33216,9,5,-4
33216,33216,33217,5,6,1
33217,33217,33218,6,4,-2
33218,33218,33219,4,0,-4
33219,33219,33220,0,5,5
33220,33220,33221,5,5,0
33221,33221,33222,5,5,0
33222,33222,33223,5,3,-2
33223,33223,33224,3,1,-2
33224,33224,33225,1,3,2
33225,33225,33226,3,9,6
33226,33226,33227,9,6,-3
33227,33227,33228,6,0,-6
33228,33228,33229,0,3,3
33229,33229,33230,3,0,-3
33230,33230,33231,0,1,1
33231,33231,33232,1,9,8
33232,33232,33233,9,2,-7
33233,33233,33234,2,7,5
33234,33234,33235,7,5,-2
33235,33235,33236,5,9,4
33236,33236,33237,9,0,-9
33237,33237,33238,0,0,0
33238,33238,33239,0,3,3
33239,33239,33240,3,3,0
33240,33240,33241,3,7,4
33241,33241,33242,7,6,-1
33242,33242,33243,6,1,-5
33243,33243,33244,1,0,-1
33244,33244,33245,0,5,5
33245,33245,33246,5,9,4
33246,33246,33247,9,5,-4
33247,33247,33248,5,4,-1
33248,33248,33249,4,9,5
33249,33249,33250,9,2,-7
33250,33250,33251,2,8,6
33251,33251,33252,8,9,1
33252,33252,33253,9,0,-9
33253,33253,33254,0,0,0
33254,33254,33255,0,9,9
33255,33255,33256,9,9,0
33256,33256,33257,9,0,-9
33257,33257,33258,0,6,6
33258,33258,33259,6,1,-5
33259,33259,33260,1,5,4
33260,33260,33261,5,2,-3
33261,33261,33262,2,4,2
33262,33262,33263,4,3,-1
33263,33263,33264,3,6,3
33264,33264,33265,6,4,-2
33265,33265,33266,4,1,-3
33266,33266,33267,1,5,4
33267,33267,33268,5,1,-4
33268,33268,33269,1,6,5
33269,33269,33270,6,8,2
33270,33270,33271,8,7,-1
33271,33271,33272,7,6,-1
33272,33272,33273,6,8,2
33273,33273,33274,8,2,-6
33274,33274,33275,2,9,7
33275,33275,33276,9,3,-6
33276,33276,33277,3,0,-3
33277,33277,33278,0,8,8
33278,33278,33279,8,1,-7
33279,33279,33280,1,7,6
33280,33280,33281,7,2,-5
33281,33281,33282,2,4,2
33282,33282,33283,4,3,-1
33283,33283,33284,3,7,4
33284,33284,33285,7,4,-3
33285,33285,33286,4,9,5
33286,33286,33287,9,7,-2
33287,33287,33288,7,5,-2
33288,33288,33289,5,8,3
33289,33289,33290,8,2,-6
33290,33290,33291,2,9,7
33291,33291,33292,9,0,-9
33292,33292,33293,0,0,0
33293,33293,33294,0,5,5
33294,33294,33295,5,1,-4
33295,33295,33296,1,2,1
33296,33296,33297,2,2,0
33297,33297,33298,2,1,-1
33298,33298,33299,1,3,2
33299,33299,33300,3,9,6
33300,33300,33301,9,4,-5
33301,33301,33302,4,0,-4
33302,33302,33303,0,5,5
33303,33303,33304,5,7,2
33304,33304,33305,7,6,-1
33305,33305,33306,6,4,-2
33306,33306,33307,4,7,3
33307,33307,33308,7,9,2
33308,33308,33309,9,8,-1
33309,33309,33310,8,1,-7
33310,33310,33311,1,9,8
33311,33311,33312,9,4,-5
33312,33312,33313,4,9,5
33313,33313,33314,9,6,-3
33314,33314,33315,6,7,1
33315,33315,33316,7,3,-4
33316,33316,33317,3,4,1
33317,33317,33318,4,6,2
33318,33318,33319,6,1,-5
33319,33319,33320,1,4,3
33320,33320,33321,4,5,1
33321,33321,33322,5,4,-1
33322,33322,33323,4,8,4
33323,33323,33324,8,5,-3
33324,33324,33325,5,8,3
33325,33325,33326,8,1,-7
33326,33326,33327,1,0,-1
33327,33327,33328,0,6,6
33328,33328,33329,6,9,3
33329,33329,33330,9,0,-9
33330,33330,33331,0,3,3
33331,33331,33332,3,1,-2
33332,33332,33333,1,2,1
33333,33333,33334,2,2,0
33334,33334,33335,2,7,5
33335,33335,33336,7,9,2
33336,33336,33337,9,8,-1
33337,33337,33338,8,8,0
33338,33338,33339,8,1,-7
33339,33339,33340,1,5,4
33340,33340,33341,5,6,1
33341,33341,33342,6,2,-4
33342,33342,33343,2,1,-1
33343,33343,33344,1,3,2
33344,33344,33345,3,0,-3
33345,33345,33346,0,4,4
33346,33346,33347,4,4,0
33347,33347,33348,4,7,3
33348,33348,33349,7,5,-2
33349,33349,33350,5,0,-5
33350,33350,33351,0,3,3
33351,33351,33352,3,5,2
33352,33352,33353,5,9,4
33353,33353,33354,9,1,-8
33354,33354,33355,1,4,3
33355,33355,33356,4,7,3
33356,33356,33357,7,3,-4
33357,33357,33358,3,9,6
33358,33358,33359,9,4,-5
33359,33359,33360,4,9,5
33360,33360,33361,9,2,-7
33361,33361,33362,2,7,5
33362,33362,33363,7,0,-7
33363,33363,33364,0,2,2
33364,33364,33365,2,5,3
33365,33365,33366,5,9,4
33366,33366,33367,9,0,-9
33367,33367,33368,0,1,1
33368,33368,33369,1,1,0
33369,33369,33370,1,1,0
33370,33370,33371,1,3,2
33371,33371,33372,3,9,6
33372,33372,33373,9,2,-7
33373,33373,33374,2,1,-1
33374,33374,33375,1,9,8
33375,33375,33376,9,5,-4
33376,33376,33377,5,1,-4
33377,33377,33378,1,0,-1
33378,33378,33379,0,6,6
33379,33379,33380,6,9,3
33380,33380,33381,9,0,-9
33381,33381,33382,0,8,8
33382,33382,33383,8,1,-7
33383,33383,33384,1,7,6
33384,33384,33385,7,1,-6
33385,33385,33386,1,8,7
33386,33386,33387,8,8,0
33387,33387,33388,8,8,0
33388,33388,33389,8,0,-8
33389,33389,33390,0,0,0
33390,33390,33391,0,4,4
33391,33391,33392,4,0,-4
33392,33392,33393,0,7,7
33393,33393,33394,7,1,-6
33394,33394,33395,1,7,6
33395,33395,33396,7,1,-6
33396,33396,33397,1,6,5
33397,33397,33398,6,1,-5
33398,33398,33399,1,3,2
33399,33399,33400,3,3,0
33400,33400,33401,3,6,3
33401,33401,33402,6,9,3
33402,33402,33403,9,0,-9
33403,33403,33404,0,5,5
33404,33404,33405,5,7,2
33405,33405,33406,7,7,0
33406,33406,33407,7,3,-4
33407,33407,33408,3,7,4
33408,33408,33409,7,5,-2
33409,33409,33410,5,6,1
33410,33410,33411,6,4,-2
33411,33411,33412,4,3,-1
33412,33412,33413,3,2,-1
33413,33413,33414,2,2,0
33414,33414,33415,2,4,2
33415,33415,33416,4,1,-3
33416,33416,33417,1,1,0
33417,33417,33418,1,1,0
33418,33418,33419,1,8,7
33419,33419,33420,8,5,-3
33420,33420,33421,5,3,-2
33421,33421,33422,3,9,6
33422,33422,33423,9,7,-2
33423,33423,33424,7,8,1
33424,33424,33425,8,1,-7
33425,33425,33426,1,4,3
33426,33426,33427,4,0,-4
33427,33427,33428,0,1,1
33428,33428,33429,1,6,5
33429,33429,33430,6,7,1
33430,33430,33431,7,7,0
33431,33431,33432,7,3,-4
33432,33432,33433,3,1,-2
33433,33433,33434,1,6,5
33434,33434,33435,6,2,-4
33435,33435,33436,2,6,4
33436,33436,33437,6,5,-1
33437,33437,33438,5,2,-3
33438,33438,33439,2,8,6
33439,33439,33440,8,1,-7
33440,33440,33441,1,1,0
33441,33441,33442,1,0,-1
33442,33442,33443,0,9,9
33443,33443,33444,9,3,-6
33444,33444,33445,3,3,0
33445,33445,33446,3,1,-2
33446,33446,33447,1,8,7
33447,33447,33448,8,5,-3
33448,33448,33449,5,2,-3
33449,33449,33450,2,6,4
33450,33450,33451,6,8,2
33451,33451,33452,8,8,0
33452,33452,33453,8,8,0
33453,33453,33454,8,6,-2
33454,33454,33455,6,7,1
33455,33455,33456,7,1,-6
33456,33456,33457,1,1,0
33457,33457,33458,1,1,0
33458,33458,33459,1,7,6
33459,33459,33460,7,8,1
33460,33460,33461,8,9,1
33461,33461,33462,9,1,-8
33462,33462,33463,1,2,1
33463,33463,33464,2,0,-2
33464,33464,33465,0,0,0
33465,33465,33466,0,7,7
33466,33466,33467,7,1,-6
33467,33467,33468,1,3,2
33468,33468,33469,3,2,-1
33469,33469,33470,2,7,5
33470,33470,33471,7,3,-4
33471,33471,33472,3,9,6
33472,33472,33473,9,4,-5
33473,33473,33474,4,6,2
33474,33474,33475,6,5,-1
33475,33475,33476,5,8,3
33476,33476,33477,8,6,-2
33477,33477,33478,6,4,-2
33478,33478,33479,4,7,3
33479,33479,33480,7,1,-6
33480,33480,33481,1,8,7
33481,33481,33482,8,0,-8
33482,33482,33483,0,9,9
33483,33483,33484,9,6,-3
33484,33484,33485,6,0,-6
33485,33485,33486,0,6,6
33486,33486,33487,6,1,-5
33487,33487,33488,1,2,1
33488,33488,33489,2,2,0
33489,33489,33490,2,8,6
33490,33490,33491,8,3,-5
33491,33491,33492,3,0,-3
33492,33492,33493,0,4,4
33493,33493,33494,4,5,1
33494,33494,33495,5,5,0
33495,33495,33496,5,0,-5
33496,33496,33497,0,6,6
33497,33497,33498,6,1,-5
33498,33498,33499,1,7,6
33499,33499,33500,7,3,-4
33500,33500,33501,3,0,-3
33501,33501,33502,0,5,5
33502,33502,33503,5,1,-4
33503,33503,33504,1,7,6
33504,33504,33505,7,2,-5
33505,33505,33506,2,4,2
33506,33506,33507,4,3,-1
33507,33507,33508,3,1,-2
33508,33508,33509,1,4,3
33509,33509,33510,4,3,-1
33510,33510,33511,3,5,2
33511,33511,33512,5,0,-5
33512,33512,33513,0,6,6
33513,33513,33514,6,8,2
33514,33514,33515,8,7,-1
33515,33515,33516,7,1,-6
33516,33516,33517,1,8,7
33517,33517,33518,8,6,-2
33518,33518,33519,6,8,2
33519,33519,33520,8,6,-2
33520,33520,33521,6,7,1
33521,33521,33522,7,0,-7
33522,33522,33523,0,4,4
33523,33523,33524,4,7,3
33524,33524,33525,7,7,0
33525,33525,33526,7,2,-5
33526,33526,33527,2,7,5
33527,33527,33528,7,5,-2
33528,33528,33529,5,3,-2
33529,33529,33530,3,7,4
33530,33530,33531,7,9,2
33531,33531,33532,9,3,-6
33532,33532,33533,3,8,5
33533,33533,33534,8,0,-8
33534,33534,33535,0,1,1
33535,33535,33536,1,0,-1
33536,33536,33537,0,5,5
33537,33537,33538,5,0,-5
33538,33538,33539,0,8,8
33539,33539,33540,8,2,-6
33540,33540,33541,2,2,0
33541,33541,33542,2,6,4
33542,33542,33543,6,7,1
33543,33543,33544,7,9,2
33544,33544,33545,9,4,-5
33545,33545,33546,4,8,4
33546,33546,33547,8,2,-6
33547,33547,33548,2,6,4
33548,33548,33549,6,6,0
33549,33549,33550,6,6,0
33550,33550,33551,6,4,-2
33551,33551,33552,4,4,0
33552,33552,33553,4,5,1
33553,33553,33554,5,4,-1
33554,33554,33555,4,5,1
33555,33555,33556,5,1,-4
33556,33556,33557,1,8,7
33557,33557,33558,8,1,-7
33558,33558,33559,1,6,5
33559,33559,33560,6,6,0
33560,33560,33561,6,4,-2
33561,33561,33562,4,5,1
33562,33562,33563,5,4,-1
33563,33563,33564,4,6,2
33564,33564,33565,6,4,-2
33565,33565,33566,4,3,-1
33566,33566,33567,3,1,-2
33567,33567,33568,1,3,2
33568,33568,33569,3,8,5
33569,33569,33570,8,8,0
33570,33570,33571,8,7,-1
33571,33571,33572,7,6,-1
33572,33572,33573,6,5,-1
33573,33573,33574,5,4,-1
33574,33574,33575,4,5,1
33575,33575,33576,5,9,4
33576,33576,33577,9,1,-8
33577,33577,33578,1,0,-1
33578,33578,33579,0,8,8
33579,33579,33580,8,1,-7
33580,33580,33581,1,9,8
33581,33581,33582,9,7,-2
33582,33582,33583,7,3,-4
33583,33583,33584,3,6,3
33584,33584,33585,6,6,0
33585,33585,33586,6,1,-5
33586,33586,33587,1,3,2
33587,33587,33588,3,6,3
33588,33588,33589,6,3,-3
33589,33589,33590,3,3,0
33590,33590,33591,3,2,-1
33591,33591,33592,2,9,7
33592,33592,33593,9,2,-7
33593,33593,33594,2,3,1
33594,33594,33595,3,6,3
33595,33595,33596,6,1,-5
33596,33596,33597,1,9,8
33597,33597,33598,9,5,-4
33598,33598,33599,5,9,4
33599,33599,33600,9,1,-8
33600,33600,33601,1,6,5
33601,33601,33602,6,5,-1
33602,33602,33603,5,5,0
33603,33603,33604,5,6,1
33604,33604,33605,6,5,-1
33605,33605,33606,5,9,4
33606,33606,33607,9,3,-6
33607,33607,33608,3,0,-3
33608,33608,33609,0,3,3
33609,33609,33610,3,9,6
33610,33610,33611,9,8,-1
33611,33611,33612,8,7,-1
33612,33612,33613,7,1,-6
33613,33613,33614,1,4,3
33614,33614,33615,4,6,2
33615,33615,33616,6,7,1
33616,33616,33617,7,5,-2
33617,33617,33618,5,7,2
33618,33618,33619,7,6,-1
33619,33619,33620,6,2,-4
33620,33620,33621,2,8,6
33621,33621,33622,8,5,-3
33622,33622,33623,5,1,-4
33623,33623,33624,1,3,2
33624,33624,33625,3,9,6
33625,33625,33626,9,4,-5
33626,33626,33627,4,7,3
33627,33627,33628,7,1,-6
33628,33628,33629,1,6,5
33629,33629,33630,6,4,-2
33630,33630,33631,4,8,4
33631,33631,33632,8,5,-3
33632,33632,33633,5,3,-2
33633,33633,33634,3,1,-2
33634,33634,33635,1,7,6
33635,33635,33636,7,8,1
33636,33636,33637,8,4,-4
33637,33637,33638,4,4,0
33638,33638,33639,4,7,3
33639,33639,33640,7,0,-7
33640,33640,33641,0,0,0
33641,33641,33642,0,9,9
33642,33642,33643,9,9,0
33643,33643,33644,9,2,-7
33644,33644,33645,2,0,-2
33645,33645,33646,0,1,1
33646,33646,33647,1,0,-1
33647,33647,33648,0,1,1
33648,33648,33649,1,3,2
33649,33649,33650,3,4,1
33650,33650,33651,4,7,3
33651,33651,33652,7,1,-6
33652,33652,33653,1,9,8
33653,33653,33654,9,1,-8
33654,33654,33655,1,3,2
33655,33655,33656,3,7,4
33656,33656,33657,7,0,-7
33657,33657,33658,0,1,1
33658,33658,33659,1,2,1
33659,33659,33660,2,7,5
33660,33660,33661,7,0,-7
33661,33661,33662,0,2,2
33662,33662,33663,2,1,-1
33663,33663,33664,1,8,7
33664,33664,33665,8,0,-8
33665,33665,33666,0,2,2
33666,33666,33667,2,1,-1
33667,33667,33668,1,8,7
33668,33668,33669,8,0,-8
33669,33669,33670,0,0,0
33670,33670,33671,0,4,4
33671,33671,33672,4,2,-2
33672,33672,33673,2,0,-2
33673,33673,33674,0,5,5
33674,33674,33675,5,1,-4
33675,33675,33676,1,7,6
33676,33676,33677,7,0,-7
33677,33677,33678,0,8,8
33678,33678,33679,8,4,-4
33679,33679,33680,4,2,-2
33680,33680,33681,2,7,5
33681,33681,33682,7,9,2
33682,33682,33683,9,9,0
33683,33683,33684,9,1,-8
33684,33684,33685,1,2,1
33685,33685,33686,2,2,0
33686,33686,33687,2,0,-2
33687,33687,33688,0,2,2
33688,33688,33689,2,6,4
33689,33689,33690,6,5,-1
33690,33690,33691,5,2,-3
33691,33691,33692,2,6,4
33692,33692,33693,6,6,0
33693,33693,33694,6,3,-3
33694,33694,33695,3,2,-1
33695,33695,33696,2,9,7
33696,33696,33697,9,2,-7
33697,33697,33698,2,2,0
33698,33698,33699,2,9,7
33699,33699,33700,9,5,-4
33700,33700,33701,5,9,4
33701,33701,33702,9,4,-5
33702,33702,33703,4,0,-4
33703,33703,33704,0,6,6
33704,33704,33705,6,1,-5
33705,33705,33706,1,1,0
33706,33706,33707,1,2,1
33707,33707,33708,2,4,2
33708,33708,33709,4,3,-1
33709,33709,33710,3,7,4
33710,33710,33711,7,4,-3
33711,33711,33712,4,9,5
33712,33712,33713,9,5,-4
33713,33713,33714,5,4,-1
33714,33714,33715,4,6,2
33715,33715,33716,6,2,-4
33716,33716,33717,2,7,5
33717,33717,33718,7,4,-3
33718,33718,33719,4,8,4
33719,33719,33720,8,4,-4
33720,33720,33721,4,9,5
33721,33721,33722,9,3,-6
33722,33722,33723,3,0,-3
33723,33723,33724,0,6,6
33724,33724,33725,6,1,-5
33725,33725,33726,1,4,3
33726,33726,33727,4,2,-2
33727,33727,33728,2,6,4
33728,33728,33729,6,3,-3
33729,33729,33730,3,6,3
33730,33730,33731,6,4,-2
33731,33731,33732,4,0,-4
33732,33732,33733,0,5,5
33733,33733,33734,5,5,0
33734,33734,33735,5,6,1
33735,33735,33736,6,7,1
33736,33736,33737,7,7,0
33737,33737,33738,7,9,2
33738,33738,33739,9,0,-9
33739,33739,33740,0,4,4
33740,33740,33741,4,1,-3
33741,33741,33742,1,6,5
33742,33742,33743,6,2,-4
33743,33743,33744,2,9,7
33744,33744,33745,9,3,-6
33745,33745,33746,3,9,6
33746,33746,33747,9,4,-5
33747,33747,33748,4,5,1
33748,33748,33749,5,5,0
33749,33749,33750,5,1,-4
33750,33750,33751,1,6,5
33751,33751,33752,6,1,-5
33752,33752,33753,1,7,6
33753,33753,33754,7,3,-4
33754,33754,33755,3,8,5
33755,33755,33756,8,9,1
33756,33756,33757,9,9,0
33757,33757,33758,9,3,-6
33758,33758,33759,3,7,4
33759,33759,33760,7,3,-4
33760,33760,33761,3,4,1
33761,33761,33762,4,9,5
33762,33762,33763,9,3,-6
33763,33763,33764,3,9,6
33764,33764,33765,9,8,-1
33765,33765,33766,8,8,0
33766,33766,33767,8,5,-3
33767,33767,33768,5,9,4
33768,33768,33769,9,1,-8
33769,33769,33770,1,8,7
33770,33770,33771,8,8,0
33771,33771,33772,8,3,-5
33772,33772,33773,3,5,2
33773,33773,33774,5,1,-4
33774,33774,33775,1,2,1
33775,33775,33776,2,0,-2
33776,33776,33777,0,8,8
33777,33777,33778,8,8,0
33778,33778,33779,8,6,-2
33779,33779,33780,6,8,2
33780,33780,33781,8,1,-7
33781,33781,33782,1,6,5
33782,33782,33783,6,9,3
33783,33783,33784,9,9,0
33784,33784,33785,9,2,-7
33785,33785,33786,2,3,1
33786,33786,33787,3,4,1
33787,33787,33788,4,7,3
33788,33788,33789,7,0,-7
33789,33789,33790,0,6,6
33790,33790,33791,6,9,3
33791,33791,33792,9,4,-5
33792,33792,33793,4,9,5
33793,33793,33794,9,6,-3
33794,33794,33795,6,3,-3
33795,33795,33796,3,7,4
33796,33796,33797,7,7,0
33797,33797,33798,7,7,0
33798,33798,33799,7,1,-6
33799,33799,33800,1,1,0
33800,33800,33801,1,8,7
33801,33801,33802,8,8,0
33802,33802,33803,8,4,-4
33803,33803,33804,4,2,-2
33804,33804,33805,2,4,2
33805,33805,33806,4,9,5
33806,33806,33807,9,2,-7
33807,33807,33808,2,5,3
33808,33808,33809,5,7,2
33809,33809,33810,7,8,1
33810,33810,33811,8,5,-3
33811,33811,33812,5,6,1
33812,33812,33813,6,8,2
33813,33813,33814,8,6,-2
33814,33814,33815,6,5,-1
33815,33815,33816,5,4,-1
33816,33816,33817,4,3,-1
33817,33817,33818,3,3,0
33818,33818,33819,3,2,-1
33819,33819,33820,2,8,6
33820,33820,33821,8,2,-6
33821,33821,33822,2,9,7
33822,33822,33823,9,0,-9
33823,33823,33824,0,4,4
33824,33824,33825,4,5,1
33825,33825,33826,5,1,-4
33826,33826,33827,1,8,7
33827,33827,33828,8,3,-5
33828,33828,33829,3,6,3
33829,33829,33830,6,7,1
33830,33830,33831,7,0,-7
33831,33831,33832,0,2,2
33832,33832,33833,2,4,2
33833,33833,33834,4,7,3
33834,33834,33835,7,0,-7
33835,33835,33836,0,7,7
33836,33836,33837,7,3,-4
33837,33837,33838,3,7,4
33838,33838,33839,7,8,1
33839,33839,33840,8,3,-5
33840,33840,33841,3,1,-2
33841,33841,33842,1,1,0
33842,33842,33843,1,0,-1
33843,33843,33844,0,0,0
33844,33844,33845,0,3,3
33845,33845,33846,3,4,1
33846,33846,33847,4,0,-4
33847,33847,33848,0,0,0
33848,33848,33849,0,4,4
33849,33849,33850,4,1,-3
33850,33850,33851,1,7,6
33851,33851,33852,7,4,-3
33852,33852,33853,4,4,0
33853,33853,33854,4,3,-1
33854,33854,33855,3,9,6
33855,33855,33856,9,1,-8
33856,33856,33857,1,2,1
33857,33857,33858,2,5,3
33858,33858,33859,5,9,4
33859,33859,33860,9,9,0
33860,33860,33861,9,1,-8
33861,33861,33862,1,9,8
33862,33862,33863,9,2,-7
33863,33863,33864,2,0,-2
33864,33864,33865,0,1,1
33865,33865,33866,1,5,4
33866,33866,33867,5,7,2
33867,33867,33868,7,1,-6
33868,33868,33869,1,1,0
33869,33869,33870,1,7,6
33870,33870,33871,7,6,-1
33871,33871,33872,6,4,-2
33872,33872,33873,4,7,3
33873,33873,33874,7,0,-7
33874,33874,33875,0,3,3
33875,33875,33876,3,5,2
33876,33876,33877,5,3,-2
33877,33877,33878,3,2,-1
33878,33878,33879,2,6,4
33879,33879,33880,6,3,-3
33880,33880,33881,3,2,-1
33881,33881,33882,2,4,2
33882,33882,33883,4,8,4
33883,33883,33884,8,4,-4
33884,33884,33885,4,7,3
33885,33885,33886,7,6,-1
33886,33886,33887,6,6,0
33887,33887,33888,6,4,-2
33888,33888,33889,4,4,0
33889,33889,33890,4,8,4
33890,33890,33891,8,9,1
33891,33891,33892,9,5,-4
33892,33892,33893,5,8,3
33893,33893,33894,8,4,-4
33894,33894,33895,4,8,4
33895,33895,33896,8,3,-5
33896,33896,33897,3,2,-1
33897,33897,33898,2,8,6
33898,33898,33899,8,9,1
33899,33899,33900,9,4,-5
33900,33900,33901,4,6,2
33901,33901,33902,6,1,-5
33902,33902,33903,1,5,4
33903,33903,33904,5,0,-5
33904,33904,33905,0,5,5
33905,33905,33906,5,2,-3
33906,33906,33907,2,9,7
33907,33907,33908,9,3,-6
33908,33908,33909,3,5,2
33909,33909,33910,5,6,1
33910,33910,33911,6,3,-3
33911,33911,33912,3,7,4
33912,33912,33913,7,7,0
33913,33913,33914,7,0,-7
33914,33914,33915,0,4,4
33915,33915,33916,4,6,2
33916,33916,33917,6,3,-3
33917,33917,33918,3,1,-2
33918,33918,33919,1,6,5
33919,33919,33920,6,7,1
33920,33920,33921,7,0,-7
33921,33921,33922,0,4,4
33922,33922,33923,4,0,-4
33923,33923,33924,0,1,1
33924,33924,33925,1,4,3
33925,33925,33926,4,4,0
33926,33926,33927,4,6,2
33927,33927,33928,6,5,-1
33928,33928,33929,5,6,1
33929,33929,33930,6,2,-4
33930,33930,33931,2,9,7
33931,33931,33932,9,4,-5
33932,33932,33933,4,0,-4
33933,33933,33934,0,6,6
33934,33934,33935,6,1,-5
33935,33935,33936,1,1,0
33936,33936,33937,1,1,0
33937,33937,33938,1,2,1
33938,33938,33939,2,3,1
33939,33939,33940,3,0,-3
33940,33940,33941,0,2,2
33941,33941,33942,2,1,-1
33942,33942,33943,1,1,0
33943,33943,33944,1,9,8
33944,33944,33945,9,0,-9
33945,33945,33946,0,8,8
33946,33946,33947,8,0,-8
33947,33947,33948,0,9,9
33948,33948,33949,9,1,-8
33949,33949,33950,1,7,6
33950,33950,33951,7,2,-5
33951,33951,33952,2,4,2
33952,33952,33953,4,3,-1
33953,33953,33954,3,5,2
33954,33954,33955,5,4,-1
33955,33955,33956,4,8,4
33956,33956,33957,8,7,-1
33957,33957,33958,7,4,-3
33958,33958,33959,4,8,4
33959,33959,33960,8,6,-2
33960,33960,33961,6,9,3
33961,33961,33962,9,3,-6
33962,33962,33963,3,0,-3
33963,33963,33964,0,7,7
33964,33964,33965,7,1,-6
33965,33965,33966,1,3,2
33966,33966,33967,3,2,-1
33967,33967,33968,2,5,3
33968,33968,33969,5,3,-2
33969,33969,33970,3,3,0
33970,33970,33971,3,4,1
33971,33971,33972,4,5,1
33972,33972,33973,5,5,0
33973,33973,33974,5,9,4
33974,33974,33975,9,6,-3
33975,33975,33976,6,9,3
33976,33976,33977,9,7,-2
33977,33977,33978,7,0,-7
33978,33978,33979,0,8,8
33979,33979,33980,8,6,-2
33980,33980,33981,6,9,3
33981,33981,33982,9,2,-7
33982,33982,33983,2,0,-2
33983,33983,33984,0,6,6
33984,33984,33985,6,1,-5
33985,33985,33986,1,3,2
33986,33986,33987,3,2,-1
33987,33987,33988,2,7,5
33988,33988,33989,7,3,-4
33989,33989,33990,3,9,6
33990,33990,33991,9,4,-5
33991,33991,33992,4,1,-3
33992,33992,33993,1,5,4
33993,33993,33994,5,4,-1
33994,33994,33995,4,7,3
33995,33995,33996,7,7,0
33996,33996,33997,7,8,1
33997,33997,33998,8,1,-7
33998,33998,33999,1,9,8
33999,33999,34000,9,4,-5
34000,34000,34001,4,8,4
34001,34001,34002,8,5,-3
34002,34002,34003,5,6,1
34003,34003,34004,6,1,-5
34004,34004,34005,1,5,4
34005,34005,34006,5,3,-2
34006,34006,34007,3,0,-3
34007,34007,34008,0,1,1
34008,34008,34009,1,6,5
34009,34009,34010,6,1,-5
34010,34010,34011,1,8,7
34011,34011,34012,8,6,-2
34012,34012,34013,6,9,3
34013,34013,34014,9,0,-9
34014,34014,34015,0,4,4
34015,34015,34016,4,0,-4
34016,34016,34017,0,1,1
34017,34017,34018,1,3,2
34018,34018,34019,3,9,6
34019,34019,34020,9,8,-1
34020,34020,34021,8,5,-3
34021,34021,34022,5,4,-1
34022,34022,34023,4,3,-1
34023,34023,34024,3,6,3
34024,34024,34025,6,0,-6
34025,34025,34026,0,3,3
34026,34026,34027,3,4,1
34027,34027,34028,4,4,0
34028,34028,34029,4,8,4
34029,34029,34030,8,8,0
34030,34030,34031,8,9,1
34031,34031,34032,9,7,-2
34032,34032,34033,7,1,-6
34033,34033,34034,1,8,7
34034,34034,34035,8,4,-4
34035,34035,34036,4,0,-4
34036,34036,34037,0,0,0
34037,34037,34038,0,1,1
34038,34038,34039,1,5,4
34039,34039,34040,5,8,3
34040,34040,34041,8,5,-3
34041,34041,34042,5,8,3
34042,34042,34043,8,4,-4
34043,34043,34044,4,9,5
34044,34044,34045,9,0,-9
34045,34045,34046,0,6,6
34046,34046,34047,6,7,1
34047,34047,34048,7,3,-4
34048,34048,34049,3,6,3
34049,34049,34050,6,5,-1
34050,34050,34051,5,0,-5
34051,34051,34052,0,9,9
34052,34052,34053,9,1,-8
34053,34053,34054,1,0,-1
34054,34054,34055,0,7,7
34055,34055,34056,7,2,-5
34056,34056,34057,2,0,-2
34057,34057,34058,0,3,3
34058,34058,34059,3,6,3
34059,34059,34060,6,6,0
34060,34060,34061,6,8,2
34061,34061,34062,8,2,-6
34062,34062,34063,2,9,7
34063,34063,34064,9,0,-9
34064,34064,34065,0,5,5
34065,34065,34066,5,9,4
34066,34066,34067,9,4,-5
34067,34067,34068,4,8,4
34068,34068,34069,8,7,-1
34069,34069,34070,7,0,-7
34070,34070,34071,0,6,6
34071,34071,34072,6,9,3
34072,34072,34073,9,0,-9
34073,34073,34074,0,1,1
34074,34074,34075,1,8,7
34075,34075,34076,8,3,-5
34076,34076,34077,3,1,-2
34077,34077,34078,1,2,1
34078,34078,34079,2,7,5
34079,34079,34080,7,1,-6
34080,34080,34081,1,7,6
34081,34081,34082,7,5,-2
34082,34082,34083,5,1,-4
34083,34083,34084,1,0,-1
34084,34084,34085,0,3,3
34085,34085,34086,3,0,-3
34086,34086,34087,0,2,2
34087,34087,34088,2,7,5
34088,34088,34089,7,3,-4
34089,34089,34090,3,9,6
34090,34090,34091,9,1,-8
34091,34091,34092,1,3,2
34092,34092,34093,3,4,1
34093,34093,34094,4,7,3
34094,34094,34095,7,2,-5
34095,34095,34096,2,1,-1
34096,34096,34097,1,0,-1
34097,34097,34098,0,8,8
34098,34098,34099,8,0,-8
34099,34099,34100,0,6,6
34100,34100,34101,6,4,-2
34101,34101,34102,4,4,0
34102,34102,34103,4,9,5
34103,34103,34104,9,9,0
34104,34104,34105,9,3,-6
34105,34105,34106,3,6,3
34106,34106,34107,6,8,2
34107,34107,34108,8,8,0
34108,34108,34109,8,4,-4
34109,34109,34110,4,7,3
34110,34110,34111,7,7,0
34111,34111,34112,7,5,-2
34112,34112,34113,5,2,-3
34113,34113,34114,2,5,3
34114,34114,34115,5,5,0
34115,34115,34116,5,2,-3
34116,34116,34117,2,6,4
34117,34117,34118,6,7,1
34118,34118,34119,7,3,-4
34119,34119,34120,3,3,0
34120,34120,34121,3,6,3
34121,34121,34122,6,5,-1
34122,34122,34123,5,9,4
34123,34123,34124,9,6,-3
34124,34124,34125,6,6,0
34125,34125,34126,6,9,3
34126,34126,34127,9,3,-6
34127,34127,34128,3,5,2
34128,34128,34129,5,2,-3
34129,34129,34130,2,4,2
34130,34130,34131,4,2,-2
34131,34131,34132,2,7,5
34132,34132,34133,7,4,-3
34133,34133,34134,4,2,-2
34134,34134,34135,2,6,4
34135,34135,34136,6,2,-4
34136,34136,34137,2,5,3
34137,34137,34138,5,4,-1
34138,34138,34139,4,5,1
34139,34139,34140,5,3,-2
34140,34140,34141,3,1,-2
34141,34141,34142,1,7,6
34142,34142,34143,7,3,-4
34143,34143,34144,3,4,1
34144,34144,34145,4,3,-1
34145,34145,34146,3,4,1
34146,34146,34147,4,9,5
34147,34147,34148,9,5,-4
34148,34148,34149,5,7,2
34149,34149,34150,7,8,1
34150,34150,34151,8,8,0
34151,34151,34152,8,0,-8
34152,34152,34153,0,7,7
34153,34153,34154,7,8,1
34154,34154,34155,8,2,-6
34155,34155,34156,2,1,-1
34156,34156,34157,1,2,1
34157,34157,34158,2,1,-1
34158,34158,34159,1,5,4
34159,34159,34160,5,7,2
34160,34160,34161,7,7,0
34161,34161,34162,7,1,-6
34162,34162,34163,1,9,8
34163,34163,34164,9,1,-8
34164,34164,34165,1,8,7
34165,34165,34166,8,1,-7
34166,34166,34167,1,2,1
34167,34167,34168,2,1,-1
34168,34168,34169,1,1,0
34169,34169,34170,1,3,2
34170,34170,34171,3,3,0
34171,34171,34172,3,0,-3
34172,34172,34173,0,1,1
34173,34173,34174,1,6,5
34174,34174,34175,6,3,-3
34175,34175,34176,3,9,6
34176,34176,34177,9,0,-9
34177,34177,34178,0,7,7
34178,34178,34179,7,1,-6
34179,34179,34180,1,3,2
34180,34180,34181,3,2,-1
34181,34181,34182,2,2,0
34182,34182,34183,2,3,1
34183,34183,34184,3,9,6
34184,34184,34185,9,4,-5
34185,34185,34186,4,6,2
34186,34186,34187,6,5,-1
34187,34187,34188,5,3,-2
34188,34188,34189,3,6,3
34189,34189,34190,6,3,-3
34190,34190,34191,3,7,4
34191,34191,34192,7,4,-3
34192,34192,34193,4,8,4
34193,34193,34194,8,8,0
34194,34194,34195,8,9,1
34195,34195,34196,9,9,0
34196,34196,34197,9,0,-9
34197,34197,34198,0,6,6
34198,34198,34199,6,1,-5
34199,34199,34200,1,7,6
34200,34200,34201,7,2,-5
34201,34201,34202,2,2,0
34202,34202,34203,2,3,1
34203,34203,34204,3,3,0
34204,34204,34205,3,4,1
34205,34205,34206,4,1,-3
34206,34206,34207,1,7,6
34207,34207,34208,7,3,-4
34208,34208,34209,3,8,5
34209,34209,34210,8,4,-4
34210,34210,34211,4,9,5
34211,34211,34212,9,8,-1
34212,34212,34213,8,0,-8
34213,34213,34214,0,2,2
34214,34214,34215,2,1,-1
34215,34215,34216,1,4,3
34216,34216,34217,4,2,-2
34217,34217,34218,2,2,0
34218,34218,34219,2,3,1
34219,34219,34220,3,6,3
34220,34220,34221,6,4,-2
34221,34221,34222,4,1,-3
34222,34222,34223,1,7,6
34223,34223,34224,7,9,2
34224,34224,34225,9,8,-1
34225,34225,34226,8,2,-6
34226,34226,34227,2,9,7
34227,34227,34228,9,2,-7
34228,34228,34229,2,7,5
34229,34229,34230,7,7,0
34230,34230,34231,7,7,0
34231,34231,34232,7,7,0
34232,34232,34233,7,7,0
34233,34233,34234,7,4,-3
34234,34234,34235,4,3,-1
34235,34235,34236,3,8,5
34236,34236,34237,8,0,-8
34237,34237,34238,0,0,0
34238,34238,34239,0,3,3
34239,34239,34240,3,4,1
34240,34240,34241,4,1,-3
34241,34241,34242,1,5,4
34242,34242,34243,5,8,3
34243,34243,34244,8,0,-8
34244,34244,34245,0,7,7
34245,34245,34246,7,0,-7
34246,34246,34247,0,6,6
34247,34247,34248,6,9,3
34248,34248,34249,9,4,-5
34249,34249,34250,4,2,-2
34250,34250,34251,2,0,-2
34251,34251,34252,0,2,2
34252,34252,34253,2,2,0
34253,34253,34254,2,9,7
34254,34254,34255,9,6,-3
34255,34255,34256,6,2,-4
34256,34256,34257,2,8,6
34257,34257,34258,8,9,1
34258,34258,34259,9,3,-6
34259,34259,34260,3,6,3
34260,34260,34261,6,1,-5
34261,34261,34262,1,0,-1
34262,34262,34263,0,1,1
34263,34263,34264,1,1,0
34264,34264,34265,1,7,6
34265,34265,34266,7,4,-3
34266,34266,34267,4,7,3
34267,34267,34268,7,3,-4
34268,34268,34269,3,1,-2
34269,34269,34270,1,5,4
34270,34270,34271,5,6,1
34271,34271,34272,6,1,-5
34272,34272,34273,1,0,-1
34273,34273,34274,0,5,5
34274,34274,34275,5,4,-1
34275,34275,34276,4,5,1
34276,34276,34277,5,6,1
34277,34277,34278,6,7,1
34278,34278,34279,7,4,-3
34279,34279,34280,4,9,5
34280,34280,34281,9,4,-5
34281,34281,34282,4,1,-3
34282,34282,34283,1,0,-1
34283,34283,34284,0,6,6
34284,34284,34285,6,6,0
34285,34285,34286,6,8,2
34286,34286,34287,8,2,-6
34287,34287,34288,2,5,3
34288,34288,34289,5,3,-2
34289,34289,34290,3,4,1
34290,34290,34291,4,1,-3
34291,34291,34292,1,9,8
34292,34292,34293,9,3,-6
34293,34293,34294,3,4,1
34294,34294,34295,4,6,2
34295,34295,34296,6,0,-6
34296,34296,34297,0,8,8
34297,34297,34298,8,7,-1
34298,34298,34299,7,5,-2
34299,34299,34300,5,9,4
34300,34300,34301,9,9,0
34301,34301,34302,9,0,-9
34302,34302,34303,0,4,4
34303,34303,34304,4,8,4
34304,34304,34305,8,0,-8
34305,34305,34306,0,9,9
34306,34306,34307,9,7,-2
34307,34307,34308,7,2,-5
34308,34308,34309,2,5,3
34309,34309,34310,5,2,-3
34310,34310,34311,2,8,6
34311,34311,34312,8,8,0
34312,34312,34313,8,8,0
34313,34313,34314,8,7,-1
34314,34314,34315,7,3,-4
34315,34315,34316,3,3,0
34316,34316,34317,3,7,4
34317,34317,34318,7,3,-4
34318,34318,34319,3,8,5
34319,34319,34320,8,8,0
34320,34320,34321,8,9,1
34321,34321,34322,9,8,-1
34322,34322,34323,8,2,-6
34323,34323,34324,2,6,4
34324,34324,34325,6,5,-1
34325,34325,34326,5,2,-3
34326,34326,34327,2,3,1
34327,34327,34328,3,8,5
34328,34328,34329,8,1,-7
34329,34329,34330,1,9,8
34330,34330,34331,9,7,-2
34331,34331,34332,7,9,2
34332,34332,34333,9,3,-6
34333,34333,34334,3,1,-2
34334,34334,34335,1,9,8
34335,34335,34336,9,6,-3
34336,34336,34337,6,1,-5
34337,34337,34338,1,9,8
34338,34338,34339,9,9,0
34339,34339,34340,9,5,-4
34340,34340,34341,5,9,4
34341,34341,34342,9,6,-3
34342,34342,34343,6,6,0
34343,34343,34344,6,7,1
34344,34344,34345,7,0,-7
34345,34345,34346,0,4,4
34346,34346,34347,4,9,5
34347,34347,34348,9,4,-5
34348,34348,34349,4,4,0
34349,34349,34350,4,6,2
34350,34350,34351,6,3,-3
34351,34351,34352,3,0,-3
34352,34352,34353,0,7,7
34353,34353,34354,7,4,-3
34354,34354,34355,4,0,-4
34355,34355,34356,0,0,0
34356,34356,34357,0,4,4
34357,34357,34358,4,0,-4
34358,34358,34359,0,1,1
34359,34359,34360,1,6,5
34360,34360,34361,6,4,-2
34361,34361,34362,4,5,1
34362,34362,34363,5,3,-2
34363,34363,34364,3,3,0
34364,34364,34365,3,5,2
34365,34365,34366,5,3,-2
34366,34366,34367,3,4,1
34367,34367,34368,4,3,-1
34368,34368,34369,3,0,-3
34369,34369,34370,0,5,5
34370,34370,34371,5,2,-3
34371,34371,34372,2,8,6
34372,34372,34373,8,1,-7
34373,34373,34374,1,6,5
34374,34374,34375,6,8,2
34375,34375,34376,8,8,0
34376,34376,34377,8,9,1
34377,34377,34378,9,7,-2
34378,34378,34379,7,4,-3
34379,34379,34380,4,6,2
34380,34380,34381,6,0,-6
34381,34381,34382,0,8,8
34382,34382,34383,8,1,-7
34383,34383,34384,1,3,2
34384,34384,34385,3,2,-1
34385,34385,34386,2,7,5
34386,34386,34387,7,3,-4
34387,34387,34388,3,1,-2
34388,34388,34389,1,4,3
34389,34389,34390,4,3,-1
34390,34390,34391,3,5,2
34391,34391,34392,5,0,-5
34392,34392,34393,0,6,6
34393,34393,34394,6,0,-6
34394,34394,34395,0,7,7
34395,34395,34396,7,3,-4
34396,34396,34397,3,8,5
34397,34397,34398,8,9,1
34398,34398,34399,9,9,0
34399,34399,34400,9,5,-4
34400,34400,34401,5,0,-5
34401,34401,34402,0,1,1
34402,34402,34403,1,1,0
34403,34403,34404,1,9,8
34404,34404,34405,9,2,-7
34405,34405,34406,2,4,2
34406,34406,34407,4,3,-1
34407,34407,34408,3,2,-1
34408,34408,34409,2,4,2
34409,34409,34410,4,7,3
34410,34410,34411,7,5,-2
34411,34411,34412,5,1,-4
34412,34412,34413,1,6,5
34413,34413,34414,6,8,2
34414,34414,34415,8,7,-1
34415,34415,34416,7,0,-7
34416,34416,34417,0,8,8
34417,34417,34418,8,1,-7
34418,34418,34419,1,9,8
34419,34419,34420,9,9,0
34420,34420,34421,9,0,-9
34421,34421,34422,0,8,8
34422,34422,34423,8,1,-7
34423,34423,34424,1,4,3
34424,34424,34425,4,2,-2
34425,34425,34426,2,1,-1
34426,34426,34427,1,3,2
34427,34427,34428,3,4,1
34428,34428,34429,4,4,0
34429,34429,34430,4,4,0
34430,34430,34431,4,5,1
34431,34431,34432,5,2,-3
34432,34432,34433,2,6,4
34433,34433,34434,6,7,1
34434,34434,34435,7,7,0
34435,34435,34436,7,2,-5
34436,34436,34437,2,8,6
34437,34437,34438,8,5,-3
34438,34438,34439,5,9,4
34439,34439,34440,9,0,-9
34440,34440,34441,0,2,2
34441,34441,34442,2,2,0
34442,34442,34443,2,2,0
34443,34443,34444,2,2,0
34444,34444,34445,2,7,5
34445,34445,34446,7,7,0
34446,34446,34447,7,6,-1
34447,34447,34448,6,5,-1
34448,34448,34449,5,4,-1
34449,34449,34450,4,2,-2
34450,34450,34451,2,0,-2
34451,34451,34452,0,8,8
34452,34452,34453,8,5,-3
34453,34453,34454,5,7,2
34454,34454,34455,7,8,1
34455,34455,34456,8,6,-2
34456,34456,34457,6,0,-6
34457,34457,34458,0,9,9
34458,34458,34459,9,7,-2
34459,34459,34460,7,8,1
34460,34460,34461,8,3,-5
34461,34461,34462,3,2,-1
34462,34462,34463,2,5,3
34463,34463,34464,5,4,-1
34464,34464,34465,4,4,0
34465,34465,34466,4,6,2
34466,34466,34467,6,1,-5
34467,34467,34468,1,4,3
34468,34468,34469,4,8,4
34469,34469,34470,8,1,-7
34470,34470,34471,1,0,-1
34471,34471,34472,0,7,7
34472,34472,34473,7,5,-2
34473,34473,34474,5,5,0
34474,34474,34475,5,2,-3
34475,34475,34476,2,9,7
34476,34476,34477,9,7,-2
34477,34477,34478,7,5,-2
34478,34478,34479,5,2,-3
34479,34479,34480,2,0,-2
34480,34480,34481,0,3,3
34481,34481,34482,3,9,6
34482,34482,34483,9,1,-8
34483,34483,34484,1,2,1
34484,34484,34485,2,7,5
34485,34485,34486,7,0,-7
34486,34486,34487,0,7,7
34487,34487,34488,7,6,-1
34488,34488,34489,6,9,3
34489,34489,34490,9,6,-3
34490,34490,34491,6,9,3
34491,34491,34492,9,6,-3
34492,34492,34493,6,1,-5
34493,34493,34494,1,2,1
34494,34494,34495,2,2,0
34495,34495,34496,2,9,7
34496,34496,34497,9,4,-5
34497,34497,34498,4,4,0
34498,34498,34499,4,6,2
34499,34499,34500,6,8,2
34500,34500,34501,8,7,-1
34501,34501,34502,7,0,-7
34502,34502,34503,0,7,7
34503,34503,34504,7,9,2
34504,34504,34505,9,5,-4
34505,34505,34506,5,7,2
34506,34506,34507,7,4,-3
34507,34507,34508,4,0,-4
34508,34508,34509,0,5,5
34509,34509,34510,5,8,3
34510,34510,34511,8,0,-8
34511,34511,34512,0,1,1
34512,34512,34513,1,1,0
34513,34513,34514,1,0,-1
34514,34514,34515,0,1,1
34515,34515,34516,1,7,6
34516,34516,34517,7,9,2
34517,34517,34518,9,7,-2
34518,34518,34519,7,0,-7
34519,34519,34520,0,6,6
34520,34520,34521,6,2,-4
34521,34521,34522,2,6,4
34522,34522,34523,6,0,-6
34523,34523,34524,0,8,8
34524,34524,34525,8,3,-5
34525,34525,34526,3,3,0
34526,34526,34527,3,5,2
34527,34527,34528,5,7,2
34528,34528,34529,7,6,-1
34529,34529,34530,6,4,-2
34530,34530,34531,4,1,-3
34531,34531,34532,1,2,1
34532,34532,34533,2,8,6
34533,34533,34534,8,8,0
34534,34534,34535,8,6,-2
34535,34535,34536,6,3,-3
34536,34536,34537,3,4,1
34537,34537,34538,4,0,-4
34538,34538,34539,0,6,6
34539,34539,34540,6,8,2
34540,34540,34541,8,0,-8
34541,34541,34542,0,1,1
34542,34542,34543,1,6,5
34543,34543,34544,6,9,3
34544,34544,34545,9,4,-5
34545,34545,34546,4,6,2
34546,34546,34547,6,3,-3
34547,34547,34548,3,3,0
34548,34548,34549,3,9,6
34549,34549,34550,9,4,-5
34550,34550,34551,4,3,-1
34551,34551,34552,3,3,0
34552,34552,34553,3,0,-3
34553,34553,34554,0,8,8
34554,34554,34555,8,0,-8
34555,34555,34556,0,3,3
34556,34556,34557,3,5,2
34557,34557,34558,5,2,-3
34558,34558,34559,2,2,0
34559,34559,34560,2,7,5
34560,34560,34561,7,5,-2
34561,34561,34562,5,0,-5
34562,34562,34563,0,8,8
34563,34563,34564,8,7,-1
34564,34564,34565,7,8,1
34565,34565,34566,8,1,-7
34566,34566,34567,1,8,7
34567,34567,34568,8,7,-1
34568,34568,34569,7,9,2
34569,34569,34570,9,4,-5
34570,34570,34571,4,4,0
34571,34571,34572,4,4,0
34572,34572,34573,4,2,-2
34573,34573,34574,2,8,6
34574,34574,34575,8,8,0
34575,34575,34576,8,7,-1
34576,34576,34577,7,8,1
34577,34577,34578,8,6,-2
34578,34578,34579,6,5,-1
34579,34579,34580,5,0,-5
34580,34580,34581,0,5,5
34581,34581,34582,5,0,-5
34582,34582,34583,0,7,7
34583,34583,34584,7,5,-2
34584,34584,34585,5,1,-4
34585,34585,34586,1,0,-1
34586,34586,34587,0,3,3
34587,34587,34588,3,1,-2
34588,34588,34589,1,6,5
34589,34589,34590,6,1,-5
34590,34590,34591,1,9,8
34591,34591,34592,9,9,0
34592,34592,34593,9,4,-5
34593,34593,34594,4,8,4
34594,34594,34595,8,1,-7
34595,34595,34596,1,4,3
34596,34596,34597,4,3,-1
34597,34597,34598,3,9,6
34598,34598,34599,9,7,-2
34599,34599,34600,7,7,0
34600,34600,34601,7,6,-1
34601,34601,34602,6,5,-1
34602,34602,34603,5,9,4
34603,34603,34604,9,2,-7
34604,34604,34605,2,3,1
34605,34605,34606,3,2,-1
34606,34606,34607,2,3,1
34607,34607,34608,3,9,6
34608,34608,34609,9,7,-2
34609,34609,34610,7,5,-2
34610,34610,34611,5,4,-1
34611,34611,34612,4,1,-3
34612,34612,34613,1,1,0
34613,34613,34614,1,2,1
34614,34614,34615,2,9,7
34615,34615,34616,9,9,0
34616,34616,34617,9,1,-8
34617,34617,34618,1,7,6
34618,34618,34619,7,0,-7
34619,34619,34620,0,2,2
34620,34620,34621,2,6,4
34621,34621,34622,6,3,-3
34622,34622,34623,3,0,-3
34623,34623,34624,0,6,6
34624,34624,34625,6,1,-5
34625,34625,34626,1,5,4
34626,34626,34627,5,2,-3
34627,34627,34628,2,6,4
34628,34628,34629,6,3,-3
34629,34629,34630,3,3,0
34630,34630,34631,3,4,1
34631,34631,34632,4,1,-3
34632,34632,34633,1,7,6
34633,34633,34634,7,0,-7
34634,34634,34635,0,8,8
34635,34635,34636,8,2,-6
34636,34636,34637,2,9,7
34637,34637,34638,9,1,-8
34638,34638,34639,1,0,-1
34639,34639,34640,0,1,1
34640,34640,34641,1,1,0
34641,34641,34642,1,3,2
34642,34642,34643,3,2,-1
34643,34643,34644,2,3,1
34644,34644,34645,3,3,0
34645,34645,34646,3,3,0
34646,34646,34647,3,7,4
34647,34647,34648,7,6,-1
34648,34648,34649,6,8,2
34649,34649,34650,8,2,-6
34650,34650,34651,2,9,7
34651,34651,34652,9,6,-3
34652,34652,34653,6,0,-6
34653,34653,34654,0,6,6
34654,34654,34655,6,1,-5
34655,34655,34656,1,0,-1
34656,34656,34657,0,2,2
34657,34657,34658,2,6,4
34658,34658,34659,6,3,-3
34659,34659,34660,3,3,0
34660,34660,34661,3,7,4
34661,34661,34662,7,0,-7
34662,34662,34663,0,8,8
34663,34663,34664,8,2,-6
34664,34664,34665,2,9,7
34665,34665,34666,9,7,-2
34666,34666,34667,7,1,-6
34667,34667,34668,1,9,8
34668,34668,34669,9,8,-1
34669,34669,34670,8,7,-1
34670,34670,34671,7,6,-1
34671,34671,34672,6,3,-3
34672,34672,34673,3,7,4
34673,34673,34674,7,5,-2
34674,34674,34675,5,2,-3
34675,34675,34676,2,7,5
34676,34676,34677,7,7,0
34677,34677,34678,7,8,1
34678,34678,34679,8,1,-7
34679,34679,34680,1,2,1
34680,34680,34681,2,1,-1
34681,34681,34682,1,4,3
34682,34682,34683,4,4,0
34683,34683,34684,4,3,-1
34684,34684,34685,3,3,0
34685,34685,34686,3,6,3
34686,34686,34687,6,7,1
34687,34687,34688,7,9,2
34688,34688,34689,9,7,-2
34689,34689,34690,7,7,0
34690,34690,34691,7,8,1
34691,34691,34692,8,5,-3
34692,34692,34693,5,9,4
34693,34693,34694,9,9,0
34694,34694,34695,9,3,-6
34695,34695,34696,3,8,5
34696,34696,34697,8,6,-2
34697,34697,34698,6,6,0
34698,34698,34699,6,0,-6
34699,34699,34700,0,6,6
34700,34700,34701,6,3,-3
34701,34701,34702,3,7,4
34702,34702,34703,7,6,-1
34703,34703,34704,6,7,1
34704,34704,34705,7,1,-6
34705,34705,34706,1,0,-1
34706,34706,34707,0,8,8
34707,34707,34708,8,0,-8
34708,34708,34709,0,4,4
34709,34709,34710,4,3,-1
34710,34710,34711,3,5,2
34711,34711,34712,5,3,-2
34712,34712,34713,3,3,0
34713,34713,34714,3,0,-3
34714,34714,34715,0,9,9
34715,34715,34716,9,3,-6
34716,34716,34717,3,2,-1
34717,34717,34718,2,2,0
34718,34718,34719,2,8,6
34719,34719,34720,8,5,-3
34720,34720,34721,5,3,-2
34721,34721,34722,3,8,5
34722,34722,34723,8,1,-7
34723,34723,34724,1,2,1
34724,34724,34725,2,1,-1
34725,34725,34726,1,2,1
34726,34726,34727,2,5,3
34727,34727,34728,5,3,-2
34728,34728,34729,3,9,6
34729,34729,34730,9,0,-9
34730,34730,34731,0,0,0
34731,34731,34732,0,7,7
34732,34732,34733,7,4,-3
34733,34733,34734,4,8,4
34734,34734,34735,8,4,-4
34735,34735,34736,4,3,-1
34736,34736,34737,3,0,-3
34737,34737,34738,0,8,8
34738,34738,34739,8,9,1
34739,34739,34740,9,3,-6
34740,34740,34741,3,6,3
34741,34741,34742,6,4,-2
34742,34742,34743,4,9,5
34743,34743,34744,9,4,-5
34744,34744,34745,4,2,-2
34745,34745,34746,2,2,0
34746,34746,34747,2,2,0
34747,34747,34748,2,6,4
34748,34748,34749,6,1,-5
34749,34749,34750,1,4,3
34750,34750,34751,4,7,3
34751,34751,34752,7,4,-3
34752,34752,34753,4,9,5
34753,34753,34754,9,1,-8
34754,34754,34755,1,5,4
34755,34755,34756,5,4,-1
34756,34756,34757,4,1,-3
34757,34757,34758,1,8,7
34758,34758,34759,8,1,-7
34759,34759,34760,1,5,4
34760,34760,34761,5,9,4
34761,34761,34762,9,1,-8
34762,34762,34763,1,8,7
34763,34763,34764,8,9,1
34764,34764,34765,9,6,-3
34765,34765,34766,6,8,2
34766,34766,34767,8,6,-2
34767,34767,34768,6,2,-4
34768,34768,34769,2,9,7
34769,34769,34770,9,8,-1
34770,34770,34771,8,0,-8
34771,34771,34772,0,7,7
34772,34772,34773,7,0,-7
34773,34773,34774,0,7,7
34774,34774,34775,7,0,-7
34775,34775,34776,0,6,6
34776,34776,34777,6,1,-5
34777,34777,34778,1,1,0
34778,34778,34779,1,8,7
34779,34779,34780,8,4,-4
34780,34780,34781,4,4,0
34781,34781,34782,4,1,-3
34782,34782,34783,1,6,5
34783,34783,34784,6,4,-2
34784,34784,34785,4,8,4
34785,34785,34786,8,9,1
34786,34786,34787,9,8,-1
34787,34787,34788,8,3,-5
34788,34788,34789,3,2,-1
34789,34789,34790,2,9,7
34790,34790,34791,9,6,-3
34791,34791,34792,6,1,-5
34792,34792,34793,1,3,2
34793,34793,34794,3,8,5
34794,34794,34795,8,2,-6
34795,34795,34796,2,1,-1
34796,34796,34797,1,9,8
34797,34797,34798,9,0,-9
34798,34798,34799,0,2,2
34799,34799,34800,2,5,3
34800,34800,34801,5,9,4
34801,34801,34802,9,3,-6
34802,34802,34803,3,0,-3
34803,34803,34804,0,8,8
34804,34804,34805,8,3,-5
34805,34805,34806,3,5,2
34806,34806,34807,5,7,2
34807,34807,34808,7,4,-3
34808,34808,34809,4,4,0
34809,34809,34810,4,4,0
34810,34810,34811,4,5,1
34811,34811,34812,5,6,1
34812,34812,34813,6,8,2
34813,34813,34814,8,8,0
34814,34814,34815,8,3,-5
34815,34815,34816,3,6,3
34816,34816,34817,6,5,-1
34817,34817,34818,5,9,4
34818,34818,34819,9,8,-1
34819,34819,34820,8,8,0
34820,34820,34821,8,5,-3
34821,34821,34822,5,9,4
34822,34822,34823,9,4,-5
34823,34823,34824,4,9,5
34824,34824,34825,9,7,-2
34825,34825,34826,7,1,-6
34826,34826,34827,1,6,5
34827,34827,34828,6,3,-3
34828,34828,34829,3,5,2
34829,34829,34830,5,4,-1
34830,34830,34831,4,2,-2
34831,34831,34832,2,3,1
34832,34832,34833,3,2,-1
34833,34833,34834,2,9,7
34834,34834,34835,9,7,-2
34835,34835,34836,7,5,-2
34836,34836,34837,5,7,2
34837,34837,34838,7,9,2
34838,34838,34839,9,0,-9
34839,34839,34840,0,6,6
34840,34840,34841,6,5,-1
34841,34841,34842,5,8,3
34842,34842,34843,8,5,-3
34843,34843,34844,5,9,4
34844,34844,34845,9,3,-6
34845,34845,34846,3,3,0
34846,34846,34847,3,0,-3
34847,34847,34848,0,2,2
34848,34848,34849,2,1,-1
34849,34849,34850,1,2,1
34850,34850,34851,2,2,0
34851,34851,34852,2,1,-1
34852,34852,34853,1,3,2
34853,34853,34854,3,0,-3
34854,34854,34855,0,4,4
34855,34855,34856,4,2,-2
34856,34856,34857,2,5,3
34857,34857,34858,5,5,0
34858,34858,34859,5,6,1
34859,34859,34860,6,4,-2
34860,34860,34861,4,7,3
34861,34861,34862,7,3,-4
34862,34862,34863,3,8,5
34863,34863,34864,8,2,-6
34864,34864,34865,2,9,7
34865,34865,34866,9,3,-6
34866,34866,34867,3,0,-3
34867,34867,34868,0,5,5
34868,34868,34869,5,1,-4
34869,34869,34870,1,8,7
34870,34870,34871,8,2,-6
34871,34871,34872,2,8,6
34872,34872,34873,8,3,-5
34873,34873,34874,3,1,-2
34874,34874,34875,1,4,3
34875,34875,34876,4,9,5
34876,34876,34877,9,5,-4
34877,34877,34878,5,9,4
34878,34878,34879,9,6,-3
34879,34879,34880,6,7,1
34880,34880,34881,7,7,0
34881,34881,34882,7,5,-2
34882,34882,34883,5,8,3
34883,34883,34884,8,1,-7
34884,34884,34885,1,9,8
34885,34885,34886,9,9,0
34886,34886,34887,9,0,-9
34887,34887,34888,0,5,5
34888,34888,34889,5,1,-4
34889,34889,34890,1,7,6
34890,34890,34891,7,2,-5
34891,34891,34892,2,9,7
34892,34892,34893,9,3,-6
34893,34893,34894,3,6,3
34894,34894,34895,6,4,-2
34895,34895,34896,4,6,2
34896,34896,34897,6,6,0
34897,34897,34898,6,3,-3
34898,34898,34899,3,7,4
34899,34899,34900,7,8,1
34900,34900,34901,8,8,0
34901,34901,34902,8,2,-6
34902,34902,34903,2,9,7
34903,34903,34904,9,0,-9
34904,34904,34905,0,6,6
34905,34905,34906,6,3,-3
34906,34906,34907,3,2,-1
34907,34907,34908,2,5,3
34908,34908,34909,5,7,2
34909,34909,34910,7,8,1
34910,34910,34911,8,1,-7
34911,34911,34912,1,8,7
34912,34912,34913,8,5,-3
34913,34913,34914,5,7,2
34914,34914,34915,7,6,-1
34915,34915,34916,6,7,1
34916,34916,34917,7,2,-5
34917,34917,34918,2,6,4
34918,34918,34919,6,0,-6
34919,34919,34920,0,9,9
34920,34920,34921,9,8,-1
34921,34921,34922,8,1,-7
34922,34922,34923,1,1,0
34923,34923,34924,1,6,5
34924,34924,34925,6,7,1
34925,34925,34926,7,1,-6
34926,34926,34927,1,1,0
34927,34927,34928,1,2,1
34928,34928,34929,2,8,6
34929,34929,34930,8,9,1
34930,34930,34931,9,3,-6
34931,34931,34932,3,5,2
34932,34932,34933,5,8,3
34933,34933,34934,8,7,-1
34934,34934,34935,7,7,0
34935,34935,34936,7,2,-5
34936,34936,34937,2,1,-1
34937,34937,34938,1,1,0
34938,34938,34939,1,7,6
34939,34939,34940,7,9,2
34940,34940,34941,9,7,-2
34941,34941,34942,7,9,2
34942,34942,34943,9,0,-9
34943,34943,34944,0,2,2
34944,34944,34945,2,1,-1
34945,34945,34946,1,8,7
34946,34946,34947,8,4,-4
34947,34947,34948,4,4,0
34948,34948,34949,4,4,0
34949,34949,34950,4,1,-3
34950,34950,34951,1,7,6
34951,34951,34952,7,5,-2
34952,34952,34953,5,4,-1
34953,34953,34954,4,9,5
34954,34954,34955,9,4,-5
34955,34955,34956,4,6,2
34956,34956,34957,6,9,3
34957,34957,34958,9,0,-9
34958,34958,34959,0,7,7
34959,34959,34960,7,6,-1
34960,34960,34961,6,2,-4
34961,34961,34962,2,9,7
34962,34962,34963,9,6,-3
34963,34963,34964,6,2,-4
34964,34964,34965,2,5,3
34965,34965,34966,5,8,3
34966,34966,34967,8,3,-5
34967,34967,34968,3,8,5
34968,34968,34969,8,9,1
34969,34969,34970,9,7,-2
34970,34970,34971,7,4,-3
34971,34971,34972,4,7,3
34972,34972,34973,7,3,-4
34973,34973,34974,3,8,5
34974,34974,34975,8,9,1
34975,34975,34976,9,2,-7
34976,34976,34977,2,0,-2
34977,34977,34978,0,8,8
34978,34978,34979,8,8,0
34979,34979,34980,8,1,-7
34980,34980,34981,1,7,6
34981,34981,34982,7,7,0
34982,34982,34983,7,9,2
34983,34983,34984,9,5,-4
34984,34984,34985,5,0,-5
34985,34985,34986,0,8,8
34986,34986,34987,8,3,-5
34987,34987,34988,3,4,1
34988,34988,34989,4,0,-4
34989,34989,34990,0,1,1
34990,34990,34991,1,4,3
34991,34991,34992,4,1,-3
34992,34992,34993,1,6,5
34993,34993,34994,6,4,-2
34994,34994,34995,4,3,-1
34995,34995,34996,3,5,2
34996,34996,34997,5,7,2
34997,34997,34998,7,7,0
34998,34998,34999,7,0,-7
34999,34999,35000,0,1,1
35000,35000,35001,1,1,0
35001,35001,35002,1,9,8
35002,35002,35003,9,4,-5
35003,35003,35004,4,9,5
35004,35004,35005,9,8,-1
35005,35005,35006,8,1,-7
35006,35006,35007,1,8,7
35007,35007,35008,8,1,-7
35008,35008,35009,1,1,0
35009,35009,35010,1,3,2
35010,35010,35011,3,2,-1
35011,35011,35012,2,0,-2
35012,35012,35013,0,9,9
35013,35013,35014,9,2,-7
35014,35014,35015,2,3,1
35015,35015,35016,3,9,6
35016,35016,35017,9,8,-1
35017,35017,35018,8,8,0
35018,35018,35019,8,9,1
35019,35019,35020,9,2,-7
35020,35020,35021,2,8,6
35021,35021,35022,8,3,-5
35022,35022,35023,3,2,-1
35023,35023,35024,2,9,7
35024,35024,35025,9,8,-1
35025,35025,35026,8,6,-2
35026,35026,35027,6,6,0
35027,35027,35028,6,0,-6
35028,35028,35029,0,5,5
35029,35029,35030,5,3,-2
35030,35030,35031,3,2,-1
35031,35031,35032,2,7,5
35032,35032,35033,7,6,-1
35033,35033,35034,6,6,0
35034,35034,35035,6,2,-4
35035,35035,35036,2,8,6
35036,35036,35037,8,6,-2
35037,35037,35038,6,8,2
35038,35038,35039,8,0,-8
35039,35039,35040,0,5,5
35040,35040,35041,5,5,0
35041,35041,35042,5,8,3
35042,35042,35043,8,3,-5
35043,35043,35044,3,8,5
35044,35044,35045,8,3,-5
35045,35045,35046,3,5,2
35046,35046,35047,5,6,1
35047,35047,35048,6,1,-5
35048,35048,35049,1,3,2
35049,35049,35050,3,0,-3
35050,35050,35051,0,2,2
35051,35051,35052,2,1,-1
35052,35052,35053,1,7,6
35053,35053,35054,7,9,2
35054,35054,35055,9,6,-3
35055,35055,35056,6,0,-6
35056,35056,35057,0,5,5
35057,35057,35058,5,3,-2
35058,35058,35059,3,9,6
35059,35059,35060,9,0,-9
35060,35060,35061,0,8,8
35061,35061,35062,8,5,-3
35062,35062,35063,5,0,-5
35063,35063,35064,0,0,0
35064,35064,35065,0,9,9
35065,35065,35066,9,3,-6
35066,35066,35067,3,0,-3
35067,35067,35068,0,9,9
35068,35068,35069,9,1,-8
35069,35069,35070,1,9,8
35070,35070,35071,9,2,-7
35071,35071,35072,2,8,6
35072,35072,35073,8,3,-5
35073,35073,35074,3,0,-3
35074,35074,35075,0,4,4
35075,35075,35076,4,2,-2
35076,35076,35077,2,5,3
35077,35077,35078,5,4,-1
35078,35078,35079,4,6,2
35079,35079,35080,6,9,3
35080,35080,35081,9,7,-2
35081,35081,35082,7,5,-2
35082,35082,35083,5,8,3
35083,35083,35084,8,9,1
35084,35084,35085,9,9,0
35085,35085,35086,9,3,-6
35086,35086,35087,3,0,-3
35087,35087,35088,0,8,8
35088,35088,35089,8,1,-7
35089,35089,35090,1,2,1
35090,35090,35091,2,2,0
35091,35091,35092,2,2,0
35092,35092,35093,2,3,1
35093,35093,35094,3,1,-2
35094,35094,35095,1,4,3
35095,35095,35096,4,8,4
35096,35096,35097,8,5,-3
35097,35097,35098,5,4,-1
35098,35098,35099,4,6,2
35099,35099,35100,6,5,-1
35100,35100,35101,5,7,2
35101,35101,35102,7,7,0
35102,35102,35103,7,8,1
35103,35103,35104,8,2,-6
35104,35104,35105,2,9,7
35105,35105,35106,9,2,-7
35106,35106,35107,2,0,-2
35107,35107,35108,0,1,1
35108,35108,35109,1,1,0
35109,35109,35110,1,2,1
35110,35110,35111,2,2,0
35111,35111,35112,2,2,0
35112,35112,35113,2,3,1
35113,35113,35114,3,5,2
35114,35114,35115,5,4,-1
35115,35115,35116,4,1,-3
35116,35116,35117,1,5,4
35117,35117,35118,5,9,4
35118,35118,35119,9,6,-3
35119,35119,35120,6,8,2
35120,35120,35121,8,7,-1
35121,35121,35122,7,3,-4
35122,35122,35123,3,8,5
35123,35123,35124,8,2,-6
35124,35124,35125,2,9,7
35125,35125,35126,9,4,-5
35126,35126,35127,4,9,5
35127,35127,35128,9,2,-7
35128,35128,35129,2,8,6
35129,35129,35130,8,7,-1
35130,35130,35131,7,6,-1
35131,35131,35132,6,3,-3
35132,35132,35133,3,5,2
35133,35133,35134,5,2,-3
35134,35134,35135,2,9,7
35135,35135,35136,9,4,-5
35136,35136,35137,4,2,-2
35137,35137,35138,2,2,0
35138,35138,35139,2,3,1
35139,35139,35140,3,6,3
35140,35140,35141,6,4,-2
35141,35141,35142,4,4,0
35142,35142,35143,4,3,-1
35143,35143,35144,3,4,1
35144,35144,35145,4,8,4
35145,35145,35146,8,6,-2
35146,35146,35147,6,5,-1
35147,35147,35148,5,0,-5
35148,35148,35149,0,1,1
35149,35149,35150,1,7,6
35150,35150,35151,7,5,-2
35151,35151,35152,5,4,-1
35152,35152,35153,4,2,-2
35153,35153,35154,2,6,4
35154,35154,35155,6,3,-3
35155,35155,35156,3,3,0
35156,35156,35157,3,0,-3
35157,35157,35158,0,6,6
35158,35158,35159,6,1,-5
35159,35159,35160,1,9,8
35160,35160,35161,9,2,-7
35161,35161,35162,2,3,1
35162,35162,35163,3,1,-2
35163,35163,35164,1,5,4
35164,35164,35165,5,3,-2
35165,35165,35166,3,4,1
35166,35166,35167,4,2,-2
35167,35167,35168,2,1,-1
35168,35168,35169,1,6,5
35169,35169,35170,6,3,-3
35170,35170,35171,3,5,2
35171,35171,35172,5,5,0
35172,35172,35173,5,3,-2
35173,35173,35174,3,9,6
35174,35174,35175,9,0,-9
35175,35175,35176,0,7,7
35176,35176,35177,7,7,0
35177,35177,35178,7,4,-3
35178,35178,35179,4,4,0
35179,35179,35180,4,3,-1
35180,35180,35181,3,6,3
35181,35181,35182,6,9,3
35182,35182,35183,9,4,-5
35183,35183,35184,4,6,2
35184,35184,35185,6,0,-6
35185,35185,35186,0,4,4
35186,35186,35187,4,5,1
35187,35187,35188,5,9,4
35188,35188,35189,9,9,0
35189,35189,35190,9,3,-6
35190,35190,35191,3,9,6
35191,35191,35192,9,0,-9
35192,35192,35193,0,8,8
35193,35193,35194,8,9,1
35194,35194,35195,9,3,-6
35195,35195,35196,3,7,4
35196,35196,35197,7,1,-6
35197,35197,35198,1,2,1
35198,35198,35199,2,7,5
35199,35199,35200,7,6,-1
35200,35200,35201,6,4,-2
35201,35201,35202,4,2,-2
35202,35202,35203,2,7,5
35203,35203,35204,7,6,-1
35204,35204,35205,6,6,0
35205,35205,35206,6,6,0
35206,35206,35207,6,5,-1
35207,35207,35208,5,3,-2
35208,35208,35209,3,0,-3
35209,35209,35210,0,6,6
35210,35210,35211,6,6,0
35211,35211,35212,6,1,-5
35212,35212,35213,1,6,5
35213,35213,35214,6,5,-1
35214,35214,35215,5,2,-3
35215,35215,35216,2,2,0
35216,35216,35217,2,0,-2
35217,35217,35218,0,9,9
35218,35218,35219,9,6,-3
35219,35219,35220,6,2,-4
35220,35220,35221,2,3,1
35221,35221,35222,3,6,3
35222,35222,35223,6,7,1
35223,35223,35224,7,5,-2
35224,35224,35225,5,7,2
35225,35225,35226,7,3,-4
35226,35226,35227,3,4,1
35227,35227,35228,4,5,1
35228,35228,35229,5,4,-1
35229,35229,35230,4,8,4
35230,35230,35231,8,3,-5
35231,35231,35232,3,8,5
35232,35232,35233,8,9,1
35233,35233,35234,9,4,-5
35234,35234,35235,4,2,-2
35235,35235,35236,2,1,-1
35236,35236,35237,1,8,7
35237,35237,35238,8,6,-2
35238,35238,35239,6,9,3
35239,35239,35240,9,2,-7
35240,35240,35241,2,6,4
35241,35241,35242,6,8,2
35242,35242,35243,8,0,-8
35243,35243,35244,0,1,1
35244,35244,35245,1,9,8
35245,35245,35246,9,8,-1
35246,35246,35247,8,5,-3
35247,35247,35248,5,3,-2
35248,35248,35249,3,3,0
35249,35249,35250,3,2,-1
35250,35250,35251,2,8,6
35251,35251,35252,8,1,-7
35252,35252,35253,1,8,7
35253,35253,35254,8,4,-4
35254,35254,35255,4,7,3
35255,35255,35256,7,4,-3
35256,35256,35257,4,1,-3
35257,35257,35258,1,4,3
35258,35258,35259,4,4,0
35259,35259,35260,4,7,3
35260,35260,35261,7,0,-7
35261,35261,35262,0,0,0
35262,35262,35263,0,4,4
35263,35263,35264,4,8,4
35264,35264,35265,8,8,0
35265,35265,35266,8,1,-7
35266,35266,35267,1,5,4
35267,35267,35268,5,5,0
35268,35268,35269,5,2,-3
35269,35269,35270,2,1,-1
35270,35270,35271,1,3,2
35271,35271,35272,3,3,0
35272,35272,35273,3,9,6
35273,35273,35274,9,5,-4
35274,35274,35275,5,0,-5
35275,35275,35276,0,5,5
35276,35276,35277,5,7,2
35277,35277,35278,7,1,-6
35278,35278,35279,1,2,1
35279,35279,35280,2,6,4
35280,35280,35281,6,1,-5
35281,35281,35282,1,0,-1
35282,35282,35283,0,9,9
35283,35283,35284,9,6,-3
35284,35284,35285,6,1,-5
35285,35285,35286,1,1,0
35286,35286,35287,1,5,4
35287,35287,35288,5,2,-3
35288,35288,35289,2,1,-1
35289,35289,35290,1,2,1
35290,35290,35291,2,7,5
35291,35291,35292,7,9,2
35292,35292,35293,9,4,-5
35293,35293,35294,4,0,-4
35294,35294,35295,0,8,8
35295,35295,35296,8,9,1
35296,35296,35297,9,6,-3
35297,35297,35298,6,2,-4
35298,35298,35299,2,1,-1
35299,35299,35300,1,8,7
35300,35300,35301,8,2,-6
35301,35301,35302,2,0,-2
35302,35302,35303,0,1,1
35303,35303,35304,1,4,3
35304,35304,35305,4,6,2
35305,35305,35306,6,7,1
35306,35306,35307,7,8,1
35307,35307,35308,8,8,0
35308,35308,35309,8,8,0
35309,35309,35310,8,5,-3
35310,35310,35311,5,0,-5
35311,35311,35312,0,4,4
35312,35312,35313,4,1,-3
35313,35313,35314,1,4,3
35314,35314,35315,4,2,-2
35315,35315,35316,2,7,5
35316,35316,35317,7,3,-4
35317,35317,35318,3,6,3
35318,35318,35319,6,4,-2
35319,35319,35320,4,0,-4
35320,35320,35321,0,7,7
35321,35321,35322,7,6,-1
35322,35322,35323,6,8,2
35323,35323,35324,8,4,-4
35324,35324,35325,4,9,5
35325,35325,35326,9,5,-4
35326,35326,35327,5,0,-5
35327,35327,35328,0,1,1
35328,35328,35329,1,1,0
35329,35329,35330,1,9,8
35330,35330,35331,9,2,-7
35331,35331,35332,2,9,7
35332,35332,35333,9,3,-6
35333,35333,35334,3,7,4
35334,35334,35335,7,4,-3
35335,35335,35336,4,3,-1
35336,35336,35337,3,7,4
35337,35337,35338,7,8,1
35338,35338,35339,8,8,0
35339,35339,35340,8,2,-6
35340,35340,35341,2,9,7
35341,35341,35342,9,6,-3
35342,35342,35343,6,0,-6
35343,35343,35344,0,2,2
35344,35344,35345,2,1,-1
35345,35345,35346,1,3,2
35346,35346,35347,3,2,-1
35347,35347,35348,2,0,-2
35348,35348,35349,0,3,3
35349,35349,35350,3,5,2
35350,35350,35351,5,7,2
35351,35351,35352,7,1,-6
35352,35352,35353,1,8,7
35353,35353,35354,8,3,-5
35354,35354,35355,3,9,6
35355,35355,35356,9,2,-7
35356,35356,35357,2,1,-1
35357,35357,35358,1,9,8
35358,35358,35359,9,1,-8
35359,35359,35360,1,1,0
35360,35360,35361,1,7,6
35361,35361,35362,7,4,-3
35362,35362,35363,4,4,0
35363,35363,35364,4,8,4
35364,35364,35365,8,8,0
35365,35365,35366,8,3,-5
35366,35366,35367,3,1,-2
35367,35367,35368,1,9,8
35368,35368,35369,9,5,-4
35369,35369,35370,5,1,-4
35370,35370,35371,1,7,6
35371,35371,35372,7,7,0
35372,35372,35373,7,2,-5
35373,35373,35374,2,9,7
35374,35374,35375,9,8,-1
35375,35375,35376,8,3,-5
35376,35376,35377,3,6,3
35377,35377,35378,6,2,-4
35378,35378,35379,2,3,1
35379,35379,35380,3,9,6
35380,35380,35381,9,3,-6
35381,35381,35382,3,7,4
35382,35382,35383,7,8,1
35383,35383,35384,8,9,1
35384,35384,35385,9,6,-3
35385,35385,35386,6,1,-5
35386,35386,35387,1,9,8
35387,35387,35388,9,5,-4
35388,35388,35389,5,1,-4
35389,35389,35390,1,5,4
35390,35390,35391,5,7,2
35391,35391,35392,7,4,-3
35392,35392,35393,4,2,-2
35393,35393,35394,2,5,3
35394,35394,35395,5,1,-4
35395,35395,35396,1,1,0
35396,35396,35397,1,5,4
35397,35397,35398,5,8,3
35398,35398,35399,8,1,-7
35399,35399,35400,1,0,-1
35400,35400,35401,0,3,3
35401,35401,35402,3,4,1
35402,35402,35403,4,2,-2
35403,35403,35404,2,1,-1
35404,35404,35405,1,2,1
35405,35405,35406,2,5,3
35406,35406,35407,5,3,-2
35407,35407,35408,3,0,-3
35408,35408,35409,0,0,0
35409,35409,35410,0,2,2
35410,35410,35411,2,6,4
35411,35411,35412,6,4,-2
35412,35412,35413,4,4,0
35413,35413,35414,4,1,-3
35414,35414,35415,1,3,2
35415,35415,35416,3,7,4
35416,35416,35417,7,7,0
35417,35417,35418,7,4,-3
35418,35418,35419,4,6,2
35419,35419,35420,6,5,-1
35420,35420,35421,5,9,4
35421,35421,35422,9,3,-6
35422,35422,35423,3,0,-3
35423,35423,35424,0,6,6
35424,35424,35425,6,4,-2
35425,35425,35426,4,6,2
35426,35426,35427,6,1,-5
35427,35427,35428,1,8,7
35428,35428,35429,8,4,-4
35429,35429,35430,4,1,-3
35430,35430,35431,1,0,-1
35431,35431,35432,0,0,0
35432,35432,35433,0,6,6
35433,35433,35434,6,3,-3
35434,35434,35435,3,1,-2
35435,35435,35436,1,1,0
35436,35436,35437,1,2,1
35437,35437,35438,2,8,6
35438,35438,35439,8,6,-2
35439,35439,35440,6,9,3
35440,35440,35441,9,9,0
35441,35441,35442,9,4,-5
35442,35442,35443,4,2,-2
35443,35443,35444,2,9,7
35444,35444,35445,9,2,-7
35445,35445,35446,2,7,5
35446,35446,35447,7,3,-4
35447,35447,35448,3,1,-2
35448,35448,35449,1,0,-1
35449,35449,35450,0,7,7
35450,35450,35451,7,7,0
35451,35451,35452,7,6,-1
35452,35452,35453,6,2,-4
35453,35453,35454,2,2,0
35454,35454,35455,2,9,7
35455,35455,35456,9,2,-7
35456,35456,35457,2,2,0
35457,35457,35458,2,3,1
35458,35458,35459,3,3,0
35459,35459,35460,3,8,5
35460,35460,35461,8,4,-4
35461,35461,35462,4,5,1
35462,35462,35463,5,0,-5
35463,35463,35464,0,9,9
35464,35464,35465,9,0,-9
35465,35465,35466,0,5,5
35466,35466,35467,5,8,3
35467,35467,35468,8,6,-2
35468,35468,35469,6,7,1
35469,35469,35470,7,6,-1
35470,35470,35471,6,8,2
35471,35471,35472,8,4,-4
35472,35472,35473,4,0,-4
35473,35473,35474,0,7,7
35474,35474,35475,7,9,2
35475,35475,35476,9,7,-2
35476,35476,35477,7,8,1
35477,35477,35478,8,2,-6
35478,35478,35479,2,9,7
35479,35479,35480,9,9,0
35480,35480,35481,9,0,-9
35481,35481,35482,0,4,4
35482,35482,35483,4,2,-2
35483,35483,35484,2,8,6
35484,35484,35485,8,0,-8
35485,35485,35486,0,3,3
35486,35486,35487,3,1,-2
35487,35487,35488,1,0,-1
35488,35488,35489,0,2,2
35489,35489,35490,2,4,2
35490,35490,35491,4,3,-1
35491,35491,35492,3,2,-1
35492,35492,35493,2,4,2
35493,35493,35494,4,2,-2
35494,35494,35495,2,5,3
35495,35495,35496,5,1,-4
35496,35496,35497,1,6,5
35497,35497,35498,6,3,-3
35498,35498,35499,3,7,4
35499,35499,35500,7,5,-2
35500,35500,35501,5,8,3
35501,35501,35502,8,0,-8
35502,35502,35503,0,9,9
35503,35503,35504,9,3,-6
35504,35504,35505,3,0,-3
35505,35505,35506,0,9,9
35506,35506,35507,9,1,-8
35507,35507,35508,1,1,0
35508,35508,35509,1,2,1
35509,35509,35510,2,2,0
35510,35510,35511,2,3,1
35511,35511,35512,3,7,4
35512,35512,35513,7,4,-3
35513,35513,35514,4,1,-3
35514,35514,35515,1,5,4
35515,35515,35516,5,0,-5
35516,35516,35517,0,6,6
35517,35517,35518,6,7,1
35518,35518,35519,7,7,0
35519,35519,35520,7,3,-4
35520,35520,35521,3,8,5
35521,35521,35522,8,3,-5
35522,35522,35523,3,9,6
35523,35523,35524,9,9,0
35524,35524,35525,9,0,-9
35525,35525,35526,0,8,8
35526,35526,35527,8,1,-7
35527,35527,35528,1,3,2
35528,35528,35529,3,2,-1
35529,35529,35530,2,3,1
35530,35530,35531,3,3,0
35531,35531,35532,3,9,6
35532,35532,35533,9,4,-5
35533,35533,35534,4,4,0
35534,35534,35535,4,5,1
35535,35535,35536,5,0,-5
35536,35536,35537,0,6,6
35537,35537,35538,6,1,-5
35538,35538,35539,1,7,6
35539,35539,35540,7,6,-1
35540,35540,35541,6,8,2
35541,35541,35542,8,3,-5
35542,35542,35543,3,9,6
35543,35543,35544,9,7,-2
35544,35544,35545,7,5,-2
35545,35545,35546,5,4,-1
35546,35546,35547,4,8,4
35547,35547,35548,8,3,-5
35548,35548,35549,3,7,4
35549,35549,35550,7,3,-4
35550,35550,35551,3,4,1
35551,35551,35552,4,1,-3
35552,35552,35553,1,7,6
35553,35553,35554,7,1,-6
35554,35554,35555,1,7,6
35555,35555,35556,7,9,2
35556,35556,35557,9,3,-6
35557,35557,35558,3,1,-2
35558,35558,35559,1,8,7
35559,35559,35560,8,7,-1
35560,35560,35561,7,8,1
35561,35561,35562,8,3,-5
35562,35562,35563,3,3,0
35563,35563,35564,3,6,3
35564,35564,35565,6,1,-5
35565,35565,35566,1,6,5
35566,35566,35567,6,5,-1
35567,35567,35568,5,3,-2
35568,35568,35569,3,8,5
35569,35569,35570,8,5,-3
35570,35570,35571,5,2,-3
35571,35571,35572,2,2,0
35572,35572,35573,2,7,5
35573,35573,35574,7,3,-4
35574,35574,35575,3,6,3
35575,35575,35576,6,8,2
35576,35576,35577,8,8,0
35577,35577,35578,8,6,-2
35578,35578,35579,6,6,0
35579,35579,35580,6,7,1
35580,35580,35581,7,4,-3
35581,35581,35582,4,3,-1
35582,35582,35583,3,4,1
35583,35583,35584,4,4,0
35584,35584,35585,4,4,0
35585,35585,35586,4,1,-3
35586,35586,35587,1,1,0
35587,35587,35588,1,6,5
35588,35588,35589,6,8,2
35589,35589,35590,8,4,-4
35590,35590,35591,4,8,4
35591,35591,35592,8,1,-7
35592,35592,35593,1,9,8
35593,35593,35594,9,7,-2
35594,35594,35595,7,1,-6
35595,35595,35596,1,1,0
35596,35596,35597,1,2,1
35597,35597,35598,2,9,7
35598,35598,35599,9,2,-7
35599,35599,35600,2,1,-1
35600,35600,35601,1,6,5
35601,35601,35602,6,5,-1
35602,35602,35603,5,9,4
35603,35603,35604,9,8,-1
35604,35604,35605,8,9,1
35605,35605,35606,9,2,-7
35606,35606,35607,2,6,4
35607,35607,35608,6,5,-1
35608,35608,35609,5,5,0
35609,35609,35610,5,3,-2
35610,35610,35611,3,5,2
35611,35611,35612,5,0,-5
35612,35612,35613,0,3,3
35613,35613,35614,3,6,3
35614,35614,35615,6,3,-3
35615,35615,35616,3,6,3
35616,35616,35617,6,8,2
35617,35617,35618,8,5,-3
35618,35618,35619,5,8,3
35619,35619,35620,8,0,-8
35620,35620,35621,0,1,1
35621,35621,35622,1,3,2
35622,35622,35623,3,9,6
35623,35623,35624,9,4,-5
35624,35624,35625,4,7,3
35625,35625,35626,7,4,-3
35626,35626,35627,4,6,2
35627,35627,35628,6,5,-1
35628,35628,35629,5,8,3
35629,35629,35630,8,2,-6
35630,35630,35631,2,3,1
35631,35631,35632,3,0,-3
35632,35632,35633,0,7,7
35633,35633,35634,7,0,-7
35634,35634,35635,0,4,4
35635,35635,35636,4,7,3
35636,35636,35637,7,7,0
35637,35637,35638,7,2,-5
35638,35638,35639,2,0,-2
35639,35639,35640,0,3,3
35640,35640,35641,3,9,6
35641,35641,35642,9,1,-8
35642,35642,35643,1,3,2
35643,35643,35644,3,2,-1
35644,35644,35645,2,7,5
35645,35645,35646,7,0,-7
35646,35646,35647,0,9,9
35647,35647,35648,9,7,-2
35648,35648,35649,7,3,-4
35649,35649,35650,3,5,2
35650,35650,35651,5,0,-5
35651,35651,35652,0,2,2
35652,35652,35653,2,2,0
35653,35653,35654,2,1,-1
35654,35654,35655,1,0,-1
35655,35655,35656,0,4,4
35656,35656,35657,4,1,-3
35657,35657,35658,1,3,2
35658,35658,35659,3,0,-3
35659,35659,35660,0,0,0
35660,35660,35661,0,1,1
35661,35661,35662,1,4,3
35662,35662,35663,4,0,-4
35663,35663,35664,0,6,6
35664,35664,35665,6,4,-2
35665,35665,35666,4,9,5
35666,35666,35667,9,0,-9
35667,35667,35668,0,7,7
35668,35668,35669,7,1,-6
35669,35669,35670,1,2,1
35670,35670,35671,2,0,-2
35671,35671,35672,0,9,9
35672,35672,35673,9,4,-5
35673,35673,35674,4,5,1
35674,35674,35675,5,7,2
35675,35675,35676,7,9,2
35676,35676,35677,9,9,0
35677,35677,35678,9,2,-7
35678,35678,35679,2,2,0
35679,35679,35680,2,0,-2
35680,35680,35681,0,0,0
35681,35681,35682,0,6,6
35682,35682,35683,6,6,0
35683,35683,35684,6,6,0
35684,35684,35685,6,2,-4
35685,35685,35686,2,4,2
35686,35686,35687,4,6,2
35687,35687,35688,6,3,-3
35688,35688,35689,3,2,-1
35689,35689,35690,2,2,0
35690,35690,35691,2,2,0
35691,35691,35692,2,3,1
35692,35692,35693,3,9,6
35693,35693,35694,9,9,0
35694,35694,35695,9,9,0
35695,35695,35696,9,7,-2
35696,35696,35697,7,0,-7
35697,35697,35698,0,1,1
35698,35698,35699,1,1,0
35699,35699,35700,1,0,-1
35700,35700,35701,0,2,2
35701,35701,35702,2,5,3
35702,35702,35703,5,3,-2
35703,35703,35704,3,8,5
35704,35704,35705,8,4,-4
35705,35705,35706,4,8,4
35706,35706,35707,8,5,-3
35707,35707,35708,5,0,-5
35708,35708,35709,0,6,6
35709,35709,35710,6,1,-5
35710,35710,35711,1,7,6
35711,35711,35712,7,0,-7
35712,35712,35713,0,8,8
35713,35713,35714,8,6,-2
35714,35714,35715,6,9,3
35715,35715,35716,9,4,-5
35716,35716,35717,4,0,-4
35717,35717,35718,0,6,6
35718,35718,35719,6,1,-5
35719,35719,35720,1,0,-1
35720,35720,35721,0,2,2
35721,35721,35722,2,1,-1
35722,35722,35723,1,3,2
35723,35723,35724,3,9,6
35724,35724,35725,9,4,-5
35725,35725,35726,4,6,2
35726,35726,35727,6,5,-1
35727,35727,35728,5,7,2
35728,35728,35729,7,6,-1
35729,35729,35730,6,8,2
35730,35730,35731,8,7,-1
35731,35731,35732,7,9,2
35732,35732,35733,9,8,-1
35733,35733,35734,8,6,-2
35734,35734,35735,6,9,3
35735,35735,35736,9,6,-3
35736,35736,35737,6,1,-5
35737,35737,35738,1,5,4
35738,35738,35739,5,0,-5
35739,35739,35740,0,0,0
35740,35740,35741,0,9,9
35741,35741,35742,9,0,-9
35742,35742,35743,0,5,5
35743,35743,35744,5,3,-2
35744,35744,35745,3,7,4
35745,35745,35746,7,0,-7
35746,35746,35747,0,5,5
35747,35747,35748,5,4,-1
35748,35748,35749,4,1,-3
35749,35749,35750,1,6,5
35750,35750,35751,6,8,2
35751,35751,35752,8,4,-4
35752,35752,35753,4,6,2
35753,35753,35754,6,7,1
35754,35754,35755,7,9,2
35755,35755,35756,9,1,-8
35756,35756,35757,1,0,-1
35757,35757,35758,0,2,2
35758,35758,35759,2,4,2
35759,35759,35760,4,9,5
35760,35760,35761,9,1,-8
35761,35761,35762,1,8,7
35762,35762,35763,8,9,1
35763,35763,35764,9,8,-1
35764,35764,35765,8,3,-5
35765,35765,35766,3,5,2
35766,35766,35767,5,8,3
35767,35767,35768,8,6,-2
35768,35768,35769,6,4,-2
35769,35769,35770,4,2,-2
35770,35770,35771,2,4,2
35771,35771,35772,4,8,4
35772,35772,35773,8,7,-1
35773,35773,35774,7,1,-6
35774,35774,35775,1,0,-1
35775,35775,35776,0,8,8
35776,35776,35777,8,1,-7
35777,35777,35778,1,0,-1
35778,35778,35779,0,2,2
35779,35779,35780,2,4,2
35780,35780,35781,4,7,3
35781,35781,35782,7,0,-7
35782,35782,35783,0,8,8
35783,35783,35784,8,5,-3
35784,35784,35785,5,2,-3
35785,35785,35786,2,9,7
35786,35786,35787,9,5,-4
35787,35787,35788,5,8,3
35788,35788,35789,8,9,1
35789,35789,35790,9,7,-2
35790,35790,35791,7,6,-1
35791,35791,35792,6,1,-5
35792,35792,35793,1,0,-1
35793,35793,35794,0,3,3
35794,35794,35795,3,6,3
35795,35795,35796,6,3,-3
35796,35796,35797,3,5,2
35797,35797,35798,5,1,-4
35798,35798,35799,1,5,4
35799,35799,35800,5,0,-5
35800,35800,35801,0,3,3
35801,35801,35802,3,2,-1
35802,35802,35803,2,3,1
35803,35803,35804,3,9,6
35804,35804,35805,9,3,-6
35805,35805,35806,3,3,0
35806,35806,35807,3,9,6
35807,35807,35808,9,6,-3
35808,35808,35809,6,8,2
35809,35809,35810,8,6,-2
35810,35810,35811,6,1,-5
35811,35811,35812,1,9,8
35812,35812,35813,9,4,-5
35813,35813,35814,4,3,-1
35814,35814,35815,3,0,-3
35815,35815,35816,0,0,0
35816,35816,35817,0,6,6
35817,35817,35818,6,4,-2
35818,35818,35819,4,1,-3
35819,35819,35820,1,1,0
35820,35820,35821,1,0,-1
35821,35821,35822,0,4,4
35822,35822,35823,4,0,-4
35823,35823,35824,0,9,9
35824,35824,35825,9,6,-3
35825,35825,35826,6,1,-5
35826,35826,35827,1,2,1
35827,35827,35828,2,6,4
35828,35828,35829,6,1,-5
35829,35829,35830,1,4,3
35830,35830,35831,4,1,-3
35831,35831,35832,1,2,1
35832,35832,35833,2,3,1
35833,35833,35834,3,7,4
35834,35834,35835,7,2,-5
35835,35835,35836,2,9,7
35836,35836,35837,9,7,-2
35837,35837,35838,7,5,-2
35838,35838,35839,5,7,2
35839,35839,35840,7,4,-3
35840,35840,35841,4,8,4
35841,35841,35842,8,7,-1
35842,35842,35843,7,8,1
35843,35843,35844,8,6,-2
35844,35844,35845,6,7,1
35845,35845,35846,7,6,-1
35846,35846,35847,6,8,2
35847,35847,35848,8,8,0
35848,35848,35849,8,4,-4
35849,35849,35850,4,2,-2
35850,35850,35851,2,6,4
35851,35851,35852,6,4,-2
35852,35852,35853,4,0,-4
35853,35853,35854,0,9,9
35854,35854,35855,9,7,-2
35855,35855,35856,7,1,-6
35856,35856,35857,1,0,-1
35857,35857,35858,0,5,5
35858,35858,35859,5,3,-2
35859,35859,35860,3,7,4
35860,35860,35861,7,6,-1
35861,35861,35862,6,1,-5
35862,35862,35863,1,7,6
35863,35863,35864,7,5,-2
35864,35864,35865,5,1,-4
35865,35865,35866,1,4,3
35866,35866,35867,4,5,1
35867,35867,35868,5,6,1
35868,35868,35869,6,3,-3
35869,35869,35870,3,3,0
35870,35870,35871,3,7,4
35871,35871,35872,7,2,-5
35872,35872,35873,2,2,0
35873,35873,35874,2,3,1
35874,35874,35875,3,4,1
35875,35875,35876,4,3,-1
35876,35876,35877,3,9,6
35877,35877,35878,9,9,0
35878,35878,35879,9,4,-5
35879,35879,35880,4,1,-3
35880,35880,35881,1,3,2
35881,35881,35882,3,2,-1
35882,35882,35883,2,6,4
35883,35883,35884,6,4,-2
35884,35884,35885,4,2,-2
35885,35885,35886,2,6,4
35886,35886,35887,6,2,-4
35887,35887,35888,2,6,4
35888,35888,35889,6,5,-1
35889,35889,35890,5,3,-2
35890,35890,35891,3,3,0
35891,35891,35892,3,9,6
35892,35892,35893,9,9,0
35893,35893,35894,9,9,0
35894,35894,35895,9,4,-5
35895,35895,35896,4,0,-4
35896,35896,35897,0,1,1
35897,35897,35898,1,3,2
35898,35898,35899,3,7,4
35899,35899,35900,7,1,-6
35900,35900,35901,1,2,1
35901,35901,35902,2,2,0
35902,35902,35903,2,5,3
35903,35903,35904,5,4,-1
35904,35904,35905,4,0,-4
35905,35905,35906,0,5,5
35906,35906,35907,5,1,-4
35907,35907,35908,1,1,0
35908,35908,35909,1,2,1
35909,35909,35910,2,6,4
35910,35910,35911,6,3,-3
35911,35911,35912,3,1,-2
35912,35912,35913,1,4,3
35913,35913,35914,4,3,-1
35914,35914,35915,3,5,2
35915,35915,35916,5,8,3
35916,35916,35917,8,6,-2
35917,35917,35918,6,6,0
35918,35918,35919,6,7,1
35919,35919,35920,7,7,0
35920,35920,35921,7,8,1
35921,35921,35922,8,3,-5
35922,35922,35923,3,0,-3
35923,35923,35924,0,8,8
35924,35924,35925,8,1,-7
35925,35925,35926,1,4,3
35926,35926,35927,4,2,-2
35927,35927,35928,2,8,6
35928,35928,35929,8,3,-5
35929,35929,35930,3,2,-1
35930,35930,35931,2,4,2
35931,35931,35932,4,8,4
35932,35932,35933,8,5,-3
35933,35933,35934,5,0,-5
35934,35934,35935,0,6,6
35935,35935,35936,6,0,-6
35936,35936,35937,0,7,7
35937,35937,35938,7,7,0
35938,35938,35939,7,8,1
35939,35939,35940,8,8,0
35940,35940,35941,8,9,1
35941,35941,35942,9,1,-8
35942,35942,35943,1,0,-1
35943,35943,35944,0,3,3
35944,35944,35945,3,1,-2
35945,35945,35946,1,4,3
35946,35946,35947,4,2,-2
35947,35947,35948,2,6,4
35948,35948,35949,6,3,-3
35949,35949,35950,3,8,5
35950,35950,35951,8,4,-4
35951,35951,35952,4,4,0
35952,35952,35953,4,5,1
35953,35953,35954,5,3,-2
35954,35954,35955,3,6,3
35955,35955,35956,6,9,3
35956,35956,35957,9,7,-2
35957,35957,35958,7,8,1
35958,35958,35959,8,0,-8
35959,35959,35960,0,7,7
35960,35960,35961,7,7,0
35961,35961,35962,7,6,-1
35962,35962,35963,6,0,-6
35963,35963,35964,0,4,4
35964,35964,35965,4,7,3
35965,35965,35966,7,4,-3
35966,35966,35967,4,8,4
35967,35967,35968,8,6,-2
35968,35968,35969,6,3,-3
35969,35969,35970,3,2,-1
35970,35970,35971,2,0,-2
35971,35971,35972,0,0,0
35972,35972,35973,0,0,0
35973,35973,35974,0,2,2
35974,35974,35975,2,5,3
35975,35975,35976,5,5,0
35976,35976,35977,5,5,0
35977,35977,35978,5,7,2
35978,35978,35979,7,3,-4
35979,35979,35980,3,7,4
35980,35980,35981,7,8,1
35981,35981,35982,8,0,-8
35982,35982,35983,0,8,8
35983,35983,35984,8,3,-5
35984,35984,35985,3,1,-2
35985,35985,35986,1,3,2
35986,35986,35987,3,8,5
35987,35987,35988,8,6,-2
35988,35988,35989,6,4,-2
35989,35989,35990,4,1,-3
35990,35990,35991,1,9,8
35991,35991,35992,9,2,-7
35992,35992,35993,2,6,4
35993,35993,35994,6,0,-6
35994,35994,35995,0,1,1
35995,35995,35996,1,9,8
35996,35996,35997,9,8,-1
35997,35997,35998,8,7,-1
35998,35998,35999,7,0,-7
35999,35999,36000,0,9,9
36000,36000,36001,9,2,-7
36001,36001,36002,2,6,4
36002,36002,36003,6,7,1
36003,36003,36004,7,9,2
36004,36004,36005,9,3,-6
36005,36005,36006,3,2,-1
36006,36006,36007,2,9,7
36007,36007,36008,9,8,-1
36008,36008,36009,8,2,-6
36009,36009,36010,2,8,6
36010,36010,36011,8,5,-3
36011,36011,36012,5,7,2
36012,36012,36013,7,9,2
36013,36013,36014,9,6,-3
36014,36014,36015,6,5,-1
36015,36015,36016,5,2,-3
36016,36016,36017,2,4,2
36017,36017,36018,4,3,-1
36018,36018,36019,3,0,-3
36019,36019,36020,0,8,8
36020,36020,36021,8,3,-5
36021,36021,36022,3,0,-3
36022,36022,36023,0,3,3
36023,36023,36024,3,9,6
36024,36024,36025,9,4,-5
36025,36025,36026,4,5,1
36026,36026,36027,5,7,2
36027,36027,36028,7,5,-2
36028,36028,36029,5,9,4
36029,36029,36030,9,1,-8
36030,36030,36031,1,0,-1
36031,36031,36032,0,3,3
36032,36032,36033,3,1,-2
36033,36033,36034,1,8,7
36034,36034,36035,8,9,1
36035,36035,36036,9,6,-3
36036,36036,36037,6,1,-5
36037,36037,36038,1,6,5
36038,36038,36039,6,2,-4
36039,36039,36040,2,0,-2
36040,36040,36041,0,7,7
36041,36041,36042,7,1,-6
36042,36042,36043,1,9,8
36043,36043,36044,9,9,0
36044,36044,36045,9,1,-8
36045,36045,36046,1,3,2
36046,36046,36047,3,0,-3
36047,36047,36048,0,3,3
36048,36048,36049,3,6,3
36049,36049,36050,6,9,3
36050,36050,36051,9,2,-7
36051,36051,36052,2,7,5
36052,36052,36053,7,4,-3
36053,36053,36054,4,8,4
36054,36054,36055,8,0,-8
36055,36055,36056,0,2,2
36056,36056,36057,2,3,1
36057,36057,36058,3,9,6
36058,36058,36059,9,5,-4
36059,36059,36060,5,5,0
36060,36060,36061,5,6,1
36061,36061,36062,6,9,3
36062,36062,36063,9,6,-3
36063,36063,36064,6,2,-4
36064,36064,36065,2,5,3
36065,36065,36066,5,8,3
36066,36066,36067,8,6,-2
36067,36067,36068,6,6,0
36068,36068,36069,6,7,1
36069,36069,36070,7,6,-1
36070,36070,36071,6,1,-5
36071,36071,36072,1,2,1
36072,36072,36073,2,4,2
36073,36073,36074,4,9,5
36074,36074,36075,9,4,-5
36075,36075,36076,4,3,-1
36076,36076,36077,3,2,-1
36077,36077,36078,2,3,1
36078,36078,36079,3,6,3
36079,36079,36080,6,9,3
36080,36080,36081,9,2,-7
36081,36081,36082,2,3,1
36082,36082,36083,3,9,6
36083,36083,36084,9,0,-9
36084,36084,36085,0,1,1
36085,36085,36086,1,5,4
36086,36086,36087,5,5,0
36087,36087,36088,5,7,2
36088,36088,36089,7,5,-2
36089,36089,36090,5,0,-5
36090,36090,36091,0,5,5
36091,36091,36092,5,4,-1
36092,36092,36093,4,3,-1
36093,36093,36094,3,1,-2
36094,36094,36095,1,1,0
36095,36095,36096,1,8,7
36096,36096,36097,8,4,-4
36097,36097,36098,4,1,-3
36098,36098,36099,1,8,7
36099,36099,36100,8,2,-6
36100,36100,36101,2,6,4
36101,36101,36102,6,9,3
36102,36102,36103,9,3,-6
36103,36103,36104,3,9,6
36104,36104,36105,9,7,-2
36105,36105,36106,7,1,-6
36106,36106,36107,1,0,-1
36107,36107,36108,0,1,1
36108,36108,36109,1,9,8
36109,36109,36110,9,1,-8
36110,36110,36111,1,5,4
36111,36111,36112,5,2,-3
36112,36112,36113,2,6,4
36113,36113,36114,6,8,2
36114,36114,36115,8,7,-1
36115,36115,36116,7,0,-7
36116,36116,36117,0,1,1
36117,36117,36118,1,5,4
36118,36118,36119,5,3,-2
36119,36119,36120,3,2,-1
36120,36120,36121,2,8,6
36121,36121,36122,8,9,1
36122,36122,36123,9,2,-7
36123,36123,36124,2,1,-1
36124,36124,36125,1,6,5
36125,36125,36126,6,5,-1
36126,36126,36127,5,2,-3
36127,36127,36128,2,3,1
36128,36128,36129,3,6,3
36129,36129,36130,6,3,-3
36130,36130,36131,3,4,1
36131,36131,36132,4,3,-1
36132,36132,36133,3,2,-1
36133,36133,36134,2,7,5
36134,36134,36135,7,7,0
36135,36135,36136,7,7,0
36136,36136,36137,7,8,1
36137,36137,36138,8,0,-8
36138,36138,36139,0,7,7
36139,36139,36140,7,7,0
36140,36140,36141,7,1,-6
36141,36141,36142,1,2,1
36142,36142,36143,2,0,-2
36143,36143,36144,0,6,6
36144,36144,36145,6,1,-5
36145,36145,36146,1,0,-1
36146,36146,36147,0,2,2
36147,36147,36148,2,9,7
36148,36148,36149,9,3,-6
36149,36149,36150,3,7,4
36150,36150,36151,7,4,-3
36151,36151,36152,4,7,3
36152,36152,36153,7,5,-2
36153,36153,36154,5,3,-2
36154,36154,36155,3,6,3
36155,36155,36156,6,7,1
36156,36156,36157,7,7,0
36157,36157,36158,7,7,0
36158,36158,36159,7,8,1
36159,36159,36160,8,4,-4
36160,36160,36161,4,9,5
36161,36161,36162,9,9,0
36162,36162,36163,9,0,-9
36163,36163,36164,0,1,1
36164,36164,36165,1,1,0
36165,36165,36166,1,2,1
36166,36166,36167,2,2,0
36167,36167,36168,2,0,-2
36168,36168,36169,0,3,3
36169,36169,36170,3,2,-1
36170,36170,36171,2,4,2
36171,36171,36172,4,9,5
36172,36172,36173,9,5,-4
36173,36173,36174,5,4,-1
36174,36174,36175,4,6,2
36175,36175,36176,6,6,0
36176,36176,36177,6,7,1
36177,36177,36178,7,7,0
36178,36178,36179,7,8,1
36179,36179,36180,8,3,-5
36180,36180,36181,3,9,6
36181,36181,36182,9,8,-1
36182,36182,36183,8,0,-8
36183,36183,36184,0,6,6
36184,36184,36185,6,1,-5
36185,36185,36186,1,9,8
36186,36186,36187,9,2,-7
36187,36187,36188,2,7,5
36188,36188,36189,7,3,-4
36189,36189,36190,3,4,1
36190,36190,36191,4,4,0
36191,36191,36192,4,8,4
36192,36192,36193,8,5,-3
36193,36193,36194,5,9,4
36194,36194,36195,9,6,-3
36195,36195,36196,6,9,3
36196,36196,36197,9,7,-2
36197,36197,36198,7,0,-7
36198,36198,36199,0,8,8
36199,36199,36200,8,4,-4
36200,36200,36201,4,9,5
36201,36201,36202,9,4,-5
36202,36202,36203,4,9,5
36203,36203,36204,9,4,-5
36204,36204,36205,4,7,3
36205,36205,36206,7,3,-4
36206,36206,36207,3,5,2
36207,36207,36208,5,4,-1
36208,36208,36209,4,2,-2
36209,36209,36210,2,8,6
36210,36210,36211,8,9,1
36211,36211,36212,9,4,-5
36212,36212,36213,4,0,-4
36213,36213,36214,0,5,5
36214,36214,36215,5,1,-4
36215,36215,36216,1,3,2
36216,36216,36217,3,5,2
36217,36217,36218,5,4,-1
36218,36218,36219,4,8,4
36219,36219,36220,8,6,-2
36220,36220,36221,6,8,2
36221,36221,36222,8,4,-4
36222,36222,36223,4,0,-4
36223,36223,36224,0,8,8
36224,36224,36225,8,9,1
36225,36225,36226,9,4,-5
36226,36226,36227,4,3,-1
36227,36227,36228,3,4,1
36228,36228,36229,4,2,-2
36229,36229,36230,2,7,5
36230,36230,36231,7,7,0
36231,36231,36232,7,6,-1
36232,36232,36233,6,8,2
36233,36233,36234,8,7,-1
36234,36234,36235,7,4,-3
36235,36235,36236,4,5,1
36236,36236,36237,5,6,1
36237,36237,36238,6,7,1
36238,36238,36239,7,1,-6
36239,36239,36240,1,1,0
36240,36240,36241,1,0,-1
36241,36241,36242,0,3,3
36242,36242,36243,3,4,1
36243,36243,36244,4,5,1
36244,36244,36245,5,5,0
36245,36245,36246,5,4,-1
36246,36246,36247,4,3,-1
36247,36247,36248,3,3,0
36248,36248,36249,3,9,6
36249,36249,36250,9,8,-1
36250,36250,36251,8,0,-8
36251,36251,36252,0,5,5
36252,36252,36253,5,5,0
36253,36253,36254,5,6,1
36254,36254,36255,6,0,-6
36255,36255,36256,0,5,5
36256,36256,36257,5,1,-4
36257,36257,36258,1,7,6
36258,36258,36259,7,6,-1
36259,36259,36260,6,0,-6
36260,36260,36261,0,9,9
36261,36261,36262,9,3,-6
36262,36262,36263,3,3,0
36263,36263,36264,3,1,-2
36264,36264,36265,1,1,0
36265,36265,36266,1,2,1
36266,36266,36267,2,6,4
36267,36267,36268,6,5,-1
36268,36268,36269,5,0,-5
36269,36269,36270,0,8,8
36270,36270,36271,8,1,-7
36271,36271,36272,1,0,-1
36272,36272,36273,0,1,1
36273,36273,36274,1,6,5
36274,36274,36275,6,8,2
36275,36275,36276,8,1,-7
36276,36276,36277,1,0,-1
36277,36277,36278,0,6,6
36278,36278,36279,6,4,-2
36279,36279,36280,4,4,0
36280,36280,36281,4,7,3
36281,36281,36282,7,9,2
36282,36282,36283,9,7,-2
36283,36283,36284,7,7,0
36284,36284,36285,7,6,-1
36285,36285,36286,6,4,-2
36286,36286,36287,4,3,-1
36287,36287,36288,3,1,-2
36288,36288,36289,1,5,4
36289,36289,36290,5,0,-5
36290,36290,36291,0,6,6
36291,36291,36292,6,2,-4
36292,36292,36293,2,6,4
36293,36293,36294,6,6,0
36294,36294,36295,6,3,-3
36295,36295,36296,3,4,1
36296,36296,36297,4,1,-3
36297,36297,36298,1,3,2
36298,36298,36299,3,8,5
36299,36299,36300,8,8,0
36300,36300,36301,8,3,-5
36301,36301,36302,3,7,4
36302,36302,36303,7,5,-2
36303,36303,36304,5,0,-5
36304,36304,36305,0,6,6
36305,36305,36306,6,9,3
36306,36306,36307,9,7,-2
36307,36307,36308,7,6,-1
36308,36308,36309,6,5,-1
36309,36309,36310,5,6,1
36310,36310,36311,6,2,-4
36311,36311,36312,2,0,-2
36312,36312,36313,0,7,7
36313,36313,36314,7,4,-3
36314,36314,36315,4,1,-3
36315,36315,36316,1,7,6
36316,36316,36317,7,1,-6
36317,36317,36318,1,0,-1
36318,36318,36319,0,9,9
36319,36319,36320,9,8,-1
36320,36320,36321,8,2,-6
36321,36321,36322,2,4,2
36322,36322,36323,4,8,4
36323,36323,36324,8,3,-5
36324,36324,36325,3,8,5
36325,36325,36326,8,2,-6
36326,36326,36327,2,3,1
36327,36327,36328,3,9,6
36328,36328,36329,9,3,-6
36329,36329,36330,3,5,2
36330,36330,36331,5,0,-5
36331,36331,36332,0,5,5
36332,36332,36333,5,1,-4
36333,36333,36334,1,7,6
36334,36334,36335,7,2,-5
36335,36335,36336,2,4,2
36336,36336,36337,4,3,-1
36337,36337,36338,3,3,0
36338,36338,36339,3,4,1
36339,36339,36340,4,7,3
36340,36340,36341,7,5,-2
36341,36341,36342,5,4,-1
36342,36342,36343,4,6,2
36343,36343,36344,6,6,0
36344,36344,36345,6,7,1
36345,36345,36346,7,4,-3
36346,36346,36347,4,8,4
36347,36347,36348,8,9,1
36348,36348,36349,9,9,0
36349,36349,36350,9,4,-5
36350,36350,36351,4,0,-4
36351,36351,36352,0,7,7
36352,36352,36353,7,1,-6
36353,36353,36354,1,5,4
36354,36354,36355,5,2,-3
36355,36355,36356,2,1,-1
36356,36356,36357,1,3,2
36357,36357,36358,3,6,3
36358,36358,36359,6,4,-2
36359,36359,36360,4,9,5
36360,36360,36361,9,5,-4
36361,36361,36362,5,0,-5
36362,36362,36363,0,6,6
36363,36363,36364,6,4,-2
36364,36364,36365,4,7,3
36365,36365,36366,7,5,-2
36366,36366,36367,5,8,3
36367,36367,36368,8,1,-7
36368,36368,36369,1,9,8
36369,36369,36370,9,9,0
36370,36370,36371,9,0,-9
36371,36371,36372,0,6,6
36372,36372,36373,6,1,-5
36373,36373,36374,1,2,1
36374,36374,36375,2,2,0
36375,36375,36376,2,0,-2
36376,36376,36377,0,3,3
36377,36377,36378,3,9,6
36378,36378,36379,9,4,-5
36379,36379,36380,4,1,-3
36380,36380,36381,1,5,4
36381,36381,36382,5,1,-4
36382,36382,36383,1,6,5
36383,36383,36384,6,4,-2
36384,36384,36385,4,7,3
36385,36385,36386,7,8,1
36386,36386,36387,8,8,0
36387,36387,36388,8,1,-7
36388,36388,36389,1,9,8
36389,36389,36390,9,6,-3
36390,36390,36391,6,0,-6
36391,36391,36392,0,9,9
36392,36392,36393,9,0,-9
36393,36393,36394,0,4,4
36394,36394,36395,4,7,3
36395,36395,36396,7,2,-5
36396,36396,36397,2,2,0
36397,36397,36398,2,7,5
36398,36398,36399,7,4,-3
36399,36399,36400,4,4,0
36400,36400,36401,4,2,-2
36401,36401,36402,2,9,7
36402,36402,36403,9,6,-3
36403,36403,36404,6,7,1
36404,36404,36405,7,5,-2
36405,36405,36406,5,3,-2
36406,36406,36407,3,5,2
36407,36407,36408,5,1,-4
36408,36408,36409,1,3,2
36409,36409,36410,3,1,-2
36410,36410,36411,1,7,6
36411,36411,36412,7,0,-7
36412,36412,36413,0,8,8
36413,36413,36414,8,0,-8
36414,36414,36415,0,6,6
36415,36415,36416,6,6,0
36416,36416,36417,6,6,0
36417,36417,36418,6,9,3
36418,36418,36419,9,4,-5
36419,36419,36420,4,9,5
36420,36420,36421,9,3,-6
36421,36421,36422,3,1,-2
36422,36422,36423,1,2,1
36423,36423,36424,2,5,3
36424,36424,36425,5,6,1
36425,36425,36426,6,1,-5
36426,36426,36427,1,3,2
36427,36427,36428,3,4,1
36428,36428,36429,4,8,4
36429,36429,36430,8,7,-1
36430,36430,36431,7,0,-7
36431,36431,36432,0,3,3
36432,36432,36433,3,1,-2
36433,36433,36434,1,4,3
36434,36434,36435,4,4,0
36435,36435,36436,4,7,3
36436,36436,36437,7,5,-2
36437,36437,36438,5,9,4
36438,36438,36439,9,6,-3
36439,36439,36440,6,0,-6
36440,36440,36441,0,4,4
36441,36441,36442,4,1,-3
36442,36442,36443,1,7,6
36443,36443,36444,7,6,-1
36444,36444,36445,6,8,2
36445,36445,36446,8,6,-2
36446,36446,36447,6,0,-6
36447,36447,36448,0,1,1
36448,36448,36449,1,3,2
36449,36449,36450,3,2,-1
36450,36450,36451,2,1,-1
36451,36451,36452,1,5,4
36452,36452,36453,5,5,0
36453,36453,36454,5,5,0
36454,36454,36455,5,4,-1
36455,36455,36456,4,9,5
36456,36456,36457,9,1,-8
36457,36457,36458,1,3,2
36458,36458,36459,3,9,6
36459,36459,36460,9,2,-7
36460,36460,36461,2,1,-1
36461,36461,36462,1,2,1
36462,36462,36463,2,2,0
36463,36463,36464,2,9,7
36464,36464,36465,9,7,-2
36465,36465,36466,7,4,-3
36466,36466,36467,4,0,-4
36467,36467,36468,0,0,0
36468,36468,36469,0,1,1
36469,36469,36470,1,5,4
36470,36470,36471,5,3,-2
36471,36471,36472,3,7,4
36472,36472,36473,7,8,1
36473,36473,36474,8,9,1
36474,36474,36475,9,2,-7
36475,36475,36476,2,0,-2
36476,36476,36477,0,9,9
36477,36477,36478,9,8,-1
36478,36478,36479,8,7,-1
36479,36479,36480,7,5,-2
36480,36480,36481,5,9,4
36481,36481,36482,9,5,-4
36482,36482,36483,5,4,-1
36483,36483,36484,4,0,-4
36484,36484,36485,0,2,2
36485,36485,36486,2,9,7
36486,36486,36487,9,5,-4
36487,36487,36488,5,3,-2
36488,36488,36489,3,8,5
36489,36489,36490,8,1,-7
36490,36490,36491,1,6,5
36491,36491,36492,6,8,2
36492,36492,36493,8,5,-3
36493,36493,36494,5,4,-1
36494,36494,36495,4,5,1
36495,36495,36496,5,6,1
36496,36496,36497,6,9,3
36497,36497,36498,9,7,-2
36498,36498,36499,7,9,2
36499,36499,36500,9,9,0
36500,36500,36501,9,1,-8
36501,36501,36502,1,4,3
36502,36502,36503,4,8,4
36503,36503,36504,8,6,-2
36504,36504,36505,6,2,-4
36505,36505,36506,2,0,-2
36506,36506,36507,0,9,9
36507,36507,36508,9,5,-4
36508,36508,36509,5,1,-4
36509,36509,36510,1,9,8
36510,36510,36511,9,3,-6
36511,36511,36512,3,7,4
36512,36512,36513,7,4,-3
36513,36513,36514,4,5,1
36514,36514,36515,5,3,-2
36515,36515,36516,3,5,2
36516,36516,36517,5,1,-4
36517,36517,36518,1,4,3
36518,36518,36519,4,0,-4
36519,36519,36520,0,1,1
36520,36520,36521,1,9,8
36521,36521,36522,9,2,-7
36522,36522,36523,2,6,4
36523,36523,36524,6,0,-6
36524,36524,36525,0,3,3
36525,36525,36526,3,9,6
36526,36526,36527,9,6,-3
36527,36527,36528,6,5,-1
36528,36528,36529,5,8,3
36529,36529,36530,8,7,-1
36530,36530,36531,7,7,0
36531,36531,36532,7,1,-6
36532,36532,36533,1,0,-1
36533,36533,36534,0,7,7
36534,36534,36535,7,1,-6
36535,36535,36536,1,1,0
36536,36536,36537,1,0,-1
36537,36537,36538,0,9,9
36538,36538,36539,9,5,-4
36539,36539,36540,5,4,-1
36540,36540,36541,4,8,4
36541,36541,36542,8,3,-5
36542,36542,36543,3,2,-1
36543,36543,36544,2,5,3
36544,36544,36545,5,7,2
36545,36545,36546,7,7,0
36546,36546,36547,7,7,0
36547,36547,36548,7,4,-3
36548,36548,36549,4,0,-4
36549,36549,36550,0,9,9
36550,36550,36551,9,1,-8
36551,36551,36552,1,4,3
36552,36552,36553,4,2,-2
36553,36553,36554,2,7,5
36554,36554,36555,7,3,-4
36555,36555,36556,3,5,2
36556,36556,36557,5,4,-1
36557,36557,36558,4,1,-3
36558,36558,36559,1,5,4
36559,36559,36560,5,0,-5
36560,36560,36561,0,6,6
36561,36561,36562,6,0,-6
36562,36562,36563,0,7,7
36563,36563,36564,7,0,-7
36564,36564,36565,0,8,8
36565,36565,36566,8,3,-5
36566,36566,36567,3,9,6
36567,36567,36568,9,2,-7
36568,36568,36569,2,0,-2
36569,36569,36570,0,6,6
36570,36570,36571,6,1,-5
36571,36571,36572,1,3,2
36572,36572,36573,3,2,-1
36573,36573,36574,2,6,4
36574,36574,36575,6,3,-3
36575,36575,36576,3,8,5
36576,36576,36577,8,4,-4
36577,36577,36578,4,6,2
36578,36578,36579,6,5,-1
36579,36579,36580,5,7,2
36580,36580,36581,7,6,-1
36581,36581,36582,6,8,2
36582,36582,36583,8,7,-1
36583,36583,36584,7,4,-3
36584,36584,36585,4,8,4
36585,36585,36586,8,0,-8
36586,36586,36587,0,9,9
36587,36587,36588,9,5,-4
36588,36588,36589,5,0,-5
36589,36589,36590,0,6,6
36590,36590,36591,6,1,-5
36591,36591,36592,1,3,2
36592,36592,36593,3,2,-1
36593,36593,36594,2,1,-1
36594,36594,36595,1,3,2
36595,36595,36596,3,4,1
36596,36596,36597,4,4,0
36597,36597,36598,4,8,4
36598,36598,36599,8,5,-3
36599,36599,36600,5,2,-3
36600,36600,36601,2,6,4
36601,36601,36602,6,5,-1
36602,36602,36603,5,7,2
36603,36603,36604,7,3,-4
36604,36604,36605,3,8,5
36605,36605,36606,8,9,1
36606,36606,36607,9,9,0
36607,36607,36608,9,1,-8
36608,36608,36609,1,5,4
36609,36609,36610,5,8,3
36610,36610,36611,8,7,-1
36611,36611,36612,7,7,0
36612,36612,36613,7,7,0
36613,36613,36614,7,2,-5
36614,36614,36615,2,7,5
36615,36615,36616,7,6,-1
36616,36616,36617,6,0,-6
36617,36617,36618,0,1,1
36618,36618,36619,1,4,3
36619,36619,36620,4,0,-4
36620,36620,36621,0,0,0
36621,36621,36622,0,8,8
36622,36622,36623,8,3,-5
36623,36623,36624,3,2,-1
36624,36624,36625,2,1,-1
36625,36625,36626,1,1,0
36626,36626,36627,1,8,7
36627,36627,36628,8,0,-8
36628,36628,36629,0,9,9
36629,36629,36630,9,4,-5
36630,36630,36631,4,2,-2
36631,36631,36632,2,4,2
36632,36632,36633,4,1,-3
36633,36633,36634,1,4,3
36634,36634,36635,4,8,4
36635,36635,36636,8,6,-2
36636,36636,36637,6,6,0
36637,36637,36638,6,5,-1
36638,36638,36639,5,5,0
36639,36639,36640,5,4,-1
36640,36640,36641,4,4,0
36641,36641,36642,4,5,1
36642,36642,36643,5,7,2
36643,36643,36644,7,3,-4
36644,36644,36645,3,3,0
36645,36645,36646,3,0,-3
36646,36646,36647,0,4,4
36647,36647,36648,4,8,4
36648,36648,36649,8,1,-7
36649,36649,36650,1,7,6
36650,36650,36651,7,8,1
36651,36651,36652,8,8,0
36652,36652,36653,8,6,-2
36653,36653,36654,6,7,1
36654,36654,36655,7,9,2
36655,36655,36656,9,8,-1
36656,36656,36657,8,1,-7
36657,36657,36658,1,5,4
36658,36658,36659,5,4,-1
36659,36659,36660,4,6,2
36660,36660,36661,6,5,-1
36661,36661,36662,5,2,-3
36662,36662,36663,2,5,3
36663,36663,36664,5,4,-1
36664,36664,36665,4,6,2
36665,36665,36666,6,9,3
36666,36666,36667,9,0,-9
36667,36667,36668,0,4,4
36668,36668,36669,4,1,-3
36669,36669,36670,1,9,8
36670,36670,36671,9,3,-6
36671,36671,36672,3,8,5
36672,36672,36673,8,6,-2
36673,36673,36674,6,4,-2
36674,36674,36675,4,4,0
36675,36675,36676,4,4,0
36676,36676,36677,4,8,4
36677,36677,36678,8,9,1
36678,36678,36679,9,9,0
36679,36679,36680,9,2,-7
36680,36680,36681,2,8,6
36681,36681,36682,8,1,-7
36682,36682,36683,1,5,4
36683,36683,36684,5,3,-2
36684,36684,36685,3,2,-1
36685,36685,36686,2,6,4
36686,36686,36687,6,1,-5
36687,36687,36688,1,7,6
36688,36688,36689,7,0,-7
36689,36689,36690,0,5,5
36690,36690,36691,5,7,2
36691,36691,36692,7,0,-7
36692,36692,36693,0,2,2
36693,36693,36694,2,2,0
36694,36694,36695,2,5,3
36695,36695,36696,5,8,3
36696,36696,36697,8,5,-3
36697,36697,36698,5,6,1
36698,36698,36699,6,6,0
36699,36699,36700,6,7,1
36700,36700,36701,7,6,-1
36701,36701,36702,6,6,0
36702,36702,36703,6,6,0
36703,36703,36704,6,2,-4
36704,36704,36705,2,3,1
36705,36705,36706,3,4,1
36706,36706,36707,4,3,-1
36707,36707,36708,3,8,5
36708,36708,36709,8,3,-5
36709,36709,36710,3,8,5
36710,36710,36711,8,1,-7
36711,36711,36712,1,0,-1
36712,36712,36713,0,7,7
36713,36713,36714,7,6,-1
36714,36714,36715,6,2,-4
36715,36715,36716,2,3,1
36716,36716,36717,3,2,-1
36717,36717,36718,2,2,0
36718,36718,36719,2,7,5
36719,36719,36720,7,9,2
36720,36720,36721,9,2,-7
36721,36721,36722,2,5,3
36722,36722,36723,5,3,-2
36723,36723,36724,3,6,3
36724,36724,36725,6,6,0
36725,36725,36726,6,4,-2
36726,36726,36727,4,8,4
36727,36727,36728,8,2,-6
36728,36728,36729,2,5,3
36729,36729,36730,5,7,2
36730,36730,36731,7,1,-6
36731,36731,36732,1,3,2
36732,36732,36733,3,4,1
36733,36733,36734,4,0,-4
36734,36734,36735,0,9,9
36735,36735,36736,9,5,-4
36736,36736,36737,5,0,-5
36737,36737,36738,0,1,1
36738,36738,36739,1,5,4
36739,36739,36740,5,3,-2
36740,36740,36741,3,0,-3
36741,36741,36742,0,4,4
36742,36742,36743,4,6,2
36743,36743,36744,6,1,-5
36744,36744,36745,1,8,7
36745,36745,36746,8,6,-2
36746,36746,36747,6,8,2
36747,36747,36748,8,7,-1
36748,36748,36749,7,0,-7
36749,36749,36750,0,5,5
36750,36750,36751,5,8,3
36751,36751,36752,8,8,0
36752,36752,36753,8,2,-6
36753,36753,36754,2,8,6
36754,36754,36755,8,3,-5
36755,36755,36756,3,5,2
36756,36756,36757,5,9,4
36757,36757,36758,9,7,-2
36758,36758,36759,7,4,-3
36759,36759,36760,4,7,3
36760,36760,36761,7,3,-4
36761,36761,36762,3,7,4
36762,36762,36763,7,7,0
36763,36763,36764,7,0,-7
36764,36764,36765,0,1,1
36765,36765,36766,1,6,5
36766,36766,36767,6,7,1
36767,36767,36768,7,2,-5
36768,36768,36769,2,6,4
36769,36769,36770,6,8,2
36770,36770,36771,8,9,1
36771,36771,36772,9,6,-3
36772,36772,36773,6,4,-2
36773,36773,36774,4,5,1
36774,36774,36775,5,2,-3
36775,36775,36776,2,8,6
36776,36776,36777,8,9,1
36777,36777,36778,9,1,-8
36778,36778,36779,1,9,8
36779,36779,36780,9,0,-9
36780,36780,36781,0,2,2
36781,36781,36782,2,9,7
36782,36782,36783,9,0,-9
36783,36783,36784,0,6,6
36784,36784,36785,6,8,2
36785,36785,36786,8,1,-7
36786,36786,36787,1,5,4
36787,36787,36788,5,0,-5
36788,36788,36789,0,0,0
36789,36789,36790,0,4,4
36790,36790,36791,4,4,0
36791,36791,36792,4,6,2
36792,36792,36793,6,9,3
36793,36793,36794,9,1,-8
36794,36794,36795,1,4,3
36795,36795,36796,4,7,3
36796,36796,36797,7,0,-7
36797,36797,36798,0,6,6
36798,36798,36799,6,7,1
36799,36799,36800,7,5,-2
36800,36800,36801,5,1,-4
36801,36801,36802,1,3,2
36802,36802,36803,3,3,0
36803,36803,36804,3,5,2
36804,36804,36805,5,2,-3
36805,36805,36806,2,7,5
36806,36806,36807,7,9,2
36807,36807,36808,9,9,0
36808,36808,36809,9,0,-9
36809,36809,36810,0,6,6
36810,36810,36811,6,1,-5
36811,36811,36812,1,5,4
36812,36812,36813,5,2,-3
36813,36813,36814,2,1,-1
36814,36814,36815,1,3,2
36815,36815,36816,3,8,5
36816,36816,36817,8,4,-4
36817,36817,36818,4,7,3
36818,36818,36819,7,5,-2
36819,36819,36820,5,8,3
36820,36820,36821,8,6,-2
36821,36821,36822,6,1,-5
36822,36822,36823,1,7,6
36823,36823,36824,7,0,-7
36824,36824,36825,0,8,8
36825,36825,36826,8,6,-2
36826,36826,36827,6,9,3
36827,36827,36828,9,8,-1
36828,36828,36829,8,0,-8
36829,36829,36830,0,9,9
36830,36830,36831,9,1,-8
36831,36831,36832,1,9,8
36832,36832,36833,9,2,-7
36833,36833,36834,2,8,6
36834,36834,36835,8,3,-5
36835,36835,36836,3,4,1
36836,36836,36837,4,4,0
36837,36837,36838,4,6,2
36838,36838,36839,6,5,-1
36839,36839,36840,5,7,2
36840,36840,36841,7,6,-1
36841,36841,36842,6,0,-6
36842,36842,36843,0,7,7
36843,36843,36844,7,2,-5
36844,36844,36845,2,8,6
36845,36845,36846,8,2,-6
36846,36846,36847,2,9,7
36847,36847,36848,9,0,-9
36848,36848,36849,0,0,0
36849,36849,36850,0,5,5
36850,36850,36851,5,1,-4
36851,36851,36852,1,3,2
36852,36852,36853,3,2,-1
36853,36853,36854,2,8,6
36854,36854,36855,8,3,-5
36855,36855,36856,3,7,4
36856,36856,36857,7,6,-1
36857,36857,36858,6,2,-4
36858,36858,36859,2,7,5
36859,36859,36860,7,9,2
36860,36860,36861,9,8,-1
36861,36861,36862,8,3,-5
36862,36862,36863,3,9,6
36863,36863,36864,9,1,-8
36864,36864,36865,1,8,7
36865,36865,36866,8,6,-2
36866,36866,36867,6,4,-2
36867,36867,36868,4,2,-2
36868,36868,36869,2,0,-2
36869,36869,36870,0,8,8
36870,36870,36871,8,0,-8
36871,36871,36872,0,3,3
36872,36872,36873,3,7,4
36873,36873,36874,7,0,-7
36874,36874,36875,0,2,2
36875,36875,36876,2,7,5
36876,36876,36877,7,4,-3
36877,36877,36878,4,8,4
36878,36878,36879,8,2,-6
36879,36879,36880,2,9,7
36880,36880,36881,9,6,-3
36881,36881,36882,6,0,-6
36882,36882,36883,0,5,5
36883,36883,36884,5,2,-3
36884,36884,36885,2,5,3
36885,36885,36886,5,9,4
36886,36886,36887,9,3,-6
36887,36887,36888,3,5,2
36888,36888,36889,5,7,2
36889,36889,36890,7,6,-1
36890,36890,36891,6,8,2
36891,36891,36892,8,1,-7
36892,36892,36893,1,6,5
36893,36893,36894,6,0,-6
36894,36894,36895,0,6,6
36895,36895,36896,6,5,-1
36896,36896,36897,5,4,-1
36897,36897,36898,4,1,-3
36898,36898,36899,1,3,2
36899,36899,36900,3,5,2
36900,36900,36901,5,2,-3
36901,36901,36902,2,7,5
36902,36902,36903,7,6,-1
36903,36903,36904,6,2,-4
36904,36904,36905,2,6,4
36905,36905,36906,6,9,3
36906,36906,36907,9,4,-5
36907,36907,36908,4,1,-3
36908,36908,36909,1,4,3
36909,36909,36910,4,6,2
36910,36910,36911,6,3,-3
36911,36911,36912,3,3,0
36912,36912,36913,3,8,5
36913,36913,36914,8,2,-6
36914,36914,36915,2,8,6
36915,36915,36916,8,7,-1
36916,36916,36917,7,3,-4
36917,36917,36918,3,5,2
36918,36918,36919,5,0,-5
36919,36919,36920,0,9,9
36920,36920,36921,9,1,-8
36921,36921,36922,1,9,8
36922,36922,36923,9,4,-5
36923,36923,36924,4,1,-3
36924,36924,36925,1,7,6
36925,36925,36926,7,7,0
36926,36926,36927,7,8,1
36927,36927,36928,8,1,-7
36928,36928,36929,1,0,-1
36929,36929,36930,0,9,9
36930,36930,36931,9,3,-6
36931,36931,36932,3,4,1
36932,36932,36933,4,1,-3
36933,36933,36934,1,9,8
36934,36934,36935,9,9,0
36935,36935,36936,9,2,-7
36936,36936,36937,2,0,-2
36937,36937,36938,0,4,4
36938,36938,36939,4,5,1
36939,36939,36940,5,4,-1
36940,36940,36941,4,4,0
36941,36941,36942,4,2,-2
36942,36942,36943,2,1,-1
36943,36943,36944,1,8,7
36944,36944,36945,8,9,1
36945,36945,36946,9,3,-6
36946,36946,36947,3,1,-2
36947,36947,36948,1,0,-1
36948,36948,36949,0,2,2
36949,36949,36950,2,2,0
36950,36950,36951,2,7,5
36951,36951,36952,7,4,-3
36952,36952,36953,4,0,-4
36953,36953,36954,0,7,7
36954,36954,36955,7,1,-6
36955,36955,36956,1,1,0
36956,36956,36957,1,3,2
36957,36957,36958,3,2,-1
36958,36958,36959,2,8,6
36959,36959,36960,8,9,1
36960,36960,36961,9,2,-7
36961,36961,36962,2,4,2
36962,36962,36963,4,9,5
36963,36963,36964,9,7,-2
36964,36964,36965,7,2,-5
36965,36965,36966,2,6,4
36966,36966,36967,6,7,1
36967,36967,36968,7,1,-6
36968,36968,36969,1,7,6
36969,36969,36970,7,4,-3
36970,36970,36971,4,9,5
36971,36971,36972,9,7,-2
36972,36972,36973,7,9,2
36973,36973,36974,9,8,-1
36974,36974,36975,8,0,-8
36975,36975,36976,0,4,4
36976,36976,36977,4,4,0
36977,36977,36978,4,2,-2
36978,36978,36979,2,2,0
36979,36979,36980,2,6,4
36980,36980,36981,6,5,-1
36981,36981,36982,5,2,-3
36982,36982,36983,2,8,6
36983,36983,36984,8,5,-3
36984,36984,36985,5,6,1
36985,36985,36986,6,8,2
36986,36986,36987,8,5,-3
36987,36987,36988,5,9,4
36988,36988,36989,9,5,-4
36989,36989,36990,5,3,-2
36990,36990,36991,3,9,6
36991,36991,36992,9,1,-8
36992,36992,36993,1,9,8
36993,36993,36994,9,0,-9
36994,36994,36995,0,1,1
36995,36995,36996,1,6,5
36996,36996,36997,6,1,-5
36997,36997,36998,1,2,1
36998,36998,36999,2,5,3
36999,36999,37000,5,4,-1
37000,37000,37001,4,7,3
37001,37001,37002,7,9,2
37002,37002,37003,9,6,-3
37003,37003,37004,6,5,-1
37004,37004,37005,5,8,3
37005,37005,37006,8,5,-3
37006,37006,37007,5,2,-3
37007,37007,37008,2,1,-1
37008,37008,37009,1,9,8
37009,37009,37010,9,4,-5
37010,37010,37011,4,1,-3
37011,37011,37012,1,1,0
37012,37012,37013,1,3,2
37013,37013,37014,3,1,-2
37014,37014,37015,1,2,1
37015,37015,37016,2,5,3
37016,37016,37017,5,3,-2
37017,37017,37018,3,6,3
37018,37018,37019,6,4,-2
37019,37019,37020,4,2,-2
37020,37020,37021,2,3,1
37021,37021,37022,3,3,0
37022,37022,37023,3,1,-2
37023,37023,37024,1,1,0
37024,37024,37025,1,9,8
37025,37025,37026,9,9,0
37026,37026,37027,9,0,-9
37027,37027,37028,0,6,6
37028,37028,37029,6,9,3
37029,37029,37030,9,8,-1
37030,37030,37031,8,5,-3
37031,37031,37032,5,8,3
37032,37032,37033,8,6,-2
37033,37033,37034,6,7,1
37034,37034,37035,7,3,-4
37035,37035,37036,3,1,-2
37036,37036,37037,1,6,5
37037,37037,37038,6,1,-5
37038,37038,37039,1,8,7
37039,37039,37040,8,2,-6
37040,37040,37041,2,7,5
37041,37041,37042,7,3,-4
37042,37042,37043,3,0,-3
37043,37043,37044,0,6,6
37044,37044,37045,6,1,-5
37045,37045,37046,1,9,8
37046,37046,37047,9,0,-9
37047,37047,37048,0,9,9
37048,37048,37049,9,5,-4
37049,37049,37050,5,6,1
37050,37050,37051,6,8,2
37051,37051,37052,8,0,-8
37052,37052,37053,0,2,2
37053,37053,37054,2,3,1
37054,37054,37055,3,7,4
37055,37055,37056,7,5,-2
37056,37056,37057,5,7,2
37057,37057,37058,7,1,-6
37058,37058,37059,1,0,-1
37059,37059,37060,0,9,9
37060,37060,37061,9,1,-8
37061,37061,37062,1,9,8
37062,37062,37063,9,2,-7
37063,37063,37064,2,7,5
37064,37064,37065,7,3,-4
37065,37065,37066,3,5,2
37066,37066,37067,5,4,-1
37067,37067,37068,4,7,3
37068,37068,37069,7,5,-2
37069,37069,37070,5,5,0
37070,37070,37071,5,6,1
37071,37071,37072,6,5,-1
37072,37072,37073,5,7,2
37073,37073,37074,7,4,-3
37074,37074,37075,4,8,4
37075,37075,37076,8,4,-4
37076,37076,37077,4,9,5
37077,37077,37078,9,8,-1
37078,37078,37079,8,0,-8
37079,37079,37080,0,4,4
37080,37080,37081,4,1,-3
37081,37081,37082,1,3,2
37082,37082,37083,3,2,-1
37083,37083,37084,2,2,0
37084,37084,37085,2,3,1
37085,37085,37086,3,5,2
37086,37086,37087,5,4,-1
37087,37087,37088,4,9,5
37088,37088,37089,9,5,-4
37089,37089,37090,5,7,2
37090,37090,37091,7,6,-1
37091,37091,37092,6,0,-6
37092,37092,37093,0,7,7
37093,37093,37094,7,8,1
37094,37094,37095,8,8,0
37095,37095,37096,8,8,0
37096,37096,37097,8,9,1
37097,37097,37098,9,7,-2
37098,37098,37099,7,0,-7
37099,37099,37100,0,7,7
37100,37100,37101,7,1,-6
37101,37101,37102,1,1,0
37102,37102,37103,1,2,1
37103,37103,37104,2,4,2
37104,37104,37105,4,3,-1
37105,37105,37106,3,8,5
37106,37106,37107,8,7,-1
37107,37107,37108,7,9,2
37108,37108,37109,9,8,-1
37109,37109,37110,8,1,-7
37110,37110,37111,1,9,8
37111,37111,37112,9,4,-5
37112,37112,37113,4,0,-4
37113,37113,37114,0,5,5
37114,37114,37115,5,9,4
37115,37115,37116,9,1,-8
37116,37116,37117,1,5,4
37117,37117,37118,5,3,-2
37118,37118,37119,3,5,2
37119,37119,37120,5,2,-3
37120,37120,37121,2,6,4
37121,37121,37122,6,8,2
37122,37122,37123,8,9,1
37123,37123,37124,9,3,-6
37124,37124,37125,3,8,5
37125,37125,37126,8,9,1
37126,37126,37127,9,9,0
37127,37127,37128,9,4,-5
37128,37128,37129,4,8,4
37129,37129,37130,8,8,0
37130,37130,37131,8,7,-1
37131,37131,37132,7,3,-4
37132,37132,37133,3,7,4
37133,37133,37134,7,3,-4
37134,37134,37135,3,3,0
37135,37135,37136,3,9,6
37136,37136,37137,9,5,-4
37137,37137,37138,5,1,-4
37138,37138,37139,1,1,0
37139,37139,37140,1,6,5
37140,37140,37141,6,0,-6
37141,37141,37142,0,6,6
37142,37142,37143,6,2,-4
37143,37143,37144,2,4,2
37144,37144,37145,4,2,-2
37145,37145,37146,2,7,5
37146,37146,37147,7,7,0
37147,37147,37148,7,5,-2
37148,37148,37149,5,8,3
37149,37149,37150,8,9,1
37150,37150,37151,9,2,-7
37151,37151,37152,2,8,6
37152,37152,37153,8,0,-8
37153,37153,37154,0,1,1
37154,37154,37155,1,1,0
37155,37155,37156,1,4,3
37156,37156,37157,4,2,-2
37157,37157,37158,2,0,-2
37158,37158,37159,0,6,6
37159,37159,37160,6,5,-1
37160,37160,37161,5,3,-2
37161,37161,37162,3,9,6
37162,37162,37163,9,3,-6
37163,37163,37164,3,5,2
37164,37164,37165,5,7,2
37165,37165,37166,7,3,-4
37166,37166,37167,3,3,0
37167,37167,37168,3,7,4
37168,37168,37169,7,3,-4
37169,37169,37170,3,8,5
37170,37170,37171,8,4,-4
37171,37171,37172,4,2,-2
37172,37172,37173,2,6,4
37173,37173,37174,6,3,-3
37174,37174,37175,3,6,3
37175,37175,37176,6,4,-2
37176,37176,37177,4,6,2
37177,37177,37178,6,8,2
37178,37178,37179,8,1,-7
37179,37179,37180,1,5,4
37180,37180,37181,5,5,0
37181,37181,37182,5,1,-4
37182,37182,37183,1,0,-1
37183,37183,37184,0,8,8
37184,37184,37185,8,8,0
37185,37185,37186,8,3,-5
37186,37186,37187,3,2,-1
37187,37187,37188,2,3,1
37188,37188,37189,3,0,-3
37189,37189,37190,0,1,1
37190,37190,37191,1,1,0
37191,37191,37192,1,0,-1
37192,37192,37193,0,7,7
37193,37193,37194,7,6,-1
37194,37194,37195,6,6,0
37195,37195,37196,6,1,-5
37196,37196,37197,1,3,2
37197,37197,37198,3,8,5
37198,37198,37199,8,2,-6
37199,37199,37200,2,1,-1
37200,37200,37201,1,1,0
37201,37201,37202,1,8,7
37202,37202,37203,8,7,-1
37203,37203,37204,7,3,-4
37204,37204,37205,3,3,0
37205,37205,37206,3,9,6
37206,37206,37207,9,1,-8
37207,37207,37208,1,6,5
37208,37208,37209,6,3,-3
37209,37209,37210,3,2,-1
37210,37210,37211,2,9,7
37211,37211,37212,9,7,-2
37212,37212,37213,7,1,-6
37213,37213,37214,1,2,1
37214,37214,37215,2,7,5
37215,37215,37216,7,5,-2
37216,37216,37217,5,6,1
37217,37217,37218,6,6,0
37218,37218,37219,6,8,2
37219,37219,37220,8,0,-8
37220,37220,37221,0,4,4
37221,37221,37222,4,6,2
37222,37222,37223,6,3,-3
37223,37223,37224,3,0,-3
37224,37224,37225,0,1,1
37225,37225,37226,1,5,4
37226,37226,37227,5,4,-1
37227,37227,37228,4,6,2
37228,37228,37229,6,3,-3
37229,37229,37230,3,6,3
37230,37230,37231,6,6,0
37231,37231,37232,6,1,-5
37232,37232,37233,1,9,8
37233,37233,37234,9,2,-7
37234,37234,37235,2,6,4
37235,37235,37236,6,6,0
37236,37236,37237,6,1,-5
37237,37237,37238,1,6,5
37238,37238,37239,6,4,-2
37239,37239,37240,4,8,4
37240,37240,37241,8,2,-6
37241,37241,37242,2,9,7
37242,37242,37243,9,2,-7
37243,37243,37244,2,3,1
37244,37244,37245,3,7,4
37245,37245,37246,7,6,-1
37246,37246,37247,6,9,3
37247,37247,37248,9,4,-5
37248,37248,37249,4,5,1
37249,37249,37250,5,3,-2
37250,37250,37251,3,4,1
37251,37251,37252,4,0,-4
37252,37252,37253,0,8,8
37253,37253,37254,8,6,-2
37254,37254,37255,6,8,2
37255,37255,37256,8,6,-2
37256,37256,37257,6,4,-2
37257,37257,37258,4,2,-2
37258,37258,37259,2,9,7
37259,37259,37260,9,3,-6
37260,37260,37261,3,0,-3
37261,37261,37262,0,4,4
37262,37262,37263,4,8,4
37263,37263,37264,8,4,-4
37264,37264,37265,4,9,5
37265,37265,37266,9,3,-6
37266,37266,37267,3,8,5
37267,37267,37268,8,9,1
37268,37268,37269,9,0,-9
37269,37269,37270,0,5,5
37270,37270,37271,5,3,-2
37271,37271,37272,3,4,1
37272,37272,37273,4,4,0
37273,37273,37274,4,2,-2
37274,37274,37275,2,5,3
37275,37275,37276,5,5,0
37276,37276,37277,5,6,1
37277,37277,37278,6,8,2
37278,37278,37279,8,7,-1
37279,37279,37280,7,3,-4
37280,37280,37281,3,8,5
37281,37281,37282,8,6,-2
37282,37282,37283,6,9,3
37283,37283,37284,9,3,-6
37284,37284,37285,3,1,-2
37285,37285,37286,1,1,0
37286,37286,37287,1,0,-1
37287,37287,37288,0,7,7
37288,37288,37289,7,1,-6
37289,37289,37290,1,1,0
37290,37290,37291,1,2,1
37291,37291,37292,2,6,4
37292,37292,37293,6,3,-3
37293,37293,37294,3,4,1
37294,37294,37295,4,4,0
37295,37295,37296,4,2,-2
37296,37296,37297,2,7,5
37297,37297,37298,7,7,0
37298,37298,37299,7,8,1
37299,37299,37300,8,5,-3
37300,37300,37301,5,9,4
37301,37301,37302,9,4,-5
37302,37302,37303,4,0,-4
37303,37303,37304,0,3,3
37304,37304,37305,3,1,-2
37305,37305,37306,1,9,8
37306,37306,37307,9,2,-7
37307,37307,37308,2,5,3
37308,37308,37309,5,3,-2
37309,37309,37310,3,6,3
37310,37310,37311,6,4,-2
37311,37311,37312,4,8,4
37312,37312,37313,8,5,-3
37313,37313,37314,5,3,-2
37314,37314,37315,3,6,3
37315,37315,37316,6,8,2
37316,37316,37317,8,7,-1
37317,37317,37318,7,9,2
37318,37318,37319,9,8,-1
37319,37319,37320,8,2,-6
37320,37320,37321,2,9,7
37321,37321,37322,9,2,-7
37322,37322,37323,2,0,-2
37323,37323,37324,0,8,8
37324,37324,37325,8,8,0
37325,37325,37326,8,9,1
37326,37326,37327,9,7,-2
37327,37327,37328,7,4,-3
37328,37328,37329,4,8,4
37329,37329,37330,8,1,-7
37330,37330,37331,1,9,8
37331,37331,37332,9,3,-6
37332,37332,37333,3,9,6
37333,37333,37334,9,6,-3
37334,37334,37335,6,0,-6
37335,37335,37336,0,6,6
37336,37336,37337,6,1,-5
37337,37337,37338,1,9,8
37338,37338,37339,9,4,-5
37339,37339,37340,4,6,2
37340,37340,37341,6,5,-1
37341,37341,37342,5,8,3
37342,37342,37343,8,1,-7
37343,37343,37344,1,8,7
37344,37344,37345,8,6,-2
37345,37345,37346,6,6,0
37346,37346,37347,6,2,-4
37347,37347,37348,2,7,5
37348,37348,37349,7,9,2
37349,37349,37350,9,6,-3
37350,37350,37351,6,6,0
37351,37351,37352,6,9,3
37352,37352,37353,9,7,-2
37353,37353,37354,7,1,-6
37354,37354,37355,1,3,2
37355,37355,37356,3,6,3
37356,37356,37357,6,9,3
37357,37357,37358,9,5,-4
37358,37358,37359,5,9,4
37359,37359,37360,9,2,-7
37360,37360,37361,2,3,1
37361,37361,37362,3,3,0
37362,37362,37363,3,8,5
37363,37363,37364,8,5,-3
37364,37364,37365,5,1,-4
37365,37365,37366,1,4,3
37366,37366,37367,4,2,-2
37367,37367,37368,2,3,1
37368,37368,37369,3,9,6
37369,37369,37370,9,6,-3
37370,37370,37371,6,6,0
37371,37371,37372,6,4,-2
37372,37372,37373,4,3,-1
37373,37373,37374,3,3,0
37374,37374,37375,3,5,2
37375,37375,37376,5,9,4
37376,37376,37377,9,0,-9
37377,37377,37378,0,1,1
37378,37378,37379,1,5,4
37379,37379,37380,5,5,0
37380,37380,37381,5,4,-1
37381,37381,37382,4,0,-4
37382,37382,37383,0,3,3
37383,37383,37384,3,1,-2
37384,37384,37385,1,4,3
37385,37385,37386,4,2,-2
37386,37386,37387,2,7,5
37387,37387,37388,7,4,-3
37388,37388,37389,4,7,3
37389,37389,37390,7,6,-1
37390,37390,37391,6,9,3
37391,37391,37392,9,4,-5
37392,37392,37393,4,1,-3
37393,37393,37394,1,7,6
37394,37394,37395,7,4,-3
37395,37395,37396,4,8,4
37396,37396,37397,8,3,-5
37397,37397,37398,3,8,5
37398,37398,37399,8,7,-1
37399,37399,37400,7,9,2
37400,37400,37401,9,6,-3
37401,37401,37402,6,7,1
37402,37402,37403,7,2,-5
37403,37403,37404,2,3,1
37404,37404,37405,3,1,-2
37405,37405,37406,1,8,7
37406,37406,37407,8,5,-3
37407,37407,37408,5,0,-5
37408,37408,37409,0,5,5
37409,37409,37410,5,4,-1
37410,37410,37411,4,0,-4
37411,37411,37412,0,2,2
37412,37412,37413,2,5,3
37413,37413,37414,5,5,0
37414,37414,37415,5,0,-5
37415,37415,37416,0,2,2
37416,37416,37417,2,8,6
37417,37417,37418,8,2,-6
37418,37418,37419,2,4,2
37419,37419,37420,4,7,3
37420,37420,37421,7,6,-1
37421,37421,37422,6,3,-3
37422,37422,37423,3,7,4
37423,37423,37424,7,9,2
37424,37424,37425,9,0,-9
37425,37425,37426,0,2,2
37426,37426,37427,2,2,0
37427,37427,37428,2,8,6
37428,37428,37429,8,4,-4
37429,37429,37430,4,9,5
37430,37430,37431,9,8,-1
37431,37431,37432,8,0,-8
37432,37432,37433,0,1,1
37433,37433,37434,1,8,7
37434,37434,37435,8,2,-6
37435,37435,37436,2,8,6
37436,37436,37437,8,2,-6
37437,37437,37438,2,5,3
37438,37438,37439,5,3,-2
37439,37439,37440,3,2,-1
37440,37440,37441,2,1,-1
37441,37441,37442,1,6,5
37442,37442,37443,6,3,-3
37443,37443,37444,3,8,5
37444,37444,37445,8,6,-2
37445,37445,37446,6,2,-4
37446,37446,37447,2,4,2
37447,37447,37448,4,5,1
37448,37448,37449,5,9,4
37449,37449,37450,9,4,-5
37450,37450,37451,4,6,2
37451,37451,37452,6,0,-6
37452,37452,37453,0,5,5
37453,37453,37454,5,3,-2
37454,37454,37455,3,1,-2
37455,37455,37456,1,8,7
37456,37456,37457,8,9,1
37457,37457,37458,9,8,-1
37458,37458,37459,8,8,0
37459,37459,37460,8,8,0
37460,37460,37461,8,1,-7
37461,37461,37462,1,2,1
37462,37462,37463,2,1,-1
37463,37463,37464,1,3,2
37464,37464,37465,3,5,2
37465,37465,37466,5,9,4
37466,37466,37467,9,0,-9
37467,37467,37468,0,3,3
37468,37468,37469,3,2,-1
37469,37469,37470,2,3,1
37470,37470,37471,3,7,4
37471,37471,37472,7,5,-2
37472,37472,37473,5,8,3
37473,37473,37474,8,9,1
37474,37474,37475,9,6,-3
37475,37475,37476,6,6,0
37476,37476,37477,6,6,0
37477,37477,37478,6,3,-3
37478,37478,37479,3,8,5
37479,37479,37480,8,7,-1
37480,37480,37481,7,2,-5
37481,37481,37482,2,1,-1
37482,37482,37483,1,8,7
37483,37483,37484,8,2,-6
37484,37484,37485,2,4,2
37485,37485,37486,4,2,-2
37486,37486,37487,2,4,2
37487,37487,37488,4,8,4
37488,37488,37489,8,2,-6
37489,37489,37490,2,4,2
37490,37490,37491,4,2,-2
37491,37491,37492,2,4,2
37492,37492,37493,4,8,4
37493,37493,37494,8,7,-1
37494,37494,37495,7,0,-7
37495,37495,37496,0,4,4
37496,37496,37497,4,0,-4
37497,37497,37498,0,9,9
37498,37498,37499,9,1,-8
37499,37499,37500,1,7,6
37500,37500,37501,7,2,-5
37501,37501,37502,2,6,4
37502,37502,37503,6,3,-3
37503,37503,37504,3,2,-1
37504,37504,37505,2,4,2
37505,37505,37506,4,0,-4
37506,37506,37507,0,5,5
37507,37507,37508,5,7,2
37508,37508,37509,7,6,-1
37509,37509,37510,6,0,-6
37510,37510,37511,0,0,0
37511,37511,37512,0,8,8
37512,37512,37513,8,1,-7
37513,37513,37514,1,2,1
37514,37514,37515,2,2,0
37515,37515,37516,2,4,2
37516,37516,37517,4,3,-1
37517,37517,37518,3,1,-2
37518,37518,37519,1,4,3
37519,37519,37520,4,9,5
37520,37520,37521,9,5,-4
37521,37521,37522,5,8,3
37522,37522,37523,8,6,-2
37523,37523,37524,6,3,-3
37524,37524,37525,3,7,4
37525,37525,37526,7,2,-5
37526,37526,37527,2,8,6
37527,37527,37528,8,4,-4
37528,37528,37529,4,0,-4
37529,37529,37530,0,4,4
37530,37530,37531,4,1,-3
37531,37531,37532,1,2,1
37532,37532,37533,2,2,0
37533,37533,37534,2,9,7
37534,37534,37535,9,6,-3
37535,37535,37536,6,7,1
37536,37536,37537,7,7,0
37537,37537,37538,7,9,2
37538,37538,37539,9,8,-1
37539,37539,37540,8,3,-5
37540,37540,37541,3,9,6
37541,37541,37542,9,6,-3
37542,37542,37543,6,0,-6
37543,37543,37544,0,6,6
37544,37544,37545,6,2,-4
37545,37545,37546,2,4,2
37546,37546,37547,4,1,-3
37547,37547,37548,1,5,4
37548,37548,37549,5,6,1
37549,37549,37550,6,7,1
37550,37550,37551,7,5,-2
37551,37551,37552,5,5,0
37552,37552,37553,5,9,4
37553,37553,37554,9,0,-9
37554,37554,37555,0,3,3
37555,37555,37556,3,7,4
37556,37556,37557,7,5,-2
37557,37557,37558,5,5,0
37558,37558,37559,5,0,-5
37559,37559,37560,0,2,2
37560,37560,37561,2,7,5
37561,37561,37562,7,4,-3
37562,37562,37563,4,1,-3
37563,37563,37564,1,1,0
37564,37564,37565,1,1,0
37565,37565,37566,1,3,2
37566,37566,37567,3,5,2
37567,37567,37568,5,2,-3
37568,37568,37569,2,3,1
37569,37569,37570,3,2,-1
37570,37570,37571,2,0,-2
37571,37571,37572,0,3,3
37572,37572,37573,3,7,4
37573,37573,37574,7,5,-2
37574,37574,37575,5,9,4
37575,37575,37576,9,6,-3
37576,37576,37577,6,6,0
37577,37577,37578,6,3,-3
37578,37578,37579,3,1,-2
37579,37579,37580,1,2,1
37580,37580,37581,2,6,4
37581,37581,37582,6,5,-1
37582,37582,37583,5,7,2
37583,37583,37584,7,5,-2
37584,37584,37585,5,4,-1
37585,37585,37586,4,9,5
37586,37586,37587,9,9,0
37587,37587,37588,9,2,-7
37588,37588,37589,2,5,3
37589,37589,37590,5,5,0
37590,37590,37591,5,7,2
37591,37591,37592,7,5,-2
37592,37592,37593,5,9,4
37593,37593,37594,9,4,-5
37594,37594,37595,4,8,4
37595,37595,37596,8,7,-1
37596,37596,37597,7,5,-2
37597,37597,37598,5,1,-4
37598,37598,37599,1,6,5
37599,37599,37600,6,8,2
37600,37600,37601,8,2,-6
37601,37601,37602,2,7,5
37602,37602,37603,7,4,-3
37603,37603,37604,4,3,-1
37604,37604,37605,3,8,5
37605,37605,37606,8,5,-3
37606,37606,37607,5,1,-4
37607,37607,37608,1,8,7
37608,37608,37609,8,5,-3
37609,37609,37610,5,2,-3
37610,37610,37611,2,9,7
37611,37611,37612,9,7,-2
37612,37612,37613,7,2,-5
37613,37613,37614,2,1,-1
37614,37614,37615,1,2,1
37615,37615,37616,2,4,2
37616,37616,37617,4,8,4
37617,37617,37618,8,1,-7
37618,37618,37619,1,0,-1
37619,37619,37620,0,8,8
37620,37620,37621,8,6,-2
37621,37621,37622,6,3,-3
37622,37622,37623,3,4,1
37623,37623,37624,4,1,-3
37624,37624,37625,1,3,2
37625,37625,37626,3,3,0
37626,37626,37627,3,3,0
37627,37627,37628,3,8,5
37628,37628,37629,8,1,-7
37629,37629,37630,1,2,1
37630,37630,37631,2,2,0
37631,37631,37632,2,2,0
37632,37632,37633,2,4,2
37633,37633,37634,4,4,0
37634,37634,37635,4,1,-3
37635,37635,37636,1,3,2
37636,37636,37637,3,9,6
37637,37637,37638,9,2,-7
37638,37638,37639,2,6,4
37639,37639,37640,6,4,-2
37640,37640,37641,4,9,5
37641,37641,37642,9,0,-9
37642,37642,37643,0,3,3
37643,37643,37644,3,8,5
37644,37644,37645,8,4,-4
37645,37645,37646,4,2,-2
37646,37646,37647,2,0,-2
37647,37647,37648,0,4,4
37648,37648,37649,4,3,-1
37649,37649,37650,3,1,-2
37650,37650,37651,1,9,8
37651,37651,37652,9,3,-6
37652,37652,37653,3,0,-3
37653,37653,37654,0,9,9
37654,37654,37655,9,2,-7
37655,37655,37656,2,0,-2
37656,37656,37657,0,7,7
37657,37657,37658,7,3,-4
37658,37658,37659,3,1,-2
37659,37659,37660,1,2,1
37660,37660,37661,2,1,-1
37661,37661,37662,1,5,4
37662,37662,37663,5,0,-5
37663,37663,37664,0,9,9
37664,37664,37665,9,7,-2
37665,37665,37666,7,6,-1
37666,37666,37667,6,6,0
37667,37667,37668,6,2,-4
37668,37668,37669,2,2,0
37669,37669,37670,2,1,-1
37670,37670,37671,1,2,1
37671,37671,37672,2,8,6
37672,37672,37673,8,7,-1
37673,37673,37674,7,1,-6
37674,37674,37675,1,6,5
37675,37675,37676,6,6,0
37676,37676,37677,6,0,-6
37677,37677,37678,0,0,0
37678,37678,37679,0,6,6
37679,37679,37680,6,5,-1
37680,37680,37681,5,9,4
37681,37681,37682,9,9,0
37682,37682,37683,9,4,-5
37683,37683,37684,4,7,3
37684,37684,37685,7,8,1
37685,37685,37686,8,0,-8
37686,37686,37687,0,4,4
37687,37687,37688,4,9,5
37688,37688,37689,9,3,-6
37689,37689,37690,3,3,0
37690,37690,37691,3,3,0
37691,37691,37692,3,3,0
37692,37692,37693,3,7,4
37693,37693,37694,7,7,0
37694,37694,37695,7,8,1
37695,37695,37696,8,2,-6
37696,37696,37697,2,0,-2
37697,37697,37698,0,5,5
37698,37698,37699,5,5,0
37699,37699,37700,5,3,-2
37700,37700,37701,3,8,5
37701,37701,37702,8,9,1
37702,37702,37703,9,3,-6
37703,37703,37704,3,8,5
37704,37704,37705,8,0,-8
37705,37705,37706,0,7,7
37706,37706,37707,7,6,-1
37707,37707,37708,6,0,-6
37708,37708,37709,0,8,8
37709,37709,37710,8,8,0
37710,37710,37711,8,3,-5
37711,37711,37712,3,4,1
37712,37712,37713,4,7,3
37713,37713,37714,7,0,-7
37714,37714,37715,0,8,8
37715,37715,37716,8,1,-7
37716,37716,37717,1,5,4
37717,37717,37718,5,3,-2
37718,37718,37719,3,1,-2
37719,37719,37720,1,8,7
37720,37720,37721,8,8,0
37721,37721,37722,8,4,-4
37722,37722,37723,4,0,-4
37723,37723,37724,0,6,6
37724,37724,37725,6,1,-5
37725,37725,37726,1,5,4
37726,37726,37727,5,2,-3
37727,37727,37728,2,1,-1
37728,37728,37729,1,3,2
37729,37729,37730,3,3,0
37730,37730,37731,3,4,1
37731,37731,37732,4,1,-3
37732,37732,37733,1,7,6
37733,37733,37734,7,2,-5
37734,37734,37735,2,8,6
37735,37735,37736,8,4,-4
37736,37736,37737,4,9,5
37737,37737,37738,9,0,-9
37738,37738,37739,0,0,0
37739,37739,37740,0,5,5
37740,37740,37741,5,1,-4
37741,37741,37742,1,1,0
37742,37742,37743,1,2,1
37743,37743,37744,2,0,-2
37744,37744,37745,0,3,3
37745,37745,37746,3,3,0
37746,37746,37747,3,4,1
37747,37747,37748,4,9,5
37748,37748,37749,9,5,-4
37749,37749,37750,5,5,0
37750,37750,37751,5,6,1
37751,37751,37752,6,0,-6
37752,37752,37753,0,7,7
37753,37753,37754,7,9,2
37754,37754,37755,9,8,-1
37755,37755,37756,8,3,-5
37756,37756,37757,3,9,6
37757,37757,37758,9,0,-9
37758,37758,37759,0,0,0
37759,37759,37760,0,2,2
37760,37760,37761,2,1,-1
37761,37761,37762,1,7,6
37762,37762,37763,7,2,-5
37763,37763,37764,2,9,7
37764,37764,37765,9,3,-6
37765,37765,37766,3,2,-1
37766,37766,37767,2,4,2
37767,37767,37768,4,8,4
37768,37768,37769,8,7,-1
37769,37769,37770,7,7,0
37770,37770,37771,7,8,1
37771,37771,37772,8,9,1
37772,37772,37773,9,9,0
37773,37773,37774,9,8,-1
37774,37774,37775,8,7,-1
37775,37775,37776,7,8,1
37776,37776,37777,8,2,-6
37777,37777,37778,2,8,6
37778,37778,37779,8,9,1
37779,37779,37780,9,0,-9
37780,37780,37781,0,9,9
37781,37781,37782,9,1,-8
37782,37782,37783,1,8,7
37783,37783,37784,8,7,-1
37784,37784,37785,7,4,-3
37785,37785,37786,4,3,-1
37786,37786,37787,3,0,-3
37787,37787,37788,0,6,6
37788,37788,37789,6,3,-3
37789,37789,37790,3,0,-3
37790,37790,37791,0,5,5
37791,37791,37792,5,3,-2
37792,37792,37793,3,4,1
37793,37793,37794,4,4,0
37794,37794,37795,4,3,-1
37795,37795,37796,3,3,0
37796,37796,37797,3,3,0
37797,37797,37798,3,2,-1
37798,37798,37799,2,4,2
37799,37799,37800,4,4,0
37800,37800,37801,4,6,2
37801,37801,37802,6,1,-5
37802,37802,37803,1,6,5
37803,37803,37804,6,6,0
37804,37804,37805,6,5,-1
37805,37805,37806,5,2,-3
37806,37806,37807,2,5,3
37807,37807,37808,5,8,3
37808,37808,37809,8,1,-7
37809,37809,37810,1,8,7
37810,37810,37811,8,7,-1
37811,37811,37812,7,2,-5
37812,37812,37813,2,8,6
37813,37813,37814,8,0,-8
37814,37814,37815,0,4,4
37815,37815,37816,4,1,-3
37816,37816,37817,1,5,4
37817,37817,37818,5,7,2
37818,37818,37819,7,7,0
37819,37819,37820,7,5,-2
37820,37820,37821,5,3,-2
37821,37821,37822,3,0,-3
37822,37822,37823,0,5,5
37823,37823,37824,5,9,4
37824,37824,37825,9,2,-7
37825,37825,37826,2,4,2
37826,37826,37827,4,3,-1
37827,37827,37828,3,1,-2
37828,37828,37829,1,6,5
37829,37829,37830,6,5,-1
37830,37830,37831,5,6,1
37831,37831,37832,6,2,-4
37832,37832,37833,2,7,5
37833,37833,37834,7,7,0
37834,37834,37835,7,7,0
37835,37835,37836,7,5,-2
37836,37836,37837,5,0,-5
37837,37837,37838,0,2,2
37838,37838,37839,2,1,-1
37839,37839,37840,1,4,3
37840,37840,37841,4,0,-4
37841,37841,37842,0,5,5
37842,37842,37843,5,1,-4
37843,37843,37844,1,0,-1
37844,37844,37845,0,6,6
37845,37845,37846,6,4,-2
37846,37846,37847,4,3,-1
37847,37847,37848,3,3,0
37848,37848,37849,3,1,-2
37849,37849,37850,1,5,4
37850,37850,37851,5,4,-1
37851,37851,37852,4,5,1
37852,37852,37853,5,7,2
37853,37853,37854,7,0,-7
37854,37854,37855,0,3,3
37855,37855,37856,3,0,-3
37856,37856,37857,0,8,8
37857,37857,37858,8,4,-4
37858,37858,37859,4,6,2
37859,37859,37860,6,3,-3
37860,37860,37861,3,2,-1
37861,37861,37862,2,1,-1
37862,37862,37863,1,2,1
37863,37863,37864,2,5,3
37864,37864,37865,5,5,0
37865,37865,37866,5,9,4
37866,37866,37867,9,9,0
37867,37867,37868,9,8,-1
37868,37868,37869,8,1,-7
37869,37869,37870,1,8,7
37870,37870,37871,8,7,-1
37871,37871,37872,7,6,-1
37872,37872,37873,6,9,3
37873,37873,37874,9,5,-4
37874,37874,37875,5,7,2
37875,37875,37876,7,7,0
37876,37876,37877,7,9,2
37877,37877,37878,9,7,-2
37878,37878,37879,7,9,2
37879,37879,37880,9,2,-7
37880,37880,37881,2,1,-1
37881,37881,37882,1,1,0
37882,37882,37883,1,0,-1
37883,37883,37884,0,4,4
37884,37884,37885,4,8,4
37885,37885,37886,8,3,-5
37886,37886,37887,3,9,6
37887,37887,37888,9,6,-3
37888,37888,37889,6,3,-3
37889,37889,37890,3,3,0
37890,37890,37891,3,8,5
37891,37891,37892,8,6,-2
37892,37892,37893,6,4,-2
37893,37893,37894,4,5,1
37894,37894,37895,5,6,1
37895,37895,37896,6,3,-3
37896,37896,37897,3,1,-2
37897,37897,37898,1,7,6
37898,37898,37899,7,4,-3
37899,37899,37900,4,7,3
37900,37900,37901,7,0,-7
37901,37901,37902,0,0,0
37902,37902,37903,0,3,3
37903,37903,37904,3,2,-1
37904,37904,37905,2,6,4
37905,37905,37906,6,9,3
37906,37906,37907,9,4,-5
37907,37907,37908,4,3,-1
37908,37908,37909,3,8,5
37909,37909,37910,8,8,0
37910,37910,37911,8,1,-7
37911,37911,37912,1,3,2
37912,37912,37913,3,3,0
37913,37913,37914,3,0,-3
37914,37914,37915,0,1,1
37915,37915,37916,1,4,3
37916,37916,37917,4,0,-4
37917,37917,37918,0,2,2
37918,37918,37919,2,9,7
37919,37919,37920,9,1,-8
37920,37920,37921,1,0,-1
37921,37921,37922,0,7,7
37922,37922,37923,7,1,-6
37923,37923,37924,1,8,7
37924,37924,37925,8,2,-6
37925,37925,37926,2,1,-1
37926,37926,37927,1,3,2
37927,37927,37928,3,3,0
37928,37928,37929,3,5,2
37929,37929,37930,5,7,2
37930,37930,37931,7,6,-1
37931,37931,37932,6,9,3
37932,37932,37933,9,8,-1
37933,37933,37934,8,9,1
37934,37934,37935,9,9,0
37935,37935,37936,9,1,-8
37936,37936,37937,1,0,-1
37937,37937,37938,0,1,1
37938,37938,37939,1,1,0
37939,37939,37940,1,3,2
37940,37940,37941,3,2,-1
37941,37941,37942,2,2,0
37942,37942,37943,2,3,1
37943,37943,37944,3,3,0
37944,37944,37945,3,4,1
37945,37945,37946,4,0,-4
37946,37946,37947,0,7,7
37947,37947,37948,7,1,-6
37948,37948,37949,1,8,7
37949,37949,37950,8,0,-8
37950,37950,37951,0,9,9
37951,37951,37952,9,8,-1
37952,37952,37953,8,0,-8
37953,37953,37954,0,0,0
37954,37954,37955,0,1,1
37955,37955,37956,1,8,7
37956,37956,37957,8,2,-6
37957,37957,37958,2,4,2
37958,37958,37959,4,3,-1
37959,37959,37960,3,7,4
37960,37960,37961,7,4,-3
37961,37961,37962,4,8,4
37962,37962,37963,8,7,-1
37963,37963,37964,7,2,-5
37964,37964,37965,2,9,7
37965,37965,37966,9,6,-3
37966,37966,37967,6,2,-4
37967,37967,37968,2,0,-2
37968,37968,37969,0,2,2
37969,37969,37970,2,0,-2
37970,37970,37971,0,7,7
37971,37971,37972,7,1,-6
37972,37972,37973,1,6,5
37973,37973,37974,6,2,-4
37974,37974,37975,2,4,2
37975,37975,37976,4,9,5
37976,37976,37977,9,0,-9
37977,37977,37978,0,1,1
37978,37978,37979,1,8,7
37979,37979,37980,8,0,-8
37980,37980,37981,0,0,0
37981,37981,37982,0,6,6
37982,37982,37983,6,5,-1
37983,37983,37984,5,7,2
37984,37984,37985,7,2,-5
37985,37985,37986,2,4,2
37986,37986,37987,4,7,3
37987,37987,37988,7,4,-3
37988,37988,37989,4,2,-2
37989,37989,37990,2,6,4
37990,37990,37991,6,3,-3
37991,37991,37992,3,5,2
37992,37992,37993,5,6,1
37993,37993,37994,6,7,1
37994,37994,37995,7,2,-5
37995,37995,37996,2,3,1
37996,37996,37997,3,1,-2
37997,37997,37998,1,6,5
37998,37998,37999,6,7,1
37999,37999,38000,7,8,1
38000,38000,38001,8,7,-1
38001,38001,38002,7,1,-6
38002,38002,38003,1,9,8
38003,38003,38004,9,7,-2
38004,38004,38005,7,9,2
38005,38005,38006,9,9,0
38006,38006,38007,9,1,-8
38007,38007,38008,1,0,-1
38008,38008,38009,0,2,2
38009,38009,38010,2,2,0
38010,38010,38011,2,4,2
38011,38011,38012,4,4,0
38012,38012,38013,4,6,2
38013,38013,38014,6,8,2
38014,38014,38015,8,7,-1
38015,38015,38016,7,1,-6
38016,38016,38017,1,7,6
38017,38017,38018,7,7,0
38018,38018,38019,7,5,-2
38019,38019,38020,5,9,4
38020,38020,38021,9,4,-5
38021,38021,38022,4,6,2
38022,38022,38023,6,5,-1
38023,38023,38024,5,2,-3
38024,38024,38025,2,0,-2
38025,38025,38026,0,7,7
38026,38026,38027,7,1,-6
38027,38027,38028,1,6,5
38028,38028,38029,6,1,-5
38029,38029,38030,1,9,8
38030,38030,38031,9,9,0
38031,38031,38032,9,6,-3
38032,38032,38033,6,2,-4
38033,38033,38034,2,7,5
38034,38034,38035,7,0,-7
38035,38035,38036,0,2,2
38036,38036,38037,2,3,1
38037,38037,38038,3,5,2
38038,38038,38039,5,1,-4
38039,38039,38040,1,2,1
38040,38040,38041,2,4,2
38041,38041,38042,4,0,-4
38042,38042,38043,0,0,0
38043,38043,38044,0,8,8
38044,38044,38045,8,6,-2
38045,38045,38046,6,9,3
38046,38046,38047,9,4,-5
38047,38047,38048,4,9,5
38048,38048,38049,9,3,-6
38049,38049,38050,3,6,3
38050,38050,38051,6,9,3
38051,38051,38052,9,4,-5
38052,38052,38053,4,3,-1
38053,38053,38054,3,0,-3
38054,38054,38055,0,0,0
38055,38055,38056,0,1,1
38056,38056,38057,1,0,-1
38057,38057,38058,0,3,3
38058,38058,38059,3,5,2
38059,38059,38060,5,5,0
38060,38060,38061,5,2,-3
38061,38061,38062,2,0,-2
38062,38062,38063,0,8,8
38063,38063,38064,8,9,1
38064,38064,38065,9,8,-1
38065,38065,38066,8,3,-5
38066,38066,38067,3,8,5
38067,38067,38068,8,2,-6
38068,38068,38069,2,8,6
38069,38069,38070,8,2,-6
38070,38070,38071,2,5,3
38071,38071,38072,5,4,-1
38072,38072,38073,4,5,1
38073,38073,38074,5,8,3
38074,38074,38075,8,7,-1
38075,38075,38076,7,7,0
38076,38076,38077,7,1,-6
38077,38077,38078,1,2,1
38078,38078,38079,2,4,2
38079,38079,38080,4,2,-2
38080,38080,38081,2,1,-1
38081,38081,38082,1,9,8
38082,38082,38083,9,3,-6
38083,38083,38084,3,6,3
38084,38084,38085,6,8,2
38085,38085,38086,8,3,-5
38086,38086,38087,3,9,6
38087,38087,38088,9,7,-2
38088,38088,38089,7,3,-4
38089,38089,38090,3,5,2
38090,38090,38091,5,7,2
38091,38091,38092,7,8,1
38092,38092,38093,8,4,-4
38093,38093,38094,4,2,-2
38094,38094,38095,2,1,-1
38095,38095,38096,1,7,6
38096,38096,38097,7,1,-6
38097,38097,38098,1,7,6
38098,38098,38099,7,0,-7
38099,38099,38100,0,0,0
38100,38100,38101,0,6,6
38101,38101,38102,6,0,-6
38102,38102,38103,0,0,0
38103,38103,38104,0,6,6
38104,38104,38105,6,1,-5
38105,38105,38106,1,0,-1
38106,38106,38107,0,2,2
38107,38107,38108,2,2,0
38108,38108,38109,2,3,1
38109,38109,38110,3,0,-3
38110,38110,38111,0,4,4
38111,38111,38112,4,8,4
38112,38112,38113,8,5,-3
38113,38113,38114,5,6,1
38114,38114,38115,6,6,0
38115,38115,38116,6,3,-3
38116,38116,38117,3,7,4
38117,38117,38118,7,9,2
38118,38118,38119,9,8,-1
38119,38119,38120,8,2,-6
38120,38120,38121,2,9,7
38121,38121,38122,9,4,-5
38122,38122,38123,4,0,-4
38123,38123,38124,0,2,2
38124,38124,38125,2,1,-1
38125,38125,38126,1,0,-1
38126,38126,38127,0,2,2
38127,38127,38128,2,0,-2
38128,38128,38129,0,3,3
38129,38129,38130,3,3,0
38130,38130,38131,3,4,1
38131,38131,38132,4,4,0
38132,38132,38133,4,7,3
38133,38133,38134,7,5,-2
38134,38134,38135,5,8,3
38135,38135,38136,8,8,0
38136,38136,38137,8,9,1
38137,38137,38138,9,0,-9
38138,38138,38139,0,0,0
38139,38139,38140,0,2,2
38140,38140,38141,2,1,-1
38141,38141,38142,1,8,7
38142,38142,38143,8,2,-6
38143,38143,38144,2,7,5
38144,38144,38145,7,3,-4
38145,38145,38146,3,8,5
38146,38146,38147,8,4,-4
38147,38147,38148,4,2,-2
38148,38148,38149,2,7,5
38149,38149,38150,7,4,-3
38150,38150,38151,4,8,4
38151,38151,38152,8,6,-2
38152,38152,38153,6,9,3
38153,38153,38154,9,9,0
38154,38154,38155,9,0,-9
38155,38155,38156,0,6,6
38156,38156,38157,6,0,-6
38157,38157,38158,0,8,8
38158,38158,38159,8,1,-7
38159,38159,38160,1,1,0
38160,38160,38161,1,0,-1
38161,38161,38162,0,0,0
38162,38162,38163,0,1,1
38163,38163,38164,1,1,0
38164,38164,38165,1,5,4
38165,38165,38166,5,3,-2
38166,38166,38167,3,3,0
38167,38167,38168,3,4,1
38168,38168,38169,4,4,0
38169,38169,38170,4,2,-2
38170,38170,38171,2,2,0
38171,38171,38172,2,6,4
38172,38172,38173,6,4,-2
38173,38173,38174,4,3,-1
38174,38174,38175,3,4,1
38175,38175,38176,4,6,2
38176,38176,38177,6,0,-6
38177,38177,38178,0,7,7
38178,38178,38179,7,0,-7
38179,38179,38180,0,3,3
38180,38180,38181,3,6,3
38181,38181,38182,6,9,3
38182,38182,38183,9,9,0
38183,38183,38184,9,7,-2
38184,38184,38185,7,6,-1
38185,38185,38186,6,7,1
38186,38186,38187,7,6,-1
38187,38187,38188,6,4,-2
38188,38188,38189,4,5,1
38189,38189,38190,5,6,1
38190,38190,38191,6,7,1
38191,38191,38192,7,6,-1
38192,38192,38193,6,3,-3
38193,38193,38194,3,5,2
38194,38194,38195,5,2,-3
38195,38195,38196,2,1,-1
38196,38196,38197,1,2,1
38197,38197,38198,2,0,-2
38198,38198,38199,0,3,3
38199,38199,38200,3,0,-3
38200,38200,38201,0,4,4
38201,38201,38202,4,5,1
38202,38202,38203,5,4,-1
38203,38203,38204,4,9,5
38204,38204,38205,9,9,0
38205,38205,38206,9,1,-8
38206,38206,38207,1,1,0
38207,38207,38208,1,2,1
38208,38208,38209,2,4,2
38209,38209,38210,4,7,3
38210,38210,38211,7,0,-7
38211,38211,38212,0,0,0
38212,38212,38213,0,7,7
38213,38213,38214,7,6,-1
38214,38214,38215,6,7,1
38215,38215,38216,7,2,-5
38216,38216,38217,2,5,3
38217,38217,38218,5,3,-2
38218,38218,38219,3,6,3
38219,38219,38220,6,7,1
38220,38220,38221,7,2,-5
38221,38221,38222,2,5,3
38222,38222,38223,5,3,-2
38223,38223,38224,3,7,4
38224,38224,38225,7,1,-6
38225,38225,38226,1,1,0
38226,38226,38227,1,4,3
38227,38227,38228,4,0,-4
38228,38228,38229,0,4,4
38229,38229,38230,4,9,5
38230,38230,38231,9,0,-9
38231,38231,38232,0,0,0
38232,38232,38233,0,9,9
38233,38233,38234,9,5,-4
38234,38234,38235,5,1,-4
38235,38235,38236,1,4,3
38236,38236,38237,4,8,4
38237,38237,38238,8,3,-5
38238,38238,38239,3,3,0
38239,38239,38240,3,5,2
38240,38240,38241,5,3,-2
38241,38241,38242,3,7,4
38242,38242,38243,7,7,0
38243,38243,38244,7,7,0
38244,38244,38245,7,3,-4
38245,38245,38246,3,7,4
38246,38246,38247,7,9,2
38247,38247,38248,9,9,0
38248,38248,38249,9,8,-1
38249,38249,38250,8,5,-3
38250,38250,38251,5,8,3
38251,38251,38252,8,5,-3
38252,38252,38253,5,4,-1
38253,38253,38254,4,5,1
38254,38254,38255,5,7,2
38255,38255,38256,7,2,-5
38256,38256,38257,2,7,5
38257,38257,38258,7,6,-1
38258,38258,38259,6,6,0
38259,38259,38260,6,6,0
38260,38260,38261,6,2,-4
38261,38261,38262,2,4,2
38262,38262,38263,4,1,-3
38263,38263,38264,1,1,0
38264,38264,38265,1,9,8
38265,38265,38266,9,5,-4
38266,38266,38267,5,8,3
38267,38267,38268,8,2,-6
38268,38268,38269,2,7,5
38269,38269,38270,7,4,-3
38270,38270,38271,4,8,4
38271,38271,38272,8,1,-7
38272,38272,38273,1,8,7
38273,38273,38274,8,4,-4
38274,38274,38275,4,2,-2
38275,38275,38276,2,1,-1
38276,38276,38277,1,3,2
38277,38277,38278,3,7,4
38278,38278,38279,7,9,2
38279,38279,38280,9,5,-4
38280,38280,38281,5,3,-2
38281,38281,38282,3,7,4
38282,38282,38283,7,3,-4
38283,38283,38284,3,4,1
38284,38284,38285,4,5,1
38285,38285,38286,5,4,-1
38286,38286,38287,4,5,1
38287,38287,38288,5,2,-3
38288,38288,38289,2,0,-2
38289,38289,38290,0,6,6
38290,38290,38291,6,7,1
38291,38291,38292,7,9,2
38292,38292,38293,9,9,0
38293,38293,38294,9,3,-6
38294,38294,38295,3,5,2
38295,38295,38296,5,4,-1
38296,38296,38297,4,0,-4
38297,38297,38298,0,5,5
38298,38298,38299,5,6,1
38299,38299,38300,6,7,1
38300,38300,38301,7,4,-3
38301,38301,38302,4,6,2
38302,38302,38303,6,1,-5
38303,38303,38304,1,7,6
38304,38304,38305,7,1,-6
38305,38305,38306,1,6,5
38306,38306,38307,6,2,-4
38307,38307,38308,2,6,4
38308,38308,38309,6,8,2
38309,38309,38310,8,0,-8
38310,38310,38311,0,1,1
38311,38311,38312,1,9,8
38312,38312,38313,9,5,-4
38313,38313,38314,5,5,0
38314,38314,38315,5,0,-5
38315,38315,38316,0,4,4
38316,38316,38317,4,1,-3
38317,38317,38318,1,6,5
38318,38318,38319,6,2,-4
38319,38319,38320,2,7,5
38320,38320,38321,7,3,-4
38321,38321,38322,3,6,3
38322,38322,38323,6,4,-2
38323,38323,38324,4,8,4
38324,38324,38325,8,5,-3
38325,38325,38326,5,2,-3
38326,38326,38327,2,6,4
38327,38327,38328,6,1,-5
38328,38328,38329,1,7,6
38329,38329,38330,7,2,-5
38330,38330,38331,2,8,6
38331,38331,38332,8,0,-8
38332,38332,38333,0,9,9
38333,38333,38334,9,6,-3
38334,38334,38335,6,0,-6
38335,38335,38336,0,4,4
38336,38336,38337,4,1,-3
38337,38337,38338,1,7,6
38338,38338,38339,7,2,-5
38339,38339,38340,2,1,-1
38340,38340,38341,1,3,2
38341,38341,38342,3,6,3
38342,38342,38343,6,4,-2
38343,38343,38344,4,9,5
38344,38344,38345,9,5,-4
38345,38345,38346,5,3,-2
38346,38346,38347,3,6,3
38347,38347,38348,6,6,0
38348,38348,38349,6,7,1
38349,38349,38350,7,7,0
38350,38350,38351,7,8,1
38351,38351,38352,8,6,-2
38352,38352,38353,6,9,3
38353,38353,38354,9,2,-7
38354,38354,38355,2,0,-2
38355,38355,38356,0,2,2
38356,38356,38357,2,1,-1
38357,38357,38358,1,9,8
38358,38358,38359,9,2,-7
38359,38359,38360,2,5,3
38360,38360,38361,5,3,-2
38361,38361,38362,3,5,2
38362,38362,38363,5,4,-1
38363,38363,38364,4,0,-4
38364,38364,38365,0,5,5
38365,38365,38366,5,2,-3
38366,38366,38367,2,6,4
38367,38367,38368,6,3,-3
38368,38368,38369,3,9,6
38369,38369,38370,9,4,-5
38370,38370,38371,4,6,2
38371,38371,38372,6,4,-2
38372,38372,38373,4,4,0
38373,38373,38374,4,7,3
38374,38374,38375,7,4,-3
38375,38375,38376,4,6,2
38376,38376,38377,6,3,-3
38377,38377,38378,3,5,2
38378,38378,38379,5,6,1
38379,38379,38380,6,0,-6
38380,38380,38381,0,2,2
38381,38381,38382,2,8,6
38382,38382,38383,8,3,-5
38383,38383,38384,3,1,-2
38384,38384,38385,1,4,3
38385,38385,38386,4,8,4
38386,38386,38387,8,8,0
38387,38387,38388,8,1,-7
38388,38388,38389,1,7,6
38389,38389,38390,7,6,-1
38390,38390,38391,6,8,2
38391,38391,38392,8,4,-4
38392,38392,38393,4,6,2
38393,38393,38394,6,6,0
38394,38394,38395,6,9,3
38395,38395,38396,9,2,-7
38396,38396,38397,2,8,6
38397,38397,38398,8,1,-7
38398,38398,38399,1,3,2
38399,38399,38400,3,6,3
38400,38400,38401,6,2,-4
38401,38401,38402,2,4,2
38402,38402,38403,4,2,-2
38403,38403,38404,2,0,-2
38404,38404,38405,0,8,8
38405,38405,38406,8,2,-6
38406,38406,38407,2,4,2
38407,38407,38408,4,5,1
38408,38408,38409,5,2,-3
38409,38409,38410,2,3,1
38410,38410,38411,3,0,-3
38411,38411,38412,0,0,0
38412,38412,38413,0,1,1
38413,38413,38414,1,5,4
38414,38414,38415,5,1,-4
38415,38415,38416,1,6,5
38416,38416,38417,6,2,-4
38417,38417,38418,2,8,6
38418,38418,38419,8,9,1
38419,38419,38420,9,8,-1
38420,38420,38421,8,6,-2
38421,38421,38422,6,7,1
38422,38422,38423,7,8,1
38423,38423,38424,8,1,-7
38424,38424,38425,1,1,0
38425,38425,38426,1,9,8
38426,38426,38427,9,2,-7
38427,38427,38428,2,4,2
38428,38428,38429,4,0,-4
38429,38429,38430,0,2,2
38430,38430,38431,2,6,4
38431,38431,38432,6,1,-5
38432,38432,38433,1,5,4
38433,38433,38434,5,8,3
38434,38434,38435,8,2,-6
38435,38435,38436,2,1,-1
38436,38436,38437,1,7,6
38437,38437,38438,7,2,-5
38438,38438,38439,2,5,3
38439,38439,38440,5,0,-5
38440,38440,38441,0,3,3
38441,38441,38442,3,8,5
38442,38442,38443,8,9,1
38443,38443,38444,9,6,-3
38444,38444,38445,6,3,-3
38445,38445,38446,3,0,-3
38446,38446,38447,0,7,7
38447,38447,38448,7,6,-1
38448,38448,38449,6,1,-5
38449,38449,38450,1,6,5
38450,38450,38451,6,3,-3
38451,38451,38452,3,8,5
38452,38452,38453,8,8,0
38453,38453,38454,8,1,-7
38454,38454,38455,1,1,0
38455,38455,38456,1,9,8
38456,38456,38457,9,9,0
38457,38457,38458,9,7,-2
38458,38458,38459,7,5,-2
38459,38459,38460,5,6,1
38460,38460,38461,6,0,-6
38461,38461,38462,0,1,1
38462,38462,38463,1,1,0
38463,38463,38464,1,1,0
38464,38464,38465,1,1,0
38465,38465,38466,1,1,0
38466,38466,38467,1,9,8
38467,38467,38468,9,7,-2
38468,38468,38469,7,2,-5
38469,38469,38470,2,9,7
38470,38470,38471,9,6,-3
38471,38471,38472,6,6,0
38472,38472,38473,6,0,-6
38473,38473,38474,0,6,6
38474,38474,38475,6,4,-2
38475,38475,38476,4,8,4
38476,38476,38477,8,5,-3
38477,38477,38478,5,6,1
38478,38478,38479,6,6,0
38479,38479,38480,6,1,-5
38480,38480,38481,1,5,4
38481,38481,38482,5,1,-4
38482,38482,38483,1,0,-1
38483,38483,38484,0,0,0
38484,38484,38485,0,3,3
38485,38485,38486,3,5,2
38486,38486,38487,5,1,-4
38487,38487,38488,1,0,-1
38488,38488,38489,0,8,8
38489,38489,38490,8,1,-7
38490,38490,38491,1,6,5
38491,38491,38492,6,1,-5
38492,38492,38493,1,9,8
38493,38493,38494,9,0,-9
38494,38494,38495,0,3,3
38495,38495,38496,3,4,1
38496,38496,38497,4,0,-4
38497,38497,38498,0,4,4
38498,38498,38499,4,1,-3
38499,38499,38500,1,4,3
38500,38500,38501,4,0,-4
38501,38501,38502,0,7,7
38502,38502,38503,7,4,-3
38503,38503,38504,4,7,3
38504,38504,38505,7,7,0
38505,38505,38506,7,7,0
38506,38506,38507,7,3,-4
38507,38507,38508,3,5,2
38508,38508,38509,5,2,-3
38509,38509,38510,2,8,6
38510,38510,38511,8,6,-2
38511,38511,38512,6,5,-1
38512,38512,38513,5,5,0
38513,38513,38514,5,6,1
38514,38514,38515,6,4,-2
38515,38515,38516,4,1,-3
38516,38516,38517,1,7,6
38517,38517,38518,7,4,-3
38518,38518,38519,4,9,5
38519,38519,38520,9,3,-6
38520,38520,38521,3,7,4
38521,38521,38522,7,1,-6
38522,38522,38523,1,0,-1
38523,38523,38524,0,4,4
38524,38524,38525,4,1,-3
38525,38525,38526,1,1,0
38526,38526,38527,1,2,1
38527,38527,38528,2,1,-1
38528,38528,38529,1,3,2
38529,38529,38530,3,2,-1
38530,38530,38531,2,4,2
38531,38531,38532,4,1,-3
38532,38532,38533,1,5,4
38533,38533,38534,5,7,2
38534,38534,38535,7,6,-1
38535,38535,38536,6,3,-3
38536,38536,38537,3,7,4
38537,38537,38538,7,1,-6
38538,38538,38539,1,8,7
38539,38539,38540,8,0,-8
38540,38540,38541,0,9,9
38541,38541,38542,9,2,-7
38542,38542,38543,2,0,-2
38543,38543,38544,0,8,8
38544,38544,38545,8,1,-7
38545,38545,38546,1,5,4
38546,38546,38547,5,2,-3
38547,38547,38548,2,6,4
38548,38548,38549,6,3,-3
38549,38549,38550,3,7,4
38550,38550,38551,7,4,-3
38551,38551,38552,4,9,5
38552,38552,38553,9,5,-4
38553,38553,38554,5,1,-4
38554,38554,38555,1,6,5
38555,38555,38556,6,7,1
38556,38556,38557,7,7,0
38557,38557,38558,7,1,-6
38558,38558,38559,1,0,-1
38559,38559,38560,0,2,2
38560,38560,38561,2,1,-1
38561,38561,38562,1,9,8
38562,38562,38563,9,2,-7
38563,38563,38564,2,5,3
38564,38564,38565,5,3,-2
38565,38565,38566,3,8,5
38566,38566,38567,8,4,-4
38567,38567,38568,4,4,0
38568,38568,38569,4,5,1
38569,38569,38570,5,1,-4
38570,38570,38571,1,6,5
38571,38571,38572,6,1,-5
38572,38572,38573,1,0,-1
38573,38573,38574,0,0,0
38574,38574,38575,0,7,7
38575,38575,38576,7,6,-1
38576,38576,38577,6,5,-1
38577,38577,38578,5,6,1
38578,38578,38579,6,0,-6
38579,38579,38580,0,3,3
38580,38580,38581,3,8,5
38581,38581,38582,8,1,-7
38582,38582,38583,1,4,3
38583,38583,38584,4,6,2
38584,38584,38585,6,1,-5
38585,38585,38586,1,7,6
38586,38586,38587,7,8,1
38587,38587,38588,8,8,0
38588,38588,38589,8,8,0
38589,38589,38590,8,0,-8
38590,38590,38591,0,1,1
38591,38591,38592,1,5,4
38592,38592,38593,5,3,-2
38593,38593,38594,3,5,2
38594,38594,38595,5,1,-4
38595,38595,38596,1,8,7
38596,38596,38597,8,9,1
38597,38597,38598,9,7,-2
38598,38598,38599,7,0,-7
38599,38599,38600,0,9,9
38600,38600,38601,9,4,-5
38601,38601,38602,4,3,-1
38602,38602,38603,3,4,1
38603,38603,38604,4,5,1
38604,38604,38605,5,0,-5
38605,38605,38606,0,8,8
38606,38606,38607,8,7,-1
38607,38607,38608,7,5,-2
38608,38608,38609,5,2,-3
38609,38609,38610,2,5,3
38610,38610,38611,5,9,4
38611,38611,38612,9,5,-4
38612,38612,38613,5,8,3
38613,38613,38614,8,0,-8
38614,38614,38615,0,7,7
38615,38615,38616,7,4,-3
38616,38616,38617,4,2,-2
38617,38617,38618,2,2,0
38618,38618,38619,2,4,2
38619,38619,38620,4,7,3
38620,38620,38621,7,7,0
38621,38621,38622,7,4,-3
38622,38622,38623,4,8,4
38623,38623,38624,8,5,-3
38624,38624,38625,5,9,4
38625,38625,38626,9,5,-4
38626,38626,38627,5,3,-2
38627,38627,38628,3,5,2
38628,38628,38629,5,1,-4
38629,38629,38630,1,4,3
38630,38630,38631,4,4,0
38631,38631,38632,4,9,5
38632,38632,38633,9,6,-3
38633,38633,38634,6,6,0
38634,38634,38635,6,2,-4
38635,38635,38636,2,2,0
38636,38636,38637,2,2,0
38637,38637,38638,2,8,6
38638,38638,38639,8,7,-1
38639,38639,38640,7,6,-1
38640,38640,38641,6,8,2
38641,38641,38642,8,6,-2
38642,38642,38643,6,6,0
38643,38643,38644,6,0,-6
38644,38644,38645,0,4,4
38645,38645,38646,4,9,5
38646,38646,38647,9,9,0
38647,38647,38648,9,5,-4
38648,38648,38649,5,2,-3
38649,38649,38650,2,7,5
38650,38650,38651,7,9,2
38651,38651,38652,9,2,-7
38652,38652,38653,2,3,1
38653,38653,38654,3,4,1
38654,38654,38655,4,5,1
38655,38655,38656,5,5,0
38656,38656,38657,5,3,-2
38657,38657,38658,3,5,2
38658,38658,38659,5,6,1
38659,38659,38660,6,0,-6
38660,38660,38661,0,6,6
38661,38661,38662,6,0,-6
38662,38662,38663,0,0,0
38663,38663,38664,0,1,1
38664,38664,38665,1,2,1
38665,38665,38666,2,1,-1
38666,38666,38667,1,2,1
38667,38667,38668,2,4,2
38668,38668,38669,4,7,3
38669,38669,38670,7,3,-4
38670,38670,38671,3,4,1
38671,38671,38672,4,7,3
38672,38672,38673,7,9,2
38673,38673,38674,9,9,0
38674,38674,38675,9,5,-4
38675,38675,38676,5,6,1
38676,38676,38677,6,1,-5
38677,38677,38678,1,5,4
38678,38678,38679,5,2,-3
38679,38679,38680,2,9,7
38680,38680,38681,9,6,-3
38681,38681,38682,6,1,-5
38682,38682,38683,1,1,0
38683,38683,38684,1,1,0
38684,38684,38685,1,8,7
38685,38685,38686,8,0,-8
38686,38686,38687,0,3,3
38687,38687,38688,3,7,4
38688,38688,38689,7,5,-2
38689,38689,38690,5,9,4
38690,38690,38691,9,0,-9
38691,38691,38692,0,2,2
38692,38692,38693,2,0,-2
38693,38693,38694,0,6,6
38694,38694,38695,6,6,0
38695,38695,38696,6,0,-6
38696,38696,38697,0,1,1
38697,38697,38698,1,5,4
38698,38698,38699,5,6,1
38699,38699,38700,6,1,-5
38700,38700,38701,1,9,8
38701,38701,38702,9,8,-1
38702,38702,38703,8,6,-2
38703,38703,38704,6,9,3
38704,38704,38705,9,7,-2
38705,38705,38706,7,0,-7
38706,38706,38707,0,1,1
38707,38707,38708,1,5,4
38708,38708,38709,5,1,-4
38709,38709,38710,1,4,3
38710,38710,38711,4,7,3
38711,38711,38712,7,3,-4
38712,38712,38713,3,1,-2
38713,38713,38714,1,3,2
38714,38714,38715,3,2,-1
38715,38715,38716,2,4,2
38716,38716,38717,4,4,0
38717,38717,38718,4,1,-3
38718,38718,38719,1,5,4
38719,38719,38720,5,2,-3
38720,38720,38721,2,6,4
38721,38721,38722,6,0,-6
38722,38722,38723,0,7,7
38723,38723,38724,7,1,-6
38724,38724,38725,1,8,7
38725,38725,38726,8,5,-3
38726,38726,38727,5,9,4
38727,38727,38728,9,7,-2
38728,38728,38729,7,0,-7
38729,38729,38730,0,6,6
38730,38730,38731,6,1,-5
38731,38731,38732,1,3,2
38732,38732,38733,3,2,-1
38733,38733,38734,2,8,6
38734,38734,38735,8,3,-5
38735,38735,38736,3,1,-2
38736,38736,38737,1,4,3
38737,38737,38738,4,7,3
38738,38738,38739,7,5,-2
38739,38739,38740,5,9,4
38740,38740,38741,9,6,-3
38741,38741,38742,6,8,2
38742,38742,38743,8,7,-1
38743,38743,38744,7,0,-7
38744,38744,38745,0,8,8
38745,38745,38746,8,0,-8
38746,38746,38747,0,9,9
38747,38747,38748,9,9,0
38748,38748,38749,9,0,-9
38749,38749,38750,0,1,1
38750,38750,38751,1,1,0
38751,38751,38752,1,3,2
38752,38752,38753,3,2,-1
38753,38753,38754,2,6,4
38754,38754,38755,6,3,-3
38755,38755,38756,3,5,2
38756,38756,38757,5,4,-1
38757,38757,38758,4,7,3
38758,38758,38759,7,5,-2
38759,38759,38760,5,9,4
38760,38760,38761,9,6,-3
38761,38761,38762,6,5,-1
38762,38762,38763,5,7,2
38763,38763,38764,7,1,-6
38764,38764,38765,1,8,7
38765,38765,38766,8,0,-8
38766,38766,38767,0,9,9
38767,38767,38768,9,9,0
38768,38768,38769,9,1,-8
38769,38769,38770,1,2,1
38770,38770,38771,2,3,1
38771,38771,38772,3,3,0
38772,38772,38773,3,5,2
38773,38773,38774,5,1,-4
38774,38774,38775,1,9,8
38775,38775,38776,9,7,-2
38776,38776,38777,7,4,-3
38777,38777,38778,4,8,4
38778,38778,38779,8,1,-7
38779,38779,38780,1,6,5
38780,38780,38781,6,7,1
38781,38781,38782,7,6,-1
38782,38782,38783,6,7,1
38783,38783,38784,7,2,-5
38784,38784,38785,2,2,0
38785,38785,38786,2,4,2
38786,38786,38787,4,1,-3
38787,38787,38788,1,7,6
38788,38788,38789,7,4,-3
38789,38789,38790,4,2,-2
38790,38790,38791,2,8,6
38791,38791,38792,8,5,-3
38792,38792,38793,5,2,-3
38793,38793,38794,2,7,5
38794,38794,38795,7,9,2
38795,38795,38796,9,6,-3
38796,38796,38797,6,3,-3
38797,38797,38798,3,5,2
38798,38798,38799,5,8,3
38799,38799,38800,8,2,-6
38800,38800,38801,2,5,3
38801,38801,38802,5,0,-5
38802,38802,38803,0,4,4
38803,38803,38804,4,3,-1
38804,38804,38805,3,8,5
38805,38805,38806,8,1,-7
38806,38806,38807,1,8,7
38807,38807,38808,8,0,-8
38808,38808,38809,0,9,9
38809,38809,38810,9,7,-2
38810,38810,38811,7,3,-4
38811,38811,38812,3,4,1
38812,38812,38813,4,9,5
38813,38813,38814,9,7,-2
38814,38814,38815,7,2,-5
38815,38815,38816,2,0,-2
38816,38816,38817,0,5,5
38817,38817,38818,5,5,0
38818,38818,38819,5,7,2
38819,38819,38820,7,6,-1
38820,38820,38821,6,4,-2
38821,38821,38822,4,4,0
38822,38822,38823,4,1,-3
38823,38823,38824,1,1,0
38824,38824,38825,1,2,1
38825,38825,38826,2,2,0
38826,38826,38827,2,3,1
38827,38827,38828,3,1,-2
38828,38828,38829,1,9,8
38829,38829,38830,9,5,-4
38830,38830,38831,5,1,-4
38831,38831,38832,1,8,7
38832,38832,38833,8,6,-2
38833,38833,38834,6,4,-2
38834,38834,38835,4,0,-4
38835,38835,38836,0,7,7
38836,38836,38837,7,1,-6
38837,38837,38838,1,7,6
38838,38838,38839,7,2,-5
38839,38839,38840,2,1,-1
38840,38840,38841,1,8,7
38841,38841,38842,8,8,0
38842,38842,38843,8,5,-3
38843,38843,38844,5,8,3
38844,38844,38845,8,1,-7
38845,38845,38846,1,2,1
38846,38846,38847,2,1,-1
38847,38847,38848,1,5,4
38848,38848,38849,5,8,3
38849,38849,38850,8,0,-8
38850,38850,38851,0,5,5
38851,38851,38852,5,4,-1
38852,38852,38853,4,6,2
38853,38853,38854,6,6,0
38854,38854,38855,6,4,-2
38855,38855,38856,4,6,2
38856,38856,38857,6,7,1
38857,38857,38858,7,8,1
38858,38858,38859,8,3,-5
38859,38859,38860,3,1,-2
38860,38860,38861,1,6,5
38861,38861,38862,6,2,-4
38862,38862,38863,2,8,6
38863,38863,38864,8,5,-3
38864,38864,38865,5,0,-5
38865,38865,38866,0,8,8
38866,38866,38867,8,3,-5
38867,38867,38868,3,1,-2
38868,38868,38869,1,7,6
38869,38869,38870,7,8,1
38870,38870,38871,8,4,-4
38871,38871,38872,4,4,0
38872,38872,38873,4,0,-4
38873,38873,38874,0,0,0
38874,38874,38875,0,6,6
38875,38875,38876,6,6,0
38876,38876,38877,6,9,3
38877,38877,38878,9,8,-1
38878,38878,38879,8,2,-6
38879,38879,38880,2,9,7
38880,38880,38881,9,6,-3
38881,38881,38882,6,3,-3
38882,38882,38883,3,5,2
38883,38883,38884,5,2,-3
38884,38884,38885,2,6,4
38885,38885,38886,6,2,-4
38886,38886,38887,2,9,7
38887,38887,38888,9,5,-4
38888,38888,38889,5,0,-5
38889,38889,38890,0,7,7
38890,38890,38891,7,4,-3
38891,38891,38892,4,3,-1
38892,38892,38893,3,0,-3
38893,38893,38894,0,3,3
38894,38894,38895,3,6,3
38895,38895,38896,6,5,-1
38896,38896,38897,5,1,-4
38897,38897,38898,1,4,3
38898,38898,38899,4,9,5
38899,38899,38900,9,3,-6
38900,38900,38901,3,2,-1
38901,38901,38902,2,5,3
38902,38902,38903,5,0,-5
38903,38903,38904,0,3,3
38904,38904,38905,3,9,6
38905,38905,38906,9,4,-5
38906,38906,38907,4,5,1
38907,38907,38908,5,7,2
38908,38908,38909,7,1,-6
38909,38909,38910,1,9,8
38910,38910,38911,9,3,-6
38911,38911,38912,3,8,5
38912,38912,38913,8,7,-1
38913,38913,38914,7,0,-7
38914,38914,38915,0,6,6
38915,38915,38916,6,7,1
38916,38916,38917,7,9,2
38917,38917,38918,9,1,-8
38918,38918,38919,1,4,3
38919,38919,38920,4,7,3
38920,38920,38921,7,7,0
38921,38921,38922,7,4,-3
38922,38922,38923,4,7,3
38923,38923,38924,7,2,-5
38924,38924,38925,2,6,4
38925,38925,38926,6,0,-6
38926,38926,38927,0,3,3
38927,38927,38928,3,1,-2
38928,38928,38929,1,0,-1
38929,38929,38930,0,9,9
38930,38930,38931,9,5,-4
38931,38931,38932,5,5,0
38932,38932,38933,5,6,1
38933,38933,38934,6,5,-1
38934,38934,38935,5,2,-3
38935,38935,38936,2,6,4
38936,38936,38937,6,2,-4
38937,38937,38938,2,4,2
38938,38938,38939,4,0,-4
38939,38939,38940,0,5,5
38940,38940,38941,5,1,-4
38941,38941,38942,1,8,7
38942,38942,38943,8,7,-1
38943,38943,38944,7,5,-2
38944,38944,38945,5,8,3
38945,38945,38946,8,0,-8
38946,38946,38947,0,9,9
38947,38947,38948,9,8,-1
38948,38948,38949,8,0,-8
38949,38949,38950,0,9,9
38950,38950,38951,9,1,-8
38951,38951,38952,1,2,1
38952,38952,38953,2,2,0
38953,38953,38954,2,7,5
38954,38954,38955,7,3,-4
38955,38955,38956,3,8,5
38956,38956,38957,8,4,-4
38957,38957,38958,4,6,2
38958,38958,38959,6,5,-1
38959,38959,38960,5,4,-1
38960,38960,38961,4,6,2
38961,38961,38962,6,2,-4
38962,38962,38963,2,0,-2
38963,38963,38964,0,7,7
38964,38964,38965,7,1,-6
38965,38965,38966,1,4,3
38966,38966,38967,4,8,4
38967,38967,38968,8,1,-7
38968,38968,38969,1,9,8
38969,38969,38970,9,3,-6
38970,38970,38971,3,8,5
38971,38971,38972,8,7,-1
38972,38972,38973,7,4,-3
38973,38973,38974,4,1,-3
38974,38974,38975,1,1,0
38975,38975,38976,1,1,0
38976,38976,38977,1,8,7
38977,38977,38978,8,4,-4
38978,38978,38979,4,8,4
38979,38979,38980,8,6,-2
38980,38980,38981,6,1,-5
38981,38981,38982,1,3,2
38982,38982,38983,3,3,0
38983,38983,38984,3,4,1
38984,38984,38985,4,1,-3
38985,38985,38986,1,3,2
38986,38986,38987,3,8,5
38987,38987,38988,8,6,-2
38988,38988,38989,6,3,-3
38989,38989,38990,3,3,0
38990,38990,38991,3,3,0
38991,38991,38992,3,9,6
38992,38992,38993,9,0,-9
38993,38993,38994,0,7,7
38994,38994,38995,7,9,2
38995,38995,38996,9,6,-3
38996,38996,38997,6,4,-2
38997,38997,38998,4,3,-1
38998,38998,38999,3,9,6
38999,38999,39000,9,9,0
39000,39000,39001,9,8,-1
39001,39001,39002,8,2,-6
39002,39002,39003,2,7,5
39003,39003,39004,7,6,-1
39004,39004,39005,6,8,2
39005,39005,39006,8,2,-6
39006,39006,39007,2,1,-1
39007,39007,39008,1,2,1
39008,39008,39009,2,7,5
39009,39009,39010,7,7,0
39010,39010,39011,7,8,1
39011,39011,39012,8,1,-7
39012,39012,39013,1,7,6
39013,39013,39014,7,7,0
39014,39014,39015,7,5,-2
39015,39015,39016,5,9,4
39016,39016,39017,9,1,-8
39017,39017,39018,1,1,0
39018,39018,39019,1,6,5
39019,39019,39020,6,2,-4
39020,39020,39021,2,5,3
39021,39021,39022,5,2,-3
39022,39022,39023,2,0,-2
39023,39023,39024,0,4,4
39024,39024,39025,4,9,5
39025,39025,39026,9,7,-2
39026,39026,39027,7,5,-2
39027,39027,39028,5,0,-5
39028,39028,39029,0,0,0
39029,39029,39030,0,9,9
39030,39030,39031,9,2,-7
39031,39031,39032,2,2,0
39032,39032,39033,2,1,-1
39033,39033,39034,1,9,8
39034,39034,39035,9,8,-1
39035,39035,39036,8,6,-2
39036,39036,39037,6,0,-6
39037,39037,39038,0,7,7
39038,39038,39039,7,0,-7
39039,39039,39040,0,3,3
39040,39040,39041,3,1,-2
39041,39041,39042,1,2,1
39042,39042,39043,2,6,4
39043,39043,39044,6,0,-6
39044,39044,39045,0,6,6
39045,39045,39046,6,4,-2
39046,39046,39047,4,7,3
39047,39047,39048,7,7,0
39048,39048,39049,7,1,-6
39049,39049,39050,1,0,-1
39050,39050,39051,0,1,1
39051,39051,39052,1,1,0
39052,39052,39053,1,7,6
39053,39053,39054,7,0,-7
39054,39054,39055,0,0,0
39055,39055,39056,0,7,7
39056,39056,39057,7,1,-6
39057,39057,39058,1,4,3
39058,39058,39059,4,2,-2
39059,39059,39060,2,7,5
39060,39060,39061,7,3,-4
39061,39061,39062,3,7,4
39062,39062,39063,7,4,-3
39063,39063,39064,4,9,5
39064,39064,39065,9,5,-4
39065,39065,39066,5,3,-2
39066,39066,39067,3,6,3
39067,39067,39068,6,8,2
39068,39068,39069,8,7,-1
39069,39069,39070,7,8,1
39070,39070,39071,8,8,0
39071,39071,39072,8,1,-7
39072,39072,39073,1,9,8
39073,39073,39074,9,2,-7
39074,39074,39075,2,0,-2
39075,39075,39076,0,1,1
39076,39076,39077,1,1,0
39077,39077,39078,1,4,3
39078,39078,39079,4,2,-2
39079,39079,39080,2,4,2
39080,39080,39081,4,3,-1
39081,39081,39082,3,7,4
39082,39082,39083,7,4,-3
39083,39083,39084,4,1,-3
39084,39084,39085,1,5,4
39085,39085,39086,5,6,1
39086,39086,39087,6,6,0
39087,39087,39088,6,7,1
39088,39088,39089,7,7,0
39089,39089,39090,7,2,-5
39090,39090,39091,2,8,6
39091,39091,39092,8,8,0
39092,39092,39093,8,0,-8
39093,39093,39094,0,8,8
39094,39094,39095,8,1,-7
39095,39095,39096,1,9,8
39096,39096,39097,9,2,-7
39097,39097,39098,2,6,4
39098,39098,39099,6,3,-3
39099,39099,39100,3,3,0
39100,39100,39101,3,4,1
39101,39101,39102,4,1,-3
39102,39102,39103,1,5,4
39103,39103,39104,5,8,3
39104,39104,39105,8,6,-2
39105,39105,39106,6,1,-5
39106,39106,39107,1,7,6
39107,39107,39108,7,3,-4
39108,39108,39109,3,8,5
39109,39109,39110,8,4,-4
39110,39110,39111,4,9,5
39111,39111,39112,9,6,-3
39112,39112,39113,6,7,1
39113,39113,39114,7,5,-2
39114,39114,39115,5,0,-5
39115,39115,39116,0,3,3
39116,39116,39117,3,4,1
39117,39117,39118,4,2,-2
39118,39118,39119,2,0,-2
39119,39119,39120,0,5,5
39120,39120,39121,5,6,1
39121,39121,39122,6,3,-3
39122,39122,39123,3,4,1
39123,39123,39124,4,3,-1
39124,39124,39125,3,3,0
39125,39125,39126,3,5,2
39126,39126,39127,5,3,-2
39127,39127,39128,3,4,1
39128,39128,39129,4,4,0
39129,39129,39130,4,6,2
39130,39130,39131,6,8,2
39131,39131,39132,8,5,-3
39132,39132,39133,5,7,2
39133,39133,39134,7,9,2
39134,39134,39135,9,8,-1
39135,39135,39136,8,3,-5
39136,39136,39137,3,6,3
39137,39137,39138,6,1,-5
39138,39138,39139,1,9,8
39139,39139,39140,9,3,-6
39140,39140,39141,3,8,5
39141,39141,39142,8,8,0
39142,39142,39143,8,3,-5
39143,39143,39144,3,8,5
39144,39144,39145,8,2,-6
39145,39145,39146,2,2,0
39146,39146,39147,2,2,0
39147,39147,39148,2,9,7
39148,39148,39149,9,8,-1
39149,39149,39150,8,7,-1
39150,39150,39151,7,4,-3
39151,39151,39152,4,1,-3
39152,39152,39153,1,2,1
39153,39153,39154,2,6,4
39154,39154,39155,6,0,-6
39155,39155,39156,0,0,0
39156,39156,39157,0,1,1
39157,39157,39158,1,5,4
39158,39158,39159,5,1,-4
39159,39159,39160,1,1,0
39160,39160,39161,1,2,1
39161,39161,39162,2,2,0
39162,39162,39163,2,9,7
39163,39163,39164,9,6,-3
39164,39164,39165,6,6,0
39165,39165,39166,6,9,3
39166,39166,39167,9,8,-1
39167,39167,39168,8,2,-6
39168,39168,39169,2,1,-1
39169,39169,39170,1,2,1
39170,39170,39171,2,2,0
39171,39171,39172,2,9,7
39172,39172,39173,9,1,-8
39173,39173,39174,1,9,8
39174,39174,39175,9,0,-9
39175,39175,39176,0,5,5
39176,39176,39177,5,6,1
39177,39177,39178,6,8,2
39178,39178,39179,8,9,1
39179,39179,39180,9,6,-3
39180,39180,39181,6,3,-3
39181,39181,39182,3,4,1
39182,39182,39183,4,7,3
39183,39183,39184,7,3,-4
39184,39184,39185,3,1,-2
39185,39185,39186,1,4,3
39186,39186,39187,4,8,4
39187,39187,39188,8,6,-2
39188,39188,39189,6,3,-3
39189,39189,39190,3,7,4
39190,39190,39191,7,8,1
39191,39191,39192,8,9,1
39192,39192,39193,9,1,-8
39193,39193,39194,1,0,-1
39194,39194,39195,0,9,9
39195,39195,39196,9,1,-8
39196,39196,39197,1,5,4
39197,39197,39198,5,2,-3
39198,39198,39199,2,9,7
39199,39199,39200,9,6,-3
39200,39200,39201,6,8,2
39201,39201,39202,8,0,-8
39202,39202,39203,0,2,2
39203,39203,39204,2,4,2
39204,39204,39205,4,6,2
39205,39205,39206,6,6,0
39206,39206,39207,6,0,-6
39207,39207,39208,0,5,5
39208,39208,39209,5,4,-1
39209,39209,39210,4,2,-2
39210,39210,39211,2,5,3
39211,39211,39212,5,6,1
39212,39212,39213,6,0,-6
39213,39213,39214,0,5,5
39214,39214,39215,5,3,-2
39215,39215,39216,3,2,-1
39216,39216,39217,2,1,-1
39217,39217,39218,1,4,3
39218,39218,39219,4,8,4
39219,39219,39220,8,0,-8
39220,39220,39221,0,6,6
39221,39221,39222,6,3,-3
39222,39222,39223,3,7,4
39223,39223,39224,7,0,-7
39224,39224,39225,0,5,5
39225,39225,39226,5,6,1
39226,39226,39227,6,9,3
39227,39227,39228,9,2,-7
39228,39228,39229,2,9,7
39229,39229,39230,9,5,-4
39230,39230,39231,5,3,-2
39231,39231,39232,3,1,-2
39232,39232,39233,1,0,-1
39233,39233,39234,0,9,9
39234,39234,39235,9,3,-6
39235,39235,39236,3,0,-3
39236,39236,39237,0,1,1
39237,39237,39238,1,8,7
39238,39238,39239,8,4,-4
39239,39239,39240,4,3,-1
39240,39240,39241,3,4,1
39241,39241,39242,4,8,4
39242,39242,39243,8,0,-8
39243,39243,39244,0,7,7
39244,39244,39245,7,4,-3
39245,39245,39246,4,7,3
39246,39246,39247,7,9,2
39247,39247,39248,9,4,-5
39248,39248,39249,4,2,-2
39249,39249,39250,2,6,4
39250,39250,39251,6,6,0
39251,39251,39252,6,7,1
39252,39252,39253,7,5,-2
39253,39253,39254,5,7,2
39254,39254,39255,7,4,-3
39255,39255,39256,4,2,-2
39256,39256,39257,2,7,5
39257,39257,39258,7,6,-1
39258,39258,39259,6,9,3
39259,39259,39260,9,6,-3
39260,39260,39261,6,7,1
39261,39261,39262,7,1,-6
39262,39262,39263,1,0,-1
39263,39263,39264,0,8,8
39264,39264,39265,8,1,-7
39265,39265,39266,1,8,7
39266,39266,39267,8,3,-5
39267,39267,39268,3,1,-2
39268,39268,39269,1,4,3
39269,39269,39270,4,1,-3
39270,39270,39271,1,5,4
39271,39271,39272,5,4,-1
39272,39272,39273,4,6,2
39273,39273,39274,6,5,-1
39274,39274,39275,5,7,2
39275,39275,39276,7,7,0
39276,39276,39277,7,8,1
39277,39277,39278,8,6,-2
39278,39278,39279,6,0,-6
39279,39279,39280,0,5,5
39280,39280,39281,5,1,-4
39281,39281,39282,1,2,1
39282,39282,39283,2,2,0
39283,39283,39284,2,2,0
39284,39284,39285,2,3,1
39285,39285,39286,3,9,6
39286,39286,39287,9,4,-5
39287,39287,39288,4,1,-3
39288,39288,39289,1,7,6
39289,39289,39290,7,3,-4
39290,39290,39291,3,8,5
39291,39291,39292,8,6,-2
39292,39292,39293,6,9,3
39293,39293,39294,9,7,-2
39294,39294,39295,7,0,-7
39295,39295,39296,0,2,2
39296,39296,39297,2,1,-1
39297,39297,39298,1,4,3
39298,39298,39299,4,2,-2
39299,39299,39300,2,1,-1
39300,39300,39301,1,3,2
39301,39301,39302,3,4,1
39302,39302,39303,4,4,0
39303,39303,39304,4,4,0
39304,39304,39305,4,7,3
39305,39305,39306,7,0,-7
39306,39306,39307,0,8,8
39307,39307,39308,8,8,0
39308,39308,39309,8,0,-8
39309,39309,39310,0,7,7
39310,39310,39311,7,5,-2
39311,39311,39312,5,3,-2
39312,39312,39313,3,6,3
39313,39313,39314,6,7,1
39314,39314,39315,7,8,1
39315,39315,39316,8,7,-1
39316,39316,39317,7,3,-4
39317,39317,39318,3,6,3
39318,39318,39319,6,9,3
39319,39319,39320,9,6,-3
39320,39320,39321,6,0,-6
39321,39321,39322,0,8,8
39322,39322,39323,8,2,-6
39323,39323,39324,2,4,2
39324,39324,39325,4,3,-1
39325,39325,39326,3,0,-3
39326,39326,39327,0,3,3
39327,39327,39328,3,1,-2
39328,39328,39329,1,3,2
39329,39329,39330,3,2,-1
39330,39330,39331,2,9,7
39331,39331,39332,9,6,-3
39332,39332,39333,6,9,3
39333,39333,39334,9,0,-9
39334,39334,39335,0,5,5
39335,39335,39336,5,6,1
39336,39336,39337,6,6,0
39337,39337,39338,6,2,-4
39338,39338,39339,2,4,2
39339,39339,39340,4,6,2
39340,39340,39341,6,4,-2
39341,39341,39342,4,2,-2
39342,39342,39343,2,2,0
39343,39343,39344,2,8,6
39344,39344,39345,8,7,-1
39345,39345,39346,7,0,-7
39346,39346,39347,0,0,0
39347,39347,39348,0,7,7
39348,39348,39349,7,3,-4
39349,39349,39350,3,8,5
39350,39350,39351,8,9,1
39351,39351,39352,9,1,-8
39352,39352,39353,1,6,5
39353,39353,39354,6,1,-5
39354,39354,39355,1,8,7
39355,39355,39356,8,6,-2
39356,39356,39357,6,7,1
39357,39357,39358,7,7,0
39358,39358,39359,7,3,-4
39359,39359,39360,3,0,-3
39360,39360,39361,0,4,4
39361,39361,39362,4,1,-3
39362,39362,39363,1,0,-1
39363,39363,39364,0,1,1
39364,39364,39365,1,4,3
39365,39365,39366,4,3,-1
39366,39366,39367,3,1,-2
39367,39367,39368,1,4,3
39368,39368,39369,4,6,2
39369,39369,39370,6,9,3
39370,39370,39371,9,7,-2
39371,39371,39372,7,6,-1
39372,39372,39373,6,8,2
39373,39373,39374,8,5,-3
39374,39374,39375,5,4,-1
39375,39375,39376,4,0,-4
39376,39376,39377,0,9,9
39377,39377,39378,9,8,-1
39378,39378,39379,8,6,-2
39379,39379,39380,6,5,-1
39380,39380,39381,5,5,0
39381,39381,39382,5,8,3
39382,39382,39383,8,6,-2
39383,39383,39384,6,3,-3
39384,39384,39385,3,6,3
39385,39385,39386,6,4,-2
39386,39386,39387,4,7,3
39387,39387,39388,7,6,-1
39388,39388,39389,6,8,2
39389,39389,39390,8,7,-1
39390,39390,39391,7,8,1
39391,39391,39392,8,2,-6
39392,39392,39393,2,1,-1
39393,39393,39394,1,6,5
39394,39394,39395,6,8,2
39395,39395,39396,8,4,-4
39396,39396,39397,4,3,-1
39397,39397,39398,3,2,-1
39398,39398,39399,2,7,5
39399,39399,39400,7,5,-2
39400,39400,39401,5,7,2
39401,39401,39402,7,1,-6
39402,39402,39403,1,1,0
39403,39403,39404,1,4,3
39404,39404,39405,4,5,1
39405,39405,39406,5,6,1
39406,39406,39407,6,0,-6
39407,39407,39408,0,2,2
39408,39408,39409,2,5,3
39409,39409,39410,5,5,0
39410,39410,39411,5,2,-3
39411,39411,39412,2,3,1
39412,39412,39413,3,4,1
39413,39413,39414,4,4,0
39414,39414,39415,4,3,-1
39415,39415,39416,3,5,2
39416,39416,39417,5,1,-4
39417,39417,39418,1,9,8
39418,39418,39419,9,8,-1
39419,39419,39420,8,2,-6
39420,39420,39421,2,2,0
39421,39421,39422,2,0,-2
39422,39422,39423,0,9,9
39423,39423,39424,9,5,-4
39424,39424,39425,5,9,4
39425,39425,39426,9,7,-2
39426,39426,39427,7,5,-2
39427,39427,39428,5,9,4
39428,39428,39429,9,2,-7
39429,39429,39430,2,6,4
39430,39430,39431,6,6,0
39431,39431,39432,6,8,2
39432,39432,39433,8,4,-4
39433,39433,39434,4,2,-2
39434,39434,39435,2,4,2
39435,39435,39436,4,5,1
39436,39436,39437,5,1,-4
39437,39437,39438,1,8,7
39438,39438,39439,8,7,-1
39439,39439,39440,7,6,-1
39440,39440,39441,6,1,-5
39441,39441,39442,1,8,7
39442,39442,39443,8,4,-4
39443,39443,39444,4,1,-3
39444,39444,39445,1,3,2
39445,39445,39446,3,0,-3
39446,39446,39447,0,9,9
39447,39447,39448,9,9,0
39448,39448,39449,9,7,-2
39449,39449,39450,7,8,1
39450,39450,39451,8,1,-7
39451,39451,39452,1,3,2
39452,39452,39453,3,2,-1
39453,39453,39454,2,1,-1
39454,39454,39455,1,6,5
39455,39455,39456,6,8,2
39456,39456,39457,8,0,-8
39457,39457,39458,0,4,4
39458,39458,39459,4,7,3
39459,39459,39460,7,5,-2
39460,39460,39461,5,3,-2
39461,39461,39462,3,1,-2
39462,39462,39463,1,0,-1
39463,39463,39464,0,9,9
39464,39464,39465,9,1,-8
39465,39465,39466,1,6,5
39466,39466,39467,6,2,-4
39467,39467,39468,2,5,3
39468,39468,39469,5,3,-2
39469,39469,39470,3,2,-1
39470,39470,39471,2,4,2
39471,39471,39472,4,9,5
39472,39472,39473,9,5,-4
39473,39473,39474,5,0,-5
39474,39474,39475,0,6,6
39475,39475,39476,6,2,-4
39476,39476,39477,2,7,5
39477,39477,39478,7,8,1
39478,39478,39479,8,8,0
39479,39479,39480,8,9,1
39480,39480,39481,9,9,0
39481,39481,39482,9,5,-4
39482,39482,39483,5,0,-5
39483,39483,39484,0,1,1
39484,39484,39485,1,1,0
39485,39485,39486,1,4,3
39486,39486,39487,4,2,-2
39487,39487,39488,2,2,0
39488,39488,39489,2,3,1
39489,39489,39490,3,7,4
39490,39490,39491,7,4,-3
39491,39491,39492,4,4,0
39492,39492,39493,4,5,1
39493,39493,39494,5,0,-5
39494,39494,39495,0,6,6
39495,39495,39496,6,6,0
39496,39496,39497,6,7,1
39497,39497,39498,7,0,-7
39498,39498,39499,0,8,8
39499,39499,39500,8,7,-1
39500,39500,39501,7,9,2
39501,39501,39502,9,5,-4
39502,39502,39503,5,0,-5
39503,39503,39504,0,0,0
39504,39504,39505,0,1,1
39505,39505,39506,1,6,5
39506,39506,39507,6,2,-4
39507,39507,39508,2,6,4
39508,39508,39509,6,3,-3
39509,39509,39510,3,2,-1
39510,39510,39511,2,4,2
39511,39511,39512,4,1,-3
39512,39512,39513,1,5,4
39513,39513,39514,5,4,-1
39514,39514,39515,4,6,2
39515,39515,39516,6,5,-1
39516,39516,39517,5,7,2
39517,39517,39518,7,2,-5
39518,39518,39519,2,8,6
39519,39519,39520,8,3,-5
39520,39520,39521,3,9,6
39521,39521,39522,9,4,-5
39522,39522,39523,4,7,3
39523,39523,39524,7,7,0
39524,39524,39525,7,4,-3
39525,39525,39526,4,5,1
39526,39526,39527,5,0,-5
39527,39527,39528,0,6,6
39528,39528,39529,6,4,-2
39529,39529,39530,4,8,4
39530,39530,39531,8,0,-8
39531,39531,39532,0,9,9
39532,39532,39533,9,1,-8
39533,39533,39534,1,7,6
39534,39534,39535,7,7,0
39535,39535,39536,7,4,-3
39536,39536,39537,4,9,5
39537,39537,39538,9,9,0
39538,39538,39539,9,5,-4
39539,39539,39540,5,7,2
39540,39540,39541,7,1,-6
39541,39541,39542,1,1,0
39542,39542,39543,1,4,3
39543,39543,39544,4,7,3
39544,39544,39545,7,2,-5
39545,39545,39546,2,1,-1
39546,39546,39547,1,8,7
39547,39547,39548,8,4,-4
39548,39548,39549,4,9,5
39549,39549,39550,9,1,-8
39550,39550,39551,1,4,3
39551,39551,39552,4,1,-3
39552,39552,39553,1,3,2
39553,39553,39554,3,1,-2
39554,39554,39555,1,1,0
39555,39555,39556,1,5,4
39556,39556,39557,5,7,2
39557,39557,39558,7,4,-3
39558,39558,39559,4,8,4
39559,39559,39560,8,1,-7
39560,39560,39561,1,2,1
39561,39561,39562,2,5,3
39562,39562,39563,5,4,-1
39563,39563,39564,4,0,-4
39564,39564,39565,0,3,3
39565,39565,39566,3,3,0
39566,39566,39567,3,6,3
39567,39567,39568,6,1,-5
39568,39568,39569,1,9,8
39569,39569,39570,9,0,-9
39570,39570,39571,0,9,9
39571,39571,39572,9,2,-7
39572,39572,39573,2,5,3
39573,39573,39574,5,5,0
39574,39574,39575,5,8,3
39575,39575,39576,8,9,1
39576,39576,39577,9,6,-3
39577,39577,39578,6,9,3
39578,39578,39579,9,7,-2
39579,39579,39580,7,7,0
39580,39580,39581,7,0,-7
39581,39581,39582,0,2,2
39582,39582,39583,2,6,4
39583,39583,39584,6,4,-2
39584,39584,39585,4,8,4
39585,39585,39586,8,7,-1
39586,39586,39587,7,2,-5
39587,39587,39588,2,9,7
39588,39588,39589,9,6,-3
39589,39589,39590,6,4,-2
39590,39590,39591,4,3,-1
39591,39591,39592,3,2,-1
39592,39592,39593,2,9,7
39593,39593,39594,9,1,-8
39594,39594,39595,1,3,2
39595,39595,39596,3,8,5
39596,39596,39597,8,2,-6
39597,39597,39598,2,9,7
39598,39598,39599,9,8,-1
39599,39599,39600,8,0,-8
39600,39600,39601,0,6,6
39601,39601,39602,6,8,2
39602,39602,39603,8,1,-7
39603,39603,39604,1,8,7
39604,39604,39605,8,7,-1
39605,39605,39606,7,0,-7
39606,39606,39607,0,4,4
39607,39607,39608,4,8,4
39608,39608,39609,8,8,0
39609,39609,39610,8,6,-2
39610,39610,39611,6,8,2
39611,39611,39612,8,0,-8
39612,39612,39613,0,9,9
39613,39613,39614,9,9,0
39614,39614,39615,9,0,-9
39615,39615,39616,0,7,7
39616,39616,39617,7,3,-4
39617,39617,39618,3,3,0
39618,39618,39619,3,3,0
39619,39619,39620,3,0,-3
39620,39620,39621,0,9,9
39621,39621,39622,9,1,-8
39622,39622,39623,1,0,-1
39623,39623,39624,0,0,0
39624,39624,39625,0,5,5
39625,39625,39626,5,6,1
39626,39626,39627,6,2,-4
39627,39627,39628,2,0,-2
39628,39628,39629,0,5,5
39629,39629,39630,5,6,1
39630,39630,39631,6,0,-6
39631,39631,39632,0,6,6
39632,39632,39633,6,9,3
39633,39633,39634,9,4,-5
39634,39634,39635,4,4,0
39635,39635,39636,4,4,0
39636,39636,39637,4,1,-3
39637,39637,39638,1,4,3
39638,39638,39639,4,0,-4
39639,39639,39640,0,9,9
39640,39640,39641,9,3,-6
39641,39641,39642,3,9,6
39642,39642,39643,9,7,-2
39643,39643,39644,7,2,-5
39644,39644,39645,2,5,3
39645,39645,39646,5,1,-4
39646,39646,39647,1,8,7
39647,39647,39648,8,9,1
39648,39648,39649,9,7,-2
39649,39649,39650,7,6,-1
39650,39650,39651,6,7,1
39651,39651,39652,7,1,-6
39652,39652,39653,1,8,7
39653,39653,39654,8,9,1
39654,39654,39655,9,2,-7
39655,39655,39656,2,0,-2
39656,39656,39657,0,9,9
39657,39657,39658,9,8,-1
39658,39658,39659,8,7,-1
39659,39659,39660,7,9,2
39660,39660,39661,9,1,-8
39661,39661,39662,1,8,7
39662,39662,39663,8,2,-6
39663,39663,39664,2,0,-2
39664,39664,39665,0,6,6
39665,39665,39666,6,5,-1
39666,39666,39667,5,4,-1
39667,39667,39668,4,8,4
39668,39668,39669,8,2,-6
39669,39669,39670,2,4,2
39670,39670,39671,4,5,1
39671,39671,39672,5,7,2
39672,39672,39673,7,2,-5
39673,39673,39674,2,4,2
39674,39674,39675,4,3,-1
39675,39675,39676,3,7,4
39676,39676,39677,7,6,-1
39677,39677,39678,6,3,-3
39678,39678,39679,3,6,3
39679,39679,39680,6,4,-2
39680,39680,39681,4,5,1
39681,39681,39682,5,2,-3
39682,39682,39683,2,0,-2
39683,39683,39684,0,1,1
39684,39684,39685,1,0,-1
39685,39685,39686,0,3,3
39686,39686,39687,3,7,4
39687,39687,39688,7,2,-5
39688,39688,39689,2,5,3
39689,39689,39690,5,4,-1
39690,39690,39691,4,2,-2
39691,39691,39692,2,9,7
39692,39692,39693,9,8,-1
39693,39693,39694,8,9,1
39694,39694,39695,9,1,-8
39695,39695,39696,1,3,2
39696,39696,39697,3,6,3
39697,39697,39698,6,2,-4
39698,39698,39699,2,1,-1
39699,39699,39700,1,5,4
39700,39700,39701,5,0,-5
39701,39701,39702,0,9,9
39702,39702,39703,9,4,-5
39703,39703,39704,4,3,-1
39704,39704,39705,3,3,0
39705,39705,39706,3,3,0
39706,39706,39707,3,1,-2
39707,39707,39708,1,2,1
39708,39708,39709,2,6,4
39709,39709,39710,6,0,-6
39710,39710,39711,0,1,1
39711,39711,39712,1,7,6
39712,39712,39713,7,9,2
39713,39713,39714,9,0,-9
39714,39714,39715,0,0,0
39715,39715,39716,0,1,1
39716,39716,39717,1,1,0
39717,39717,39718,1,9,8
39718,39718,39719,9,2,-7
39719,39719,39720,2,4,2
39720,39720,39721,4,3,-1
39721,39721,39722,3,5,2
39722,39722,39723,5,4,-1
39723,39723,39724,4,9,5
39724,39724,39725,9,5,-4
39725,39725,39726,5,2,-3
39726,39726,39727,2,6,4
39727,39727,39728,6,3,-3
39728,39728,39729,3,7,4
39729,39729,39730,7,4,-3
39730,39730,39731,4,8,4
39731,39731,39732,8,9,1
39732,39732,39733,9,9,0
39733,39733,39734,9,2,-7
39734,39734,39735,2,0,-2
39735,39735,39736,0,6,6
39736,39736,39737,6,1,-5
39737,39737,39738,1,4,3
39738,39738,39739,4,2,-2
39739,39739,39740,2,0,-2
39740,39740,39741,0,3,3
39741,39741,39742,3,6,3
39742,39742,39743,6,4,-2
39743,39743,39744,4,3,-1
39744,39744,39745,3,5,2
39745,39745,39746,5,0,-5
39746,39746,39747,0,6,6
39747,39747,39748,6,5,-1
39748,39748,39749,5,7,2
39749,39749,39750,7,9,2
39750,39750,39751,9,8,-1
39751,39751,39752,8,7,-1
39752,39752,39753,7,9,2
39753,39753,39754,9,9,0
39754,39754,39755,9,0,-9
39755,39755,39756,0,8,8
39756,39756,39757,8,1,-7
39757,39757,39758,1,0,-1
39758,39758,39759,0,2,2
39759,39759,39760,2,7,5
39760,39760,39761,7,3,-4
39761,39761,39762,3,9,6
39762,39762,39763,9,4,-5
39763,39763,39764,4,8,4
39764,39764,39765,8,5,-3
39765,39765,39766,5,6,1
39766,39766,39767,6,6,0
39767,39767,39768,6,3,-3
39768,39768,39769,3,7,4
39769,39769,39770,7,3,-4
39770,39770,39771,3,8,5
39771,39771,39772,8,2,-6
39772,39772,39773,2,5,3
39773,39773,39774,5,3,-2
39774,39774,39775,3,0,-3
39775,39775,39776,0,1,1
39776,39776,39777,1,6,5
39777,39777,39778,6,8,2
39778,39778,39779,8,8,0
39779,39779,39780,8,5,-3
39780,39780,39781,5,9,4
39781,39781,39782,9,1,-8
39782,39782,39783,1,4,3
39783,39783,39784,4,7,3
39784,39784,39785,7,1,-6
39785,39785,39786,1,3,2
39786,39786,39787,3,9,6
39787,39787,39788,9,0,-9
39788,39788,39789,0,0,0
39789,39789,39790,0,2,2
39790,39790,39791,2,4,2
39791,39791,39792,4,6,2
39792,39792,39793,6,8,2
39793,39793,39794,8,2,-6
39794,39794,39795,2,9,7
39795,39795,39796,9,1,-8
39796,39796,39797,1,1,0
39797,39797,39798,1,3,2
39798,39798,39799,3,4,1
39799,39799,39800,4,0,-4
39800,39800,39801,0,0,0
39801,39801,39802,0,9,9
39802,39802,39803,9,5,-4
39803,39803,39804,5,3,-2
39804,39804,39805,3,1,-2
39805,39805,39806,1,8,7
39806,39806,39807,8,5,-3
39807,39807,39808,5,5,0
39808,39808,39809,5,4,-1
39809,39809,39810,4,2,-2
39810,39810,39811,2,0,-2
39811,39811,39812,0,4,4
39812,39812,39813,4,7,3
39813,39813,39814,7,3,-4
39814,39814,39815,3,6,3
39815,39815,39816,6,9,3
39816,39816,39817,9,0,-9
39817,39817,39818,0,1,1
39818,39818,39819,1,1,0
39819,39819,39820,1,3,2
39820,39820,39821,3,7,4
39821,39821,39822,7,9,2
39822,39822,39823,9,0,-9
39823,39823,39824,0,6,6
39824,39824,39825,6,6,0
39825,39825,39826,6,7,1
39826,39826,39827,7,8,1
39827,39827,39828,8,1,-7
39828,39828,39829,1,9,8
39829,39829,39830,9,1,-8
39830,39830,39831,1,5,4
39831,39831,39832,5,8,3
39832,39832,39833,8,4,-4
39833,39833,39834,4,9,5
39834,39834,39835,9,7,-2
39835,39835,39836,7,3,-4
39836,39836,39837,3,6,3
39837,39837,39838,6,1,-5
39838,39838,39839,1,0,-1
39839,39839,39840,0,2,2
39840,39840,39841,2,8,6
39841,39841,39842,8,9,1
39842,39842,39843,9,1,-8
39843,39843,39844,1,4,3
39844,39844,39845,4,7,3
39845,39845,39846,7,1,-6
39846,39846,39847,1,7,6
39847,39847,39848,7,0,-7
39848,39848,39849,0,1,1
39849,39849,39850,1,0,-1
39850,39850,39851,0,3,3
39851,39851,39852,3,3,0
39852,39852,39853,3,2,-1
39853,39853,39854,2,0,-2
39854,39854,39855,0,3,3
39855,39855,39856,3,0,-3
39856,39856,39857,0,1,1
39857,39857,39858,1,5,4
39858,39858,39859,5,0,-5
39859,39859,39860,0,2,2
39860,39860,39861,2,0,-2
39861,39861,39862,0,2,2
39862,39862,39863,2,7,5
39863,39863,39864,7,8,1
39864,39864,39865,8,8,0
39865,39865,39866,8,4,-4
39866,39866,39867,4,4,0
39867,39867,39868,4,7,3
39868,39868,39869,7,9,2
39869,39869,39870,9,6,-3
39870,39870,39871,6,3,-3
39871,39871,39872,3,8,5
39872,39872,39873,8,8,0
39873,39873,39874,8,0,-8
39874,39874,39875,0,4,4
39875,39875,39876,4,8,4
39876,39876,39877,8,7,-1
39877,39877,39878,7,1,-6
39878,39878,39879,1,2,1
39879,39879,39880,2,7,5
39880,39880,39881,7,5,-2
39881,39881,39882,5,8,3
39882,39882,39883,8,6,-2
39883,39883,39884,6,3,-3
39884,39884,39885,3,3,0
39885,39885,39886,3,4,1
39886,39886,39887,4,6,2
39887,39887,39888,6,1,-5
39888,39888,39889,1,9,8
39889,39889,39890,9,0,-9
39890,39890,39891,0,4,4
39891,39891,39892,4,2,-2
39892,39892,39893,2,6,4
39893,39893,39894,6,4,-2
39894,39894,39895,4,9,5
39895,39895,39896,9,1,-8
39896,39896,39897,1,0,-1
39897,39897,39898,0,0,0
39898,39898,39899,0,2,2
39899,39899,39900,2,3,1
39900,39900,39901,3,5,2
39901,39901,39902,5,8,3
39902,39902,39903,8,5,-3
39903,39903,39904,5,3,-2
39904,39904,39905,3,1,-2
39905,39905,39906,1,0,-1
39906,39906,39907,0,3,3
39907,39907,39908,3,6,3
39908,39908,39909,6,3,-3
39909,39909,39910,3,5,2
39910,39910,39911,5,9,4
39911,39911,39912,9,1,-8
39912,39912,39913,1,7,6
39913,39913,39914,7,2,-5
39914,39914,39915,2,8,6
39915,39915,39916,8,4,-4
39916,39916,39917,4,7,3
39917,39917,39918,7,2,-5
39918,39918,39919,2,2,0
39919,39919,39920,2,7,5
39920,39920,39921,7,2,-5
39921,39921,39922,2,8,6
39922,39922,39923,8,5,-3
39923,39923,39924,5,9,4
39924,39924,39925,9,7,-2
39925,39925,39926,7,8,1
39926,39926,39927,8,9,1
39927,39927,39928,9,3,-6
39928,39928,39929,3,2,-1
39929,39929,39930,2,2,0
39930,39930,39931,2,1,-1
39931,39931,39932,1,9,8
39932,39932,39933,9,3,-6
39933,39933,39934,3,6,3
39934,39934,39935,6,0,-6
39935,39935,39936,0,1,1
39936,39936,39937,1,1,0
39937,39937,39938,1,8,7
39938,39938,39939,8,2,-6
39939,39939,39940,2,5,3
39940,39940,39941,5,3,-2
39941,39941,39942,3,9,6
39942,39942,39943,9,4,-5
39943,39943,39944,4,0,-4
39944,39944,39945,0,5,5
39945,39945,39946,5,5,0
39946,39946,39947,5,6,1
39947,39947,39948,6,8,2
39948,39948,39949,8,7,-1
39949,39949,39950,7,1,-6
39950,39950,39951,1,8,7
39951,39951,39952,8,5,-3
39952,39952,39953,5,9,4
39953,39953,39954,9,4,-5
39954,39954,39955,4,0,-4
39955,39955,39956,0,0,0
39956,39956,39957,0,1,1
39957,39957,39958,1,5,4
39958,39958,39959,5,2,-3
39959,39959,39960,2,0,-2
39960,39960,39961,0,3,3
39961,39961,39962,3,5,2
39962,39962,39963,5,4,-1
39963,39963,39964,4,5,1
39964,39964,39965,5,5,0
39965,39965,39966,5,5,0
39966,39966,39967,5,6,1
39967,39967,39968,6,0,-6
39968,39968,39969,0,7,7
39969,39969,39970,7,2,-5
39970,39970,39971,2,8,6
39971,39971,39972,8,5,-3
39972,39972,39973,5,9,4
39973,39973,39974,9,9,0
39974,39974,39975,9,0,-9
39975,39975,39976,0,4,4
39976,39976,39977,4,1,-3
39977,39977,39978,1,5,4
39978,39978,39979,5,2,-3
39979,39979,39980,2,1,-1
39980,39980,39981,1,3,2
39981,39981,39982,3,3,0
39982,39982,39983,3,4,1
39983,39983,39984,4,1,-3
39984,39984,39985,1,5,4
39985,39985,39986,5,1,-4
39986,39986,39987,1,6,5
39987,39987,39988,6,1,-5
39988,39988,39989,1,7,6
39989,39989,39990,7,4,-3
39990,39990,39991,4,8,4
39991,39991,39992,8,0,-8
39992,39992,39993,0,9,9
39993,39993,39994,9,8,-1
39994,39994,39995,8,8,0
39995,39995,39996,8,5,-3
39996,39996,39997,5,9,4
39997,39997,39998,9,9,0
39998,39998,39999,9,5,-4
39999,39999,40000,5,7,2
40000,40000,40001,7,7,0
40001,40001,40002,7,0,-7
40002,40002,40003,0,0,0
40003,40003,40004,0,1,1
40004,40004,40005,1,3,2
40005,40005,40006,3,9,6
40006,40006,40007,9,1,-8
40007,40007,40008,1,5,4
40008,40008,40009,5,6,1
40009,40009,40010,6,6,0
40010,40010,40011,6,8,2
40011,40011,40012,8,8,0
40012,40012,40013,8,4,-4
40013,40013,40014,4,5,1
40014,40014,40015,5,1,-4
40015,40015,40016,1,8,7
40016,40016,40017,8,7,-1
40017,40017,40018,7,7,0
40018,40018,40019,7,6,-1
40019,40019,40020,6,3,-3
40020,40020,40021,3,5,2
40021,40021,40022,5,8,3
40022,40022,40023,8,6,-2
40023,40023,40024,6,1,-5
40024,40024,40025,1,4,3
40025,40025,40026,4,9,5
40026,40026,40027,9,2,-7
40027,40027,40028,2,9,7
40028,40028,40029,9,7,-2
40029,40029,40030,7,4,-3
40030,40030,40031,4,8,4
40031,40031,40032,8,5,-3
40032,40032,40033,5,1,-4
40033,40033,40034,1,6,5
40034,40034,40035,6,3,-3
40035,40035,40036,3,6,3
40036,40036,40037,6,2,-4
40037,40037,40038,2,0,-2
40038,40038,40039,0,0,0
40039,40039,40040,0,0,0
40040,40040,40041,0,5,5
40041,40041,40042,5,0,-5
40042,40042,40043,0,0,0
40043,40043,40044,0,2,2
40044,40044,40045,2,1,-1
40045,40045,40046,1,7,6
40046,40046,40047,7,9,2
40047,40047,40048,9,8,-1
40048,40048,40049,8,2,-6
40049,40049,40050,2,9,7
40050,40050,40051,9,3,-6
40051,40051,40052,3,1,-2
40052,40052,40053,1,2,1
40053,40053,40054,2,2,0
40054,40054,40055,2,3,1
40055,40055,40056,3,1,-2
40056,40056,40057,1,5,4
40057,40057,40058,5,1,-4
40058,40058,40059,1,5,4
40059,40059,40060,5,7,2
40060,40060,40061,7,7,0
40061,40061,40062,7,4,-3
40062,40062,40063,4,9,5
40063,40063,40064,9,8,-1
40064,40064,40065,8,9,1
40065,40065,40066,9,4,-5
40066,40066,40067,4,7,3
40067,40067,40068,7,3,-4
40068,40068,40069,3,1,-2
40069,40069,40070,1,7,6
40070,40070,40071,7,1,-6
40071,40071,40072,1,6,5
40072,40072,40073,6,9,3
40073,40073,40074,9,0,-9
40074,40074,40075,0,0,0
40075,40075,40076,0,2,2
40076,40076,40077,2,7,5
40077,40077,40078,7,3,-4
40078,40078,40079,3,3,0
40079,40079,40080,3,7,4
40080,40080,40081,7,4,-3
40081,40081,40082,4,0,-4
40082,40082,40083,0,8,8
40083,40083,40084,8,2,-6
40084,40084,40085,2,6,4
40085,40085,40086,6,1,-5
40086,40086,40087,1,3,2
40087,40087,40088,3,5,2
40088,40088,40089,5,8,3
40089,40089,40090,8,2,-6
40090,40090,40091,2,0,-2
40091,40091,40092,0,8,8
40092,40092,40093,8,6,-2
40093,40093,40094,6,4,-2
40094,40094,40095,4,2,-2
40095,40095,40096,2,2,0
40096,40096,40097,2,1,-1
40097,40097,40098,1,1,0
40098,40098,40099,1,0,-1
40099,40099,40100,0,3,3
40100,40100,40101,3,1,-2
40101,40101,40102,1,9,8
40102,40102,40103,9,0,-9
40103,40103,40104,0,3,3
40104,40104,40105,3,6,3
40105,40105,40106,6,8,2
40106,40106,40107,8,2,-6
40107,40107,40108,2,0,-2
40108,40108,40109,0,3,3
40109,40109,40110,3,8,5
40110,40110,40111,8,8,0
40111,40111,40112,8,4,-4
40112,40112,40113,4,9,5
40113,40113,40114,9,7,-2
40114,40114,40115,7,0,-7
40115,40115,40116,0,4,4
40116,40116,40117,4,7,3
40117,40117,40118,7,7,0
40118,40118,40119,7,2,-5
40119,40119,40120,2,2,0
40120,40120,40121,2,3,1
40121,40121,40122,3,0,-3
40122,40122,40123,0,4,4
40123,40123,40124,4,6,2
40124,40124,40125,6,5,-1
40125,40125,40126,5,9,4
40126,40126,40127,9,5,-4
40127,40127,40128,5,9,4
40128,40128,40129,9,2,-7
40129,40129,40130,2,4,2
40130,40130,40131,4,8,4
40131,40131,40132,8,1,-7
40132,40132,40133,1,5,4
40133,40133,40134,5,8,3
40134,40134,40135,8,4,-4
40135,40135,40136,4,9,5
40136,40136,40137,9,6,-3
40137,40137,40138,6,8,2
40138,40138,40139,8,6,-2
40139,40139,40140,6,1,-5
40140,40140,40141,1,6,5
40141,40141,40142,6,1,-5
40142,40142,40143,1,7,6
40143,40143,40144,7,5,-2
40144,40144,40145,5,9,4
40145,40145,40146,9,8,-1
40146,40146,40147,8,1,-7
40147,40147,40148,1,1,0
40148,40148,40149,1,8,7
40149,40149,40150,8,0,-8
40150,40150,40151,0,2,2
40151,40151,40152,2,2,0
40152,40152,40153,2,1,-1
40153,40153,40154,1,5,4
40154,40154,40155,5,2,-3
40155,40155,40156,2,4,2
40156,40156,40157,4,6,2
40157,40157,40158,6,8,2
40158,40158,40159,8,5,-3
40159,40159,40160,5,2,-3
40160,40160,40161,2,3,1
40161,40161,40162,3,0,-3
40162,40162,40163,0,4,4
40163,40163,40164,4,4,0
40164,40164,40165,4,7,3
40165,40165,40166,7,3,-4
40166,40166,40167,3,9,6
40167,40167,40168,9,4,-5
40168,40168,40169,4,4,0
40169,40169,40170,4,7,3
40170,40170,40171,7,0,-7
40171,40171,40172,0,5,5
40172,40172,40173,5,0,-5
40173,40173,40174,0,9,9
40174,40174,40175,9,5,-4
40175,40175,40176,5,6,1
40176,40176,40177,6,9,3
40177,40177,40178,9,1,-8
40178,40178,40179,1,0,-1
40179,40179,40180,0,0,0
40180,40180,40181,0,1,1
40181,40181,40182,1,5,4
40182,40182,40183,5,2,-3
40183,40183,40184,2,3,1
40184,40184,40185,3,3,0
40185,40185,40186,3,7,4
40186,40186,40187,7,4,-3
40187,40187,40188,4,0,-4
40188,40188,40189,0,5,5
40189,40189,40190,5,1,-4
40190,40190,40191,1,6,5
40191,40191,40192,6,8,2
40192,40192,40193,8,7,-1
40193,40193,40194,7,5,-2
40194,40194,40195,5,8,3
40195,40195,40196,8,1,-7
40196,40196,40197,1,9,8
40197,40197,40198,9,2,-7
40198,40198,40199,2,0,-2
40199,40199,40200,0,0,0
40200,40200,40201,0,1,1
40201,40201,40202,1,3,2
40202,40202,40203,3,2,-1
40203,40203,40204,2,7,5
40204,40204,40205,7,3,-4
40205,40205,40206,3,2,-1
40206,40206,40207,2,5,3
40207,40207,40208,5,0,-5
40208,40208,40209,0,6,6
40209,40209,40210,6,1,-5
40210,40210,40211,1,7,6
40211,40211,40212,7,2,-5
40212,40212,40213,2,8,6
40213,40213,40214,8,7,-1
40214,40214,40215,7,9,2
40215,40215,40216,9,7,-2
40216,40216,40217,7,0,-7
40217,40217,40218,0,0,0
40218,40218,40219,0,1,1
40219,40219,40220,1,1,0
40220,40220,40221,1,2,1
40221,40221,40222,2,7,5
40222,40222,40223,7,3,-4
40223,40223,40224,3,4,1
40224,40224,40225,4,4,0
40225,40225,40226,4,4,0
40226,40226,40227,4,5,1
40227,40227,40228,5,0,-5
40228,40228,40229,0,6,6
40229,40229,40230,6,6,0
40230,40230,40231,6,7,1
40231,40231,40232,7,7,0
40232,40232,40233,7,8,1
40233,40233,40234,8,4,-4
40234,40234,40235,4,9,5
40235,40235,40236,9,4,-5
40236,40236,40237,4,0,-4
40237,40237,40238,0,4,4
40238,40238,40239,4,7,3
40239,40239,40240,7,0,-7
40240,40240,40241,0,0,0
40241,40241,40242,0,7,7
40242,40242,40243,7,7,0
40243,40243,40244,7,6,-1
40244,40244,40245,6,8,2
40245,40245,40246,8,0,-8
40246,40246,40247,0,3,3
40247,40247,40248,3,1,-2
40248,40248,40249,1,0,-1
40249,40249,40250,0,9,9
40250,40250,40251,9,0,-9
40251,40251,40252,0,8,8
40252,40252,40253,8,5,-3
40253,40253,40254,5,3,-2
40254,40254,40255,3,5,2
40255,40255,40256,5,3,-2
40256,40256,40257,3,3,0
40257,40257,40258,3,5,2
40258,40258,40259,5,8,3
40259,40259,40260,8,0,-8
40260,40260,40261,0,8,8
40261,40261,40262,8,0,-8
40262,40262,40263,0,1,1
40263,40263,40264,1,9,8
40264,40264,40265,9,8,-1
40265,40265,40266,8,0,-8
40266,40266,40267,0,4,4
40267,40267,40268,4,5,1
40268,40268,40269,5,9,4
40269,40269,40270,9,9,0
40270,40270,40271,9,6,-3
40271,40271,40272,6,2,-4
40272,40272,40273,2,1,-1
40273,40273,40274,1,8,7
40274,40274,40275,8,8,0
40275,40275,40276,8,1,-7
40276,40276,40277,1,0,-1
40277,40277,40278,0,6,6
40278,40278,40279,6,2,-4
40279,40279,40280,2,0,-2
40280,40280,40281,0,3,3
40281,40281,40282,3,6,3
40282,40282,40283,6,9,3
40283,40283,40284,9,0,-9
40284,40284,40285,0,4,4
40285,40285,40286,4,0,-4
40286,40286,40287,0,1,1
40287,40287,40288,1,4,3
40288,40288,40289,4,2,-2
40289,40289,40290,2,5,3
40290,40290,40291,5,5,0
40291,40291,40292,5,9,4
40292,40292,40293,9,9,0
40293,40293,40294,9,1,-8
40294,40294,40295,1,8,7
40295,40295,40296,8,8,0
40296,40296,40297,8,9,1
40297,40297,40298,9,3,-6
40298,40298,40299,3,4,1
40299,40299,40300,4,9,5
40300,40300,40301,9,3,-6
40301,40301,40302,3,9,6
40302,40302,40303,9,0,-9
40303,40303,40304,0,6,6
40304,40304,40305,6,3,-3
40305,40305,40306,3,8,5
40306,40306,40307,8,3,-5
40307,40307,40308,3,7,4
40308,40308,40309,7,4,-3
40309,40309,40310,4,1,-3
40310,40310,40311,1,7,6
40311,40311,40312,7,0,-7
40312,40312,40313,0,0,0
40313,40313,40314,0,1,1
40314,40314,40315,1,1,0
40315,40315,40316,1,4,3
40316,40316,40317,4,9,5
40317,40317,40318,9,2,-7
40318,40318,40319,2,1,-1
40319,40319,40320,1,0,-1
40320,40320,40321,0,2,2
40321,40321,40322,2,0,-2
40322,40322,40323,0,7,7
40323,40323,40324,7,8,1
40324,40324,40325,8,9,1
40325,40325,40326,9,5,-4
40326,40326,40327,5,1,-4
40327,40327,40328,1,9,8
40328,40328,40329,9,0,-9
40329,40329,40330,0,9,9
40330,40330,40331,9,6,-3
40331,40331,40332,6,6,0
40332,40332,40333,6,2,-4
40333,40333,40334,2,4,2
40334,40334,40335,4,0,-4
40335,40335,40336,0,0,0
40336,40336,40337,0,3,3
40337,40337,40338,3,7,4
40338,40338,40339,7,8,1
40339,40339,40340,8,0,-8
40340,40340,40341,0,9,9
40341,40341,40342,9,6,-3
40342,40342,40343,6,4,-2
40343,40343,40344,4,7,3
40344,40344,40345,7,2,-5
40345,40345,40346,2,5,3
40346,40346,40347,5,5,0
40347,40347,40348,5,1,-4
40348,40348,40349,1,6,5
40349,40349,40350,6,5,-1
40350,40350,40351,5,6,1
40351,40351,40352,6,1,-5
40352,40352,40353,1,5,4
40353,40353,40354,5,4,-1
40354,40354,40355,4,6,2
40355,40355,40356,6,6,0
40356,40356,40357,6,7,1
40357,40357,40358,7,7,0
40358,40358,40359,7,1,-6
40359,40359,40360,1,2,1
40360,40360,40361,2,4,2
40361,40361,40362,4,1,-3
40362,40362,40363,1,4,3
40363,40363,40364,4,8,4
40364,40364,40365,8,2,-6
40365,40365,40366,2,2,0
40366,40366,40367,2,6,4
40367,40367,40368,6,7,1
40368,40368,40369,7,2,-5
40369,40369,40370,2,7,5
40370,40370,40371,7,9,2
40371,40371,40372,9,9,0
40372,40372,40373,9,1,-8
40373,40373,40374,1,3,2
40374,40374,40375,3,3,0
40375,40375,40376,3,2,-1
40376,40376,40377,2,1,-1
40377,40377,40378,1,7,6
40378,40378,40379,7,4,-3
40379,40379,40380,4,1,-3
40380,40380,40381,1,8,7
40381,40381,40382,8,3,-5
40382,40382,40383,3,6,3
40383,40383,40384,6,3,-3
40384,40384,40385,3,3,0
40385,40385,40386,3,7,4
40386,40386,40387,7,7,0
40387,40387,40388,7,2,-5
40388,40388,40389,2,0,-2
40389,40389,40390,0,0,0
40390,40390,40391,0,9,9
40391,40391,40392,9,4,-5
40392,40392,40393,4,5,1
40393,40393,40394,5,6,1
40394,40394,40395,6,6,0
40395,40395,40396,6,0,-6
40396,40396,40397,0,7,7
40397,40397,40398,7,8,1
40398,40398,40399,8,1,-7
40399,40399,40400,1,0,-1
40400,40400,40401,0,3,3
40401,40401,40402,3,4,1
40402,40402,40403,4,8,4
40403,40403,40404,8,3,-5
40404,40404,40405,3,2,-1
40405,40405,40406,2,7,5
40406,40406,40407,7,6,-1
40407,40407,40408,6,8,2
40408,40408,40409,8,2,-6
40409,40409,40410,2,8,6
40410,40410,40411,8,6,-2
40411,40411,40412,6,0,-6
40412,40412,40413,0,2,2
40413,40413,40414,2,0,-2
40414,40414,40415,0,7,7
40415,40415,40416,7,2,-5
40416,40416,40417,2,8,6
40417,40417,40418,8,0,-8
40418,40418,40419,0,7,7
40419,40419,40420,7,2,-5
40420,40420,40421,2,0,-2
40421,40421,40422,0,5,5
40422,40422,40423,5,1,-4
40423,40423,40424,1,4,3
40424,40424,40425,4,2,-2
40425,40425,40426,2,4,2
40426,40426,40427,4,3,-1
40427,40427,40428,3,0,-3
40428,40428,40429,0,4,4
40429,40429,40430,4,7,3
40430,40430,40431,7,5,-2
40431,40431,40432,5,5,0
40432,40432,40433,5,6,1
40433,40433,40434,6,5,-1
40434,40434,40435,5,7,2
40435,40435,40436,7,7,0
40436,40436,40437,7,8,1
40437,40437,40438,8,1,-7
40438,40438,40439,1,9,8
40439,40439,40440,9,9,0
40440,40440,40441,9,0,-9
40441,40441,40442,0,7,7
40442,40442,40443,7,1,-6
40443,40443,40444,1,4,3
40444,40444,40445,4,2,-2
40445,40445,40446,2,9,7
40446,40446,40447,9,3,-6
40447,40447,40448,3,9,6
40448,40448,40449,9,4,-5
40449,40449,40450,4,4,0
40450,40450,40451,4,7,3
40451,40451,40452,7,3,-4
40452,40452,40453,3,8,5
40453,40453,40454,8,0,-8
40454,40454,40455,0,9,9
40455,40455,40456,9,0,-9
40456,40456,40457,0,0,0
40457,40457,40458,0,9,9
40458,40458,40459,9,1,-8
40459,40459,40460,1,4,3
40460,40460,40461,4,2,-2
40461,40461,40462,2,3,1
40462,40462,40463,3,3,0
40463,40463,40464,3,1,-2
40464,40464,40465,1,7,6
40465,40465,40466,7,8,1
40466,40466,40467,8,8,0
40467,40467,40468,8,1,-7
40468,40468,40469,1,9,8
40469,40469,40470,9,7,-2
40470,40470,40471,7,0,-7
40471,40471,40472,0,8,8
40472,40472,40473,8,5,-3
40473,40473,40474,5,5,0
40474,40474,40475,5,6,1
40475,40475,40476,6,7,1
40476,40476,40477,7,9,2
40477,40477,40478,9,5,-4
40478,40478,40479,5,0,-5
40479,40479,40480,0,3,3
40480,40480,40481,3,3,0
40481,40481,40482,3,1,-2
40482,40482,40483,1,3,2
40483,40483,40484,3,6,3
40484,40484,40485,6,9,3
40485,40485,40486,9,0,-9
40486,40486,40487,0,9,9
40487,40487,40488,9,8,-1
40488,40488,40489,8,5,-3
40489,40489,40490,5,3,-2
40490,40490,40491,3,6,3
40491,40491,40492,6,6,0
40492,40492,40493,6,4,-2
40493,40493,40494,4,0,-4
40494,40494,40495,0,4,4
40495,40495,40496,4,4,0
40496,40496,40497,4,2,-2
40497,40497,40498,2,2,0
40498,40498,40499,2,9,7
40499,40499,40500,9,7,-2
40500,40500,40501,7,6,-1
40501,40501,40502,6,3,-3
40502,40502,40503,3,8,5
40503,40503,40504,8,1,-7
40504,40504,40505,1,7,6
40505,40505,40506,7,7,0
40506,40506,40507,7,9,2
40507,40507,40508,9,9,0
40508,40508,40509,9,1,-8
40509,40509,40510,1,7,6
40510,40510,40511,7,5,-2
40511,40511,40512,5,7,2
40512,40512,40513,7,2,-5
40513,40513,40514,2,6,4
40514,40514,40515,6,6,0
40515,40515,40516,6,1,-5
40516,40516,40517,1,3,2
40517,40517,40518,3,5,2
40518,40518,40519,5,4,-1
40519,40519,40520,4,3,-1
40520,40520,40521,3,0,-3
40521,40521,40522,0,9,9
40522,40522,40523,9,4,-5
40523,40523,40524,4,7,3
40524,40524,40525,7,1,-6
40525,40525,40526,1,6,5
40526,40526,40527,6,6,0
40527,40527,40528,6,9,3
40528,40528,40529,9,4,-5
40529,40529,40530,4,2,-2
40530,40530,40531,2,9,7
40531,40531,40532,9,3,-6
40532,40532,40533,3,6,3
40533,40533,40534,6,5,-1
40534,40534,40535,5,5,0
40535,40535,40536,5,2,-3
40536,40536,40537,2,1,-1
40537,40537,40538,1,6,5
40538,40538,40539,6,2,-4
40539,40539,40540,2,3,1
40540,40540,40541,3,6,3
40541,40541,40542,6,2,-4
40542,40542,40543,2,6,4
40543,40543,40544,6,0,-6
40544,40544,40545,0,7,7
40545,40545,40546,7,5,-2
40546,40546,40547,5,8,3
40547,40547,40548,8,4,-4
40548,40548,40549,4,8,4
40549,40549,40550,8,3,-5
40550,40550,40551,3,1,-2
40551,40551,40552,1,4,3
40552,40552,40553,4,8,4
40553,40553,40554,8,6,-2
40554,40554,40555,6,3,-3
40555,40555,40556,3,2,-1
40556,40556,40557,2,7,5
40557,40557,40558,7,8,1
40558,40558,40559,8,7,-1
40559,40559,40560,7,6,-1
40560,40560,40561,6,1,-5
40561,40561,40562,1,2,1
40562,40562,40563,2,0,-2
40563,40563,40564,0,6,6
40564,40564,40565,6,0,-6
40565,40565,40566,0,2,2
40566,40566,40567,2,5,3
40567,40567,40568,5,1,-4
40568,40568,40569,1,2,1
40569,40569,40570,2,3,1
40570,40570,40571,3,8,5
40571,40571,40572,8,3,-5
40572,40572,40573,3,4,1
40573,40573,40574,4,3,-1
40574,40574,40575,3,3,0
40575,40575,40576,3,4,1
40576,40576,40577,4,1,-3
40577,40577,40578,1,3,2
40578,40578,40579,3,8,5
40579,40579,40580,8,2,-6
40580,40580,40581,2,2,0
40581,40581,40582,2,0,-2
40582,40582,40583,0,9,9
40583,40583,40584,9,9,0
40584,40584,40585,9,9,0
40585,40585,40586,9,0,-9
40586,40586,40587,0,5,5
40587,40587,40588,5,3,-2
40588,40588,40589,3,2,-1
40589,40589,40590,2,7,5
40590,40590,40591,7,6,-1
40591,40591,40592,6,2,-4
40592,40592,40593,2,4,2
40593,40593,40594,4,6,2
40594,40594,40595,6,8,2
40595,40595,40596,8,6,-2
40596,40596,40597,6,2,-4
40597,40597,40598,2,2,0
40598,40598,40599,2,5,3
40599,40599,40600,5,4,-1
40600,40600,40601,4,4,0
40601,40601,40602,4,4,0
40602,40602,40603,4,7,3
40603,40603,40604,7,1,-6
40604,40604,40605,1,1,0
40605,40605,40606,1,4,3
40606,40606,40607,4,2,-2
40607,40607,40608,2,9,7
40608,40608,40609,9,6,-3
40609,40609,40610,6,1,-5
40610,40610,40611,1,0,-1
40611,40611,40612,0,0,0
40612,40612,40613,0,0,0
40613,40613,40614,0,2,2
40614,40614,40615,2,1,-1
40615,40615,40616,1,6,5
40616,40616,40617,6,2,-4
40617,40617,40618,2,3,1
40618,40618,40619,3,3,0
40619,40619,40620,3,3,0
40620,40620,40621,3,4,1
40621,40621,40622,4,2,-2
40622,40622,40623,2,5,3
40623,40623,40624,5,5,0
40624,40624,40625,5,6,1
40625,40625,40626,6,8,2
40626,40626,40627,8,7,-1
40627,40627,40628,7,9,2
40628,40628,40629,9,8,-1
40629,40629,40630,8,0,-8
40630,40630,40631,0,9,9
40631,40631,40632,9,2,-7
40632,40632,40633,2,0,-2
40633,40633,40634,0,9,9
40634,40634,40635,9,1,-8
40635,40635,40636,1,3,2
40636,40636,40637,3,2,-1
40637,40637,40638,2,7,5
40638,40638,40639,7,3,-4
40639,40639,40640,3,5,2
40640,40640,40641,5,6,1
40641,40641,40642,6,6,0
40642,40642,40643,6,7,1
40643,40643,40644,7,1,-6
40644,40644,40645,1,8,7
40645,40645,40646,8,8,0
40646,40646,40647,8,9,1
40647,40647,40648,9,0,-9
40648,40648,40649,0,0,0
40649,40649,40650,0,6,6
40650,40650,40651,6,1,-5
40651,40651,40652,1,8,7
40652,40652,40653,8,2,-6
40653,40653,40654,2,5,3
40654,40654,40655,5,3,-2
40655,40655,40656,3,9,6
40656,40656,40657,9,4,-5
40657,40657,40658,4,1,-3
40658,40658,40659,1,5,4
40659,40659,40660,5,4,-1
40660,40660,40661,4,6,2
40661,40661,40662,6,3,-3
40662,40662,40663,3,7,4
40663,40663,40664,7,1,-6
40664,40664,40665,1,8,7
40665,40665,40666,8,9,1
40666,40666,40667,9,9,0
40667,40667,40668,9,7,-2
40668,40668,40669,7,5,-2
40669,40669,40670,5,9,4
40670,40670,40671,9,4,-5
40671,40671,40672,4,4,0
40672,40672,40673,4,8,4
40673,40673,40674,8,5,-3
40674,40674,40675,5,7,2
40675,40675,40676,7,6,-1
40676,40676,40677,6,4,-2
40677,40677,40678,4,5,1
40678,40678,40679,5,7,2
40679,40679,40680,7,4,-3
40680,40680,40681,4,7,3
40681,40681,40682,7,1,-6
40682,40682,40683,1,3,2
40683,40683,40684,3,7,4
40684,40684,40685,7,9,2
40685,40685,40686,9,2,-7
40686,40686,40687,2,8,6
40687,40687,40688,8,5,-3
40688,40688,40689,5,8,3
40689,40689,40690,8,0,-8
40690,40690,40691,0,3,3
40691,40691,40692,3,1,-2
40692,40692,40693,1,1,0
40693,40693,40694,1,1,0
40694,40694,40695,1,5,4
40695,40695,40696,5,1,-4
40696,40696,40697,1,8,7
40697,40697,40698,8,8,0
40698,40698,40699,8,2,-6
40699,40699,40700,2,7,5
40700,40700,40701,7,7,0
40701,40701,40702,7,4,-3
40702,40702,40703,4,4,0
40703,40703,40704,4,5,1
40704,40704,40705,5,2,-3
40705,40705,40706,2,8,6
40706,40706,40707,8,6,-2
40707,40707,40708,6,8,2
40708,40708,40709,8,4,-4
40709,40709,40710,4,7,3
40710,40710,40711,7,5,-2
40711,40711,40712,5,7,2
40712,40712,40713,7,5,-2
40713,40713,40714,5,1,-4
40714,40714,40715,1,8,7
40715,40715,40716,8,1,-7
40716,40716,40717,1,6,5
40717,40717,40718,6,2,-4
40718,40718,40719,2,4,2
40719,40719,40720,4,3,-1
40720,40720,40721,3,4,1
40721,40721,40722,4,3,-1
40722,40722,40723,3,4,1
40723,40723,40724,4,1,-3
40724,40724,40725,1,1,0
40725,40725,40726,1,8,7
40726,40726,40727,8,8,0
40727,40727,40728,8,7,-1
40728,40728,40729,7,7,0
40729,40729,40730,7,7,0
40730,40730,40731,7,5,-2
40731,40731,40732,5,0,-5
40732,40732,40733,0,5,5
40733,40733,40734,5,3,-2
40734,40734,40735,3,1,-2
40735,40735,40736,1,5,4
40736,40736,40737,5,8,3
40737,40737,40738,8,5,-3
40738,40738,40739,5,3,-2
40739,40739,40740,3,2,-1
40740,40740,40741,2,6,4
40741,40741,40742,6,7,1
40742,40742,40743,7,3,-4
40743,40743,40744,3,1,-2
40744,40744,40745,1,3,2
40745,40745,40746,3,0,-3
40746,40746,40747,0,2,2
40747,40747,40748,2,5,3
40748,40748,40749,5,2,-3
40749,40749,40750,2,8,6
40750,40750,40751,8,6,-2
40751,40751,40752,6,3,-3
40752,40752,40753,3,9,6
40753,40753,40754,9,6,-3
40754,40754,40755,6,9,3
40755,40755,40756,9,5,-4
40756,40756,40757,5,6,1
40757,40757,40758,6,8,2
40758,40758,40759,8,5,-3
40759,40759,40760,5,0,-5
40760,40760,40761,0,5,5
40761,40761,40762,5,9,4
40762,40762,40763,9,3,-6
40763,40763,40764,3,9,6
40764,40764,40765,9,3,-6
40765,40765,40766,3,4,1
40766,40766,40767,4,8,4
40767,40767,40768,8,7,-1
40768,40768,40769,7,1,-6
40769,40769,40770,1,1,0
40770,40770,40771,1,6,5
40771,40771,40772,6,9,3
40772,40772,40773,9,5,-4
40773,40773,40774,5,7,2
40774,40774,40775,7,6,-1
40775,40775,40776,6,5,-1
40776,40776,40777,5,8,3
40777,40777,40778,8,0,-8
40778,40778,40779,0,1,1
40779,40779,40780,1,0,-1
40780,40780,40781,0,9,9
40781,40781,40782,9,2,-7
40782,40782,40783,2,7,5
40783,40783,40784,7,7,0
40784,40784,40785,7,6,-1
40785,40785,40786,6,9,3
40786,40786,40787,9,8,-1
40787,40787,40788,8,2,-6
40788,40788,40789,2,3,1
40789,40789,40790,3,1,-2
40790,40790,40791,1,7,6
40791,40791,40792,7,8,1
40792,40792,40793,8,4,-4
40793,40793,40794,4,7,3
40794,40794,40795,7,7,0
40795,40795,40796,7,1,-6
40796,40796,40797,1,0,-1
40797,40797,40798,0,6,6
40798,40798,40799,6,9,3
40799,40799,40800,9,9,0
40800,40800,40801,9,0,-9
40801,40801,40802,0,1,1
40802,40802,40803,1,0,-1
40803,40803,40804,0,9,9
40804,40804,40805,9,3,-6
40805,40805,40806,3,4,1
40806,40806,40807,4,7,3
40807,40807,40808,7,8,1
40808,40808,40809,8,9,1
40809,40809,40810,9,7,-2
40810,40810,40811,7,3,-4
40811,40811,40812,3,2,-1
40812,40812,40813,2,0,-2
40813,40813,40814,0,8,8
40814,40814,40815,8,2,-6
40815,40815,40816,2,2,0
40816,40816,40817,2,0,-2
40817,40817,40818,0,3,3
40818,40818,40819,3,1,-2
40819,40819,40820,1,0,-1
40820,40820,40821,0,0,0
40821,40821,40822,0,7,7
40822,40822,40823,7,1,-6
40823,40823,40824,1,5,4
40824,40824,40825,5,0,-5
40825,40825,40826,0,1,1
40826,40826,40827,1,4,3
40827,40827,40828,4,6,2
40828,40828,40829,6,0,-6
40829,40829,40830,0,3,3
40830,40830,40831,3,1,-2
40831,40831,40832,1,2,1
40832,40832,40833,2,0,-2
40833,40833,40834,0,4,4
40834,40834,40835,4,4,0
40835,40835,40836,4,3,-1
40836,40836,40837,3,7,4
40837,40837,40838,7,7,0
40838,40838,40839,7,9,2
40839,40839,40840,9,5,-4
40840,40840,40841,5,2,-3
40841,40841,40842,2,4,2
40842,40842,40843,4,0,-4
40843,40843,40844,0,0,0
40844,40844,40845,0,6,6
40845,40845,40846,6,4,-2
40846,40846,40847,4,2,-2
40847,40847,40848,2,1,-1
40848,40848,40849,1,6,5
40849,40849,40850,6,0,-6
40850,40850,40851,0,2,2
40851,40851,40852,2,8,6
40852,40852,40853,8,2,-6
40853,40853,40854,2,9,7
40854,40854,40855,9,9,0
40855,40855,40856,9,8,-1
40856,40856,40857,8,9,1
40857,40857,40858,9,3,-6
40858,40858,40859,3,0,-3
40859,40859,40860,0,1,1
40860,40860,40861,1,1,0
40861,40861,40862,1,6,5
40862,40862,40863,6,2,-4
40863,40863,40864,2,1,-1
40864,40864,40865,1,3,2
40865,40865,40866,3,3,0
40866,40866,40867,3,4,1
40867,40867,40868,4,5,1
40868,40868,40869,5,5,0
40869,40869,40870,5,2,-3
40870,40870,40871,2,6,4
40871,40871,40872,6,7,1
40872,40872,40873,7,7,0
40873,40873,40874,7,6,-1
40874,40874,40875,6,8,2
40875,40875,40876,8,9,1
40876,40876,40877,9,0,-9
40877,40877,40878,0,1,1
40878,40878,40879,1,1,0
40879,40879,40880,1,1,0
40880,40880,40881,1,2,1
40881,40881,40882,2,8,6
40882,40882,40883,8,3,-5
40883,40883,40884,3,1,-2
40884,40884,40885,1,4,3
40885,40885,40886,4,2,-2
40886,40886,40887,2,5,3
40887,40887,40888,5,0,-5
40888,40888,40889,0,6,6
40889,40889,40890,6,9,3
40890,40890,40891,9,7,-2
40891,40891,40892,7,3,-4
40892,40892,40893,3,8,5
40893,40893,40894,8,6,-2
40894,40894,40895,6,0,-6
40895,40895,40896,0,1,1
40896,40896,40897,1,1,0
40897,40897,40898,1,3,2
40898,40898,40899,3,2,-1
40899,40899,40900,2,2,0
40900,40900,40901,2,3,1
40901,40901,40902,3,5,2
40902,40902,40903,5,4,-1
40903,40903,40904,4,3,-1
40904,40904,40905,3,5,2
40905,40905,40906,5,7,2
40906,40906,40907,7,6,-1
40907,40907,40908,6,1,-5
40908,40908,40909,1,1,0
40909,40909,40910,1,4,3
40910,40910,40911,4,7,3
40911,40911,40912,7,4,-3
40912,40912,40913,4,4,0
40913,40913,40914,4,3,-1
40914,40914,40915,3,0,-3
40915,40915,40916,0,7,7
40916,40916,40917,7,6,-1
40917,40917,40918,6,1,-5
40918,40918,40919,1,4,3
40919,40919,40920,4,5,1
40920,40920,40921,5,1,-4
40921,40921,40922,1,0,-1
40922,40922,40923,0,4,4
40923,40923,40924,4,1,-3
40924,40924,40925,1,3,2
40925,40925,40926,3,3,0
40926,40926,40927,3,6,3
40927,40927,40928,6,8,2
40928,40928,40929,8,2,-6
40929,40929,40930,2,5,3
40930,40930,40931,5,3,-2
40931,40931,40932,3,3,0
40932,40932,40933,3,4,1
40933,40933,40934,4,4,0
40934,40934,40935,4,8,4
40935,40935,40936,8,2,-6
40936,40936,40937,2,7,5
40937,40937,40938,7,9,2
40938,40938,40939,9,8,-1
40939,40939,40940,8,3,-5
40940,40940,40941,3,6,3
40941,40941,40942,6,8,2
40942,40942,40943,8,9,1
40943,40943,40944,9,1,-8
40944,40944,40945,1,8,7
40945,40945,40946,8,4,-4
40946,40946,40947,4,3,-1
40947,40947,40948,3,2,-1
40948,40948,40949,2,2,0
40949,40949,40950,2,4,2
40950,40950,40951,4,2,-2
40951,40951,40952,2,6,4
40952,40952,40953,6,8,2
40953,40953,40954,8,1,-7
40954,40954,40955,1,4,3
40955,40955,40956,4,2,-2
40956,40956,40957,2,8,6
40957,40957,40958,8,0,-8
40958,40958,40959,0,5,5
40959,40959,40960,5,8,3
40960,40960,40961,8,6,-2
40961,40961,40962,6,3,-3
40962,40962,40963,3,5,2
40963,40963,40964,5,5,0
40964,40964,40965,5,0,-5
40965,40965,40966,0,5,5
40966,40966,40967,5,2,-3
40967,40967,40968,2,2,0
40968,40968,40969,2,0,-2
40969,40969,40970,0,4,4
40970,40970,40971,4,1,-3
40971,40971,40972,1,5,4
40972,40972,40973,5,1,-4
40973,40973,40974,1,1,0
40974,40974,40975,1,2,1
40975,40975,40976,2,1,-1
40976,40976,40977,1,9,8
40977,40977,40978,9,9,0
40978,40978,40979,9,6,-3
40979,40979,40980,6,6,0
40980,40980,40981,6,8,2
40981,40981,40982,8,1,-7
40982,40982,40983,1,1,0
40983,40983,40984,1,9,8
40984,40984,40985,9,2,-7
40985,40985,40986,2,6,4
40986,40986,40987,6,1,-5
40987,40987,40988,1,2,1
40988,40988,40989,2,0,-2
40989,40989,40990,0,4,4
40990,40990,40991,4,6,2
40991,40991,40992,6,4,-2
40992,40992,40993,4,5,1
40993,40993,40994,5,9,4
40994,40994,40995,9,2,-7
40995,40995,40996,2,3,1
40996,40996,40997,3,9,6
40997,40997,40998,9,8,-1
40998,40998,40999,8,1,-7
40999,40999,41000,1,5,4
41000,41000,41001,5,5,0
41001,41001,41002,5,7,2
41002,41002,41003,7,3,-4
41003,41003,41004,3,2,-1
41004,41004,41005,2,9,7
41005,41005,41006,9,4,-5
41006,41006,41007,4,3,-1
41007,41007,41008,3,9,6
41008,41008,41009,9,7,-2
41009,41009,41010,7,3,-4
41010,41010,41011,3,1,-2
41011,41011,41012,1,0,-1
41012,41012,41013,0,8,8
41013,41013,41014,8,9,1
41014,41014,41015,9,3,-6
41015,41015,41016,3,5,2
41016,41016,41017,5,8,3
41017,41017,41018,8,6,-2
41018,41018,41019,6,1,-5
41019,41019,41020,1,4,3
41020,41020,41021,4,9,5
41021,41021,41022,9,4,-5
41022,41022,41023,4,5,1
41023,41023,41024,5,7,2
41024,41024,41025,7,5,-2
41025,41025,41026,5,7,2
41026,41026,41027,7,0,-7
41027,41027,41028,0,4,4
41028,41028,41029,4,1,-3
41029,41029,41030,1,0,-1
41030,41030,41031,0,1,1
41031,41031,41032,1,5,4
41032,41032,41033,5,9,4
41033,41033,41034,9,8,-1
41034,41034,41035,8,8,0
41035,41035,41036,8,4,-4
41036,41036,41037,4,2,-2
41037,41037,41038,2,0,-2
41038,41038,41039,0,6,6
41039,41039,41040,6,9,3
41040,41040,41041,9,0,-9
41041,41041,41042,0,9,9
41042,41042,41043,9,4,-5
41043,41043,41044,4,7,3
41044,41044,41045,7,5,-2
41045,41045,41046,5,8,3
41046,41046,41047,8,6,-2
41047,41047,41048,6,3,-3
41048,41048,41049,3,5,2
41049,41049,41050,5,6,1
41050,41050,41051,6,0,-6
41051,41051,41052,0,0,0
41052,41052,41053,0,3,3
41053,41053,41054,3,7,4
41054,41054,41055,7,1,-6
41055,41055,41056,1,0,-1
41056,41056,41057,0,8,8
41057,41057,41058,8,9,1
41058,41058,41059,9,6,-3
41059,41059,41060,6,6,0
41060,41060,41061,6,7,1
41061,41061,41062,7,7,0
41062,41062,41063,7,5,-2
41063,41063,41064,5,8,3
41064,41064,41065,8,9,1
41065,41065,41066,9,4,-5
41066,41066,41067,4,3,-1
41067,41067,41068,3,4,1
41068,41068,41069,4,0,-4
41069,41069,41070,0,9,9
41070,41070,41071,9,3,-6
41071,41071,41072,3,5,2
41072,41072,41073,5,1,-4
41073,41073,41074,1,2,1
41074,41074,41075,2,4,2
41075,41075,41076,4,1,-3
41076,41076,41077,1,0,-1
41077,41077,41078,0,8,8
41078,41078,41079,8,4,-4
41079,41079,41080,4,2,-2
41080,41080,41081,2,9,7
41081,41081,41082,9,2,-7
41082,41082,41083,2,7,5
41083,41083,41084,7,9,2
41084,41084,41085,9,3,-6
41085,41085,41086,3,6,3
41086,41086,41087,6,2,-4
41087,41087,41088,2,7,5
41088,41088,41089,7,6,-1
41089,41089,41090,6,1,-5
41090,41090,41091,1,5,4
41091,41091,41092,5,8,3
41092,41092,41093,8,4,-4
41093,41093,41094,4,5,1
41094,41094,41095,5,7,2
41095,41095,41096,7,4,-3
41096,41096,41097,4,9,5
41097,41097,41098,9,4,-5
41098,41098,41099,4,7,3
41099,41099,41100,7,0,-7
41100,41100,41101,0,0,0
41101,41101,41102,0,9,9
41102,41102,41103,9,1,-8
41103,41103,41104,1,1,0
41104,41104,41105,1,2,1
41105,41105,41106,2,8,6
41106,41106,41107,8,3,-5
41107,41107,41108,3,0,-3
41108,41108,41109,0,4,4
41109,41109,41110,4,3,-1
41110,41110,41111,3,6,3
41111,41111,41112,6,2,-4
41112,41112,41113,2,7,5
41113,41113,41114,7,9,2
41114,41114,41115,9,8,-1
41115,41115,41116,8,9,1
41116,41116,41117,9,0,-9
41117,41117,41118,0,8,8
41118,41118,41119,8,1,-7
41119,41119,41120,1,4,3
41120,41120,41121,4,2,-2
41121,41121,41122,2,0,-2
41122,41122,41123,0,3,3
41123,41123,41124,3,8,5
41124,41124,41125,8,4,-4
41125,41125,41126,4,0,-4
41126,41126,41127,0,5,5
41127,41127,41128,5,9,4
41128,41128,41129,9,6,-3
41129,41129,41130,6,8,2
41130,41130,41131,8,7,-1
41131,41131,41132,7,8,1
41132,41132,41133,8,8,0
41133,41133,41134,8,6,-2
41134,41134,41135,6,9,3
41135,41135,41136,9,3,-6
41136,41136,41137,3,0,-3
41137,41137,41138,0,0,0
41138,41138,41139,0,1,1
41139,41139,41140,1,5,4
41140,41140,41141,5,2,-3
41141,41141,41142,2,6,4
41142,41142,41143,6,3,-3
41143,41143,41144,3,5,2
41144,41144,41145,5,4,-1
41145,41145,41146,4,1,-3
41146,41146,41147,1,5,4
41147,41147,41148,5,7,2
41148,41148,41149,7,6,-1
41149,41149,41150,6,1,-5
41150,41150,41151,1,7,6
41151,41151,41152,7,5,-2
41152,41152,41153,5,8,3
41153,41153,41154,8,8,0
41154,41154,41155,8,9,1
41155,41155,41156,9,0,-9
41156,41156,41157,0,6,6
41157,41157,41158,6,0,-6
41158,41158,41159,0,4,4
41159,41159,41160,4,6,2
41160,41160,41161,6,7,1
41161,41161,41162,7,9,2
41162,41162,41163,9,4,-5
41163,41163,41164,4,7,3
41164,41164,41165,7,3,-4
41165,41165,41166,3,4,1
41166,41166,41167,4,6,2
41167,41167,41168,6,7,1
41168,41168,41169,7,2,-5
41169,41169,41170,2,6,4
41170,41170,41171,6,3,-3
41171,41171,41172,3,6,3
41172,41172,41173,6,4,-2
41173,41173,41174,4,7,3
41174,41174,41175,7,8,1
41175,41175,41176,8,7,-1
41176,41176,41177,7,9,2
41177,41177,41178,9,9,0
41178,41178,41179,9,2,-7
41179,41179,41180,2,8,6
41180,41180,41181,8,2,-6
41181,41181,41182,2,2,0
41182,41182,41183,2,8,6
41183,41183,41184,8,7,-1
41184,41184,41185,7,5,-2
41185,41185,41186,5,5,0
41186,41186,41187,5,0,-5
41187,41187,41188,0,6,6
41188,41188,41189,6,2,-4
41189,41189,41190,2,6,4
41190,41190,41191,6,0,-6
41191,41191,41192,0,4,4
41192,41192,41193,4,1,-3
41193,41193,41194,1,7,6
41194,41194,41195,7,1,-6
41195,41195,41196,1,9,8
41196,41196,41197,9,2,-7
41197,41197,41198,2,6,4
41198,41198,41199,6,9,3
41199,41199,41200,9,8,-1
41200,41200,41201,8,6,-2
41201,41201,41202,6,5,-1
41202,41202,41203,5,8,3
41203,41203,41204,8,2,-6
41204,41204,41205,2,1,-1
41205,41205,41206,1,4,3
41206,41206,41207,4,2,-2
41207,41207,41208,2,5,3
41208,41208,41209,5,1,-4
41209,41209,41210,1,1,0
41210,41210,41211,1,0,-1
41211,41211,41212,0,3,3
41212,41212,41213,3,6,3
41213,41213,41214,6,6,0
41214,41214,41215,6,5,-1
41215,41215,41216,5,2,-3
41216,41216,41217,2,2,0
41217,41217,41218,2,8,6
41218,41218,41219,8,9,1
41219,41219,41220,9,4,-5
41220,41220,41221,4,7,3
41221,41221,41222,7,1,-6
41222,41222,41223,1,5,4
41223,41223,41224,5,7,2
41224,41224,41225,7,3,-4
41225,41225,41226,3,1,-2
41226,41226,41227,1,9,8
41227,41227,41228,9,0,-9
41228,41228,41229,0,3,3
41229,41229,41230,3,5,2
41230,41230,41231,5,8,3
41231,41231,41232,8,7,-1
41232,41232,41233,7,3,-4
41233,41233,41234,3,2,-1
41234,41234,41235,2,8,6
41235,41235,41236,8,7,-1
41236,41236,41237,7,1,-6
41237,41237,41238,1,1,0
41238,41238,41239,1,9,8
41239,41239,41240,9,7,-2
41240,41240,41241,7,5,-2
41241,41241,41242,5,6,1
41242,41242,41243,6,5,-1
41243,41243,41244,5,7,2
41244,41244,41245,7,0,-7
41245,41245,41246,0,6,6
41246,41246,41247,6,1,-5
41247,41247,41248,1,1,0
41248,41248,41249,1,1,0
41249,41249,41250,1,7,6
41250,41250,41251,7,9,2
41251,41251,41252,9,0,-9
41252,41252,41253,0,8,8
41253,41253,41254,8,9,1
41254,41254,41255,9,2,-7
41255,41255,41256,2,2,0
41256,41256,41257,2,6,4
41257,41257,41258,6,5,-1
41258,41258,41259,5,0,-5
41259,41259,41260,0,2,2
41260,41260,41261,2,6,4
41261,41261,41262,6,6,0
41262,41262,41263,6,5,-1
41263,41263,41264,5,2,-3
41264,41264,41265,2,0,-2
41265,41265,41266,0,1,1
41266,41266,41267,1,3,2
41267,41267,41268,3,6,3
41268,41268,41269,6,1,-5
41269,41269,41270,1,9,8
41270,41270,41271,9,8,-1
41271,41271,41272,8,6,-2
41272,41272,41273,6,6,0
41273,41273,41274,6,9,3
41274,41274,41275,9,7,-2
41275,41275,41276,7,2,-5
41276,41276,41277,2,5,3
41277,41277,41278,5,5,0
41278,41278,41279,5,9,4
41279,41279,41280,9,7,-2
41280,41280,41281,7,9,2
41281,41281,41282,9,1,-8
41282,41282,41283,1,3,2
41283,41283,41284,3,2,-1
41284,41284,41285,2,0,-2
41285,41285,41286,0,0,0
41286,41286,41287,0,3,3
41287,41287,41288,3,0,-3
41288,41288,41289,0,1,1
41289,41289,41290,1,2,1
41290,41290,41291,2,0,-2
41291,41291,41292,0,2,2
41292,41292,41293,2,4,2
41293,41293,41294,4,2,-2
41294,41294,41295,2,9,7
41295,41295,41296,9,0,-9
41296,41296,41297,0,7,7
41297,41297,41298,7,4,-3
41298,41298,41299,4,3,-1
41299,41299,41300,3,7,4
41300,41300,41301,7,2,-5
41301,41301,41302,2,9,7
41302,41302,41303,9,6,-3
41303,41303,41304,6,8,2
41304,41304,41305,8,5,-3
41305,41305,41306,5,9,4
41306,41306,41307,9,4,-5
41307,41307,41308,4,6,2
41308,41308,41309,6,7,1
41309,41309,41310,7,7,0
41310,41310,41311,7,9,2
41311,41311,41312,9,5,-4
41312,41312,41313,5,7,2
41313,41313,41314,7,5,-2
41314,41314,41315,5,0,-5
41315,41315,41316,0,6,6
41316,41316,41317,6,3,-3
41317,41317,41318,3,0,-3
41318,41318,41319,0,4,4
41319,41319,41320,4,0,-4
41320,41320,41321,0,5,5
41321,41321,41322,5,5,0
41322,41322,41323,5,6,1
41323,41323,41324,6,7,1
41324,41324,41325,7,7,0
41325,41325,41326,7,9,2
41326,41326,41327,9,8,-1
41327,41327,41328,8,7,-1
41328,41328,41329,7,9,2
41329,41329,41330,9,2,-7
41330,41330,41331,2,0,-2
41331,41331,41332,0,1,1
41332,41332,41333,1,1,0
41333,41333,41334,1,9,8
41334,41334,41335,9,2,-7
41335,41335,41336,2,7,5
41336,41336,41337,7,3,-4
41337,41337,41338,3,0,-3
41338,41338,41339,0,7,7
41339,41339,41340,7,2,-5
41340,41340,41341,2,0,-2
41341,41341,41342,0,4,4
41342,41342,41343,4,3,-1
41343,41343,41344,3,6,3
41344,41344,41345,6,7,1
41345,41345,41346,7,6,-1
41346,41346,41347,6,8,2
41347,41347,41348,8,2,-6
41348,41348,41349,2,9,7
41349,41349,41350,9,0,-9
41350,41350,41351,0,6,6
41351,41351,41352,6,0,-6
41352,41352,41353,0,0,0
41353,41353,41354,0,4,4
41354,41354,41355,4,4,0
41355,41355,41356,4,3,-1
41356,41356,41357,3,0,-3
41357,41357,41358,0,0,0
41358,41358,41359,0,8,8
41359,41359,41360,8,1,-7
41360,41360,41361,1,6,5
41361,41361,41362,6,7,1
41362,41362,41363,7,8,1
41363,41363,41364,8,9,1
41364,41364,41365,9,7,-2
41365,41365,41366,7,2,-5
41366,41366,41367,2,7,5
41367,41367,41368,7,0,-7
41368,41368,41369,0,9,9
41369,41369,41370,9,5,-4
41370,41370,41371,5,0,-5
41371,41371,41372,0,1,1
41372,41372,41373,1,4,3
41373,41373,41374,4,0,-4
41374,41374,41375,0,9,9
41375,41375,41376,9,0,-9
41376,41376,41377,0,9,9
41377,41377,41378,9,3,-6
41378,41378,41379,3,7,4
41379,41379,41380,7,6,-1
41380,41380,41381,6,4,-2
41381,41381,41382,4,2,-2
41382,41382,41383,2,0,-2
41383,41383,41384,0,0,0
41384,41384,41385,0,3,3
41385,41385,41386,3,1,-2
41386,41386,41387,1,5,4
41387,41387,41388,5,0,-5
41388,41388,41389,0,5,5
41389,41389,41390,5,5,0
41390,41390,41391,5,3,-2
41391,41391,41392,3,1,-2
41392,41392,41393,1,8,7
41393,41393,41394,8,8,0
41394,41394,41395,8,9,1
41395,41395,41396,9,8,-1
41396,41396,41397,8,2,-6
41397,41397,41398,2,2,0
41398,41398,41399,2,2,0
41399,41399,41400,2,6,4
41400,41400,41401,6,0,-6
41401,41401,41402,0,5,5
41402,41402,41403,5,9,4
41403,41403,41404,9,3,-6
41404,41404,41405,3,7,4
41405,41405,41406,7,0,-7
41406,41406,41407,0,3,3
41407,41407,41408,3,6,3
41408,41408,41409,6,1,-5
41409,41409,41410,1,6,5
41410,41410,41411,6,3,-3
41411,41411,41412,3,0,-3
41412,41412,41413,0,6,6
41413,41413,41414,6,7,1
41414,41414,41415,7,6,-1
41415,41415,41416,6,8,2
41416,41416,41417,8,2,-6
41417,41417,41418,2,1,-1
41418,41418,41419,1,1,0
41419,41419,41420,1,2,1
41420,41420,41421,2,2,0
41421,41421,41422,2,9,7
41422,41422,41423,9,6,-3
41423,41423,41424,6,1,-5
41424,41424,41425,1,0,-1
41425,41425,41426,0,4,4
41426,41426,41427,4,2,-2
41427,41427,41428,2,3,1
41428,41428,41429,3,2,-1
41429,41429,41430,2,6,4
41430,41430,41431,6,8,2
41431,41431,41432,8,0,-8
41432,41432,41433,0,9,9
41433,41433,41434,9,9,0
41434,41434,41435,9,5,-4
41435,41435,41436,5,3,-2
41436,41436,41437,3,1,-2
41437,41437,41438,1,2,1
41438,41438,41439,2,6,4
41439,41439,41440,6,4,-2
41440,41440,41441,4,8,4
41441,41441,41442,8,6,-2
41442,41442,41443,6,0,-6
41443,41443,41444,0,4,4
41444,41444,41445,4,0,-4
41445,41445,41446,0,1,1
41446,41446,41447,1,0,-1
41447,41447,41448,0,7,7
41448,41448,41449,7,1,-6
41449,41449,41450,1,7,6
41450,41450,41451,7,2,-5
41451,41451,41452,2,6,4
41452,41452,41453,6,3,-3
41453,41453,41454,3,1,-2
41454,41454,41455,1,4,3
41455,41455,41456,4,4,0
41456,41456,41457,4,5,1
41457,41457,41458,5,2,-3
41458,41458,41459,2,6,4
41459,41459,41460,6,2,-4
41460,41460,41461,2,7,5
41461,41461,41462,7,5,-2
41462,41462,41463,5,8,3
41463,41463,41464,8,8,0
41464,41464,41465,8,0,-8
41465,41465,41466,0,2,2
41466,41466,41467,2,1,-1
41467,41467,41468,1,8,7
41468,41468,41469,8,2,-6
41469,41469,41470,2,7,5
41470,41470,41471,7,3,-4
41471,41471,41472,3,7,4
41472,41472,41473,7,4,-3
41473,41473,41474,4,1,-3
41474,41474,41475,1,5,4
41475,41475,41476,5,3,-2
41476,41476,41477,3,6,3
41477,41477,41478,6,2,-4
41478,41478,41479,2,7,5
41479,41479,41480,7,9,2
41480,41480,41481,9,8,-1
41481,41481,41482,8,4,-4
41482,41482,41483,4,9,5
41483,41483,41484,9,2,-7
41484,41484,41485,2,0,-2
41485,41485,41486,0,5,5
41486,41486,41487,5,1,-4
41487,41487,41488,1,6,5
41488,41488,41489,6,2,-4
41489,41489,41490,2,0,-2
41490,41490,41491,0,3,3
41491,41491,41492,3,1,-2
41492,41492,41493,1,7,6
41493,41493,41494,7,3,-4
41494,41494,41495,3,8,5
41495,41495,41496,8,7,-1
41496,41496,41497,7,9,2
41497,41497,41498,9,5,-4
41498,41498,41499,5,4,-1
41499,41499,41500,4,6,2
41500,41500,41501,6,9,3
41501,41501,41502,9,9,0
41502,41502,41503,9,9,0
41503,41503,41504,9,8,-1
41504,41504,41505,8,8,0
41505,41505,41506,8,0,-8
41506,41506,41507,0,3,3
41507,41507,41508,3,6,3
41508,41508,41509,6,5,-1
41509,41509,41510,5,9,4
41510,41510,41511,9,4,-5
41511,41511,41512,4,2,-2
41512,41512,41513,2,3,1
41513,41513,41514,3,1,-2
41514,41514,41515,1,3,2
41515,41515,41516,3,2,-1
41516,41516,41517,2,6,4
41517,41517,41518,6,1,-5
41518,41518,41519,1,6,5
41519,41519,41520,6,7,1
41520,41520,41521,7,5,-2
41521,41521,41522,5,5,0
41522,41522,41523,5,5,0
41523,41523,41524,5,1,-4
41524,41524,41525,1,1,0
41525,41525,41526,1,1,0
41526,41526,41527,1,7,6
41527,41527,41528,7,4,-3
41528,41528,41529,4,8,4
41529,41529,41530,8,7,-1
41530,41530,41531,7,4,-3
41531,41531,41532,4,7,3
41532,41532,41533,7,5,-2
41533,41533,41534,5,0,-5
41534,41534,41535,0,7,7
41535,41535,41536,7,1,-6
41536,41536,41537,1,3,2
41537,41537,41538,3,6,3
41538,41538,41539,6,5,-1
41539,41539,41540,5,2,-3
41540,41540,41541,2,2,0
41541,41541,41542,2,1,-1
41542,41542,41543,1,3,2
41543,41543,41544,3,8,5
41544,41544,41545,8,6,-2
41545,41545,41546,6,6,0
41546,41546,41547,6,6,0
41547,41547,41548,6,5,-1
41548,41548,41549,5,7,2
41549,41549,41550,7,8,1
41550,41550,41551,8,7,-1
41551,41551,41552,7,3,-4
41552,41552,41553,3,0,-3
41553,41553,41554,0,1,1
41554,41554,41555,1,1,0
41555,41555,41556,1,0,-1
41556,41556,41557,0,0,0
41557,41557,41558,0,7,7
41558,41558,41559,7,1,-6
41559,41559,41560,1,8,7
41560,41560,41561,8,6,-2
41561,41561,41562,6,9,3
41562,41562,41563,9,9,0
41563,41563,41564,9,8,-1
41564,41564,41565,8,3,-5
41565,41565,41566,3,5,2
41566,41566,41567,5,1,-4
41567,41567,41568,1,4,3
41568,41568,41569,4,4,0
41569,41569,41570,4,0,-4
41570,41570,41571,0,7,7
41571,41571,41572,7,6,-1
41572,41572,41573,6,3,-3
41573,41573,41574,3,4,1
41574,41574,41575,4,8,4
41575,41575,41576,8,4,-4
41576,41576,41577,4,6,2
41577,41577,41578,6,8,2
41578,41578,41579,8,2,-6
41579,41579,41580,2,4,2
41580,41580,41581,4,2,-2
41581,41581,41582,2,5,3
41582,41582,41583,5,9,4
41583,41583,41584,9,7,-2
41584,41584,41585,7,1,-6
41585,41585,41586,1,6,5
41586,41586,41587,6,5,-1
41587,41587,41588,5,0,-5
41588,41588,41589,0,9,9
41589,41589,41590,9,3,-6
41590,41590,41591,3,1,-2
41591,41591,41592,1,8,7
41592,41592,41593,8,2,-6
41593,41593,41594,2,9,7
41594,41594,41595,9,2,-7
41595,41595,41596,2,1,-1
41596,41596,41597,1,7,6
41597,41597,41598,7,8,1
41598,41598,41599,8,9,1
41599,41599,41600,9,1,-8
41600,41600,41601,1,7,6
41601,41601,41602,7,5,-2
41602,41602,41603,5,9,4
41603,41603,41604,9,7,-2
41604,41604,41605,7,9,2
41605,41605,41606,9,0,-9
41606,41606,41607,0,1,1
41607,41607,41608,1,3,2
41608,41608,41609,3,0,-3
41609,41609,41610,0,5,5
41610,41610,41611,5,8,3
41611,41611,41612,8,0,-8
41612,41612,41613,0,9,9
41613,41613,41614,9,0,-9
41614,41614,41615,0,7,7
41615,41615,41616,7,0,-7
41616,41616,41617,0,0,0
41617,41617,41618,0,5,5
41618,41618,41619,5,3,-2
41619,41619,41620,3,0,-3
41620,41620,41621,0,8,8
41621,41621,41622,8,8,0
41622,41622,41623,8,1,-7
41623,41623,41624,1,3,2
41624,41624,41625,3,4,1
41625,41625,41626,4,4,0
41626,41626,41627,4,0,-4
41627,41627,41628,0,5,5
41628,41628,41629,5,3,-2
41629,41629,41630,3,7,4
41630,41630,41631,7,6,-1
41631,41631,41632,6,3,-3
41632,41632,41633,3,2,-1
41633,41633,41634,2,0,-2
41634,41634,41635,0,0,0
41635,41635,41636,0,6,6
41636,41636,41637,6,1,-5
41637,41637,41638,1,1,0
41638,41638,41639,1,3,2
41639,41639,41640,3,1,-2
41640,41640,41641,1,1,0
41641,41641,41642,1,6,5
41642,41642,41643,6,0,-6
41643,41643,41644,0,9,9
41644,41644,41645,9,9,0
41645,41645,41646,9,0,-9
41646,41646,41647,0,0,0
41647,41647,41648,0,4,4
41648,41648,41649,4,1,-3
41649,41649,41650,1,7,6
41650,41650,41651,7,2,-5
41651,41651,41652,2,8,6
41652,41652,41653,8,3,-5
41653,41653,41654,3,6,3
41654,41654,41655,6,4,-2
41655,41655,41656,4,7,3
41656,41656,41657,7,5,-2
41657,41657,41658,5,1,-4
41658,41658,41659,1,6,5
41659,41659,41660,6,7,1
41660,41660,41661,7,7,0
41661,41661,41662,7,2,-5
41662,41662,41663,2,8,6
41663,41663,41664,8,4,-4
41664,41664,41665,4,9,5
41665,41665,41666,9,6,-3
41666,41666,41667,6,0,-6
41667,41667,41668,0,2,2
41668,41668,41669,2,1,-1
41669,41669,41670,1,5,4
41670,41670,41671,5,4,-1
41671,41671,41672,4,2,-2
41672,41672,41673,2,5,3
41673,41673,41674,5,5,0
41674,41674,41675,5,6,1
41675,41675,41676,6,6,0
41676,41676,41677,6,7,1
41677,41677,41678,7,4,-3
41678,41678,41679,4,8,4
41679,41679,41680,8,4,-4
41680,41680,41681,4,9,5
41681,41681,41682,9,5,-4
41682,41682,41683,5,0,-5
41683,41683,41684,0,9,9
41684,41684,41685,9,1,-8
41685,41685,41686,1,4,3
41686,41686,41687,4,2,-2
41687,41687,41688,2,6,4
41688,41688,41689,6,3,-3
41689,41689,41690,3,6,3
41690,41690,41691,6,4,-2
41691,41691,41692,4,7,3
41692,41692,41693,7,5,-2
41693,41693,41694,5,1,-4
41694,41694,41695,1,6,5
41695,41695,41696,6,0,-6
41696,41696,41697,0,7,7
41697,41697,41698,7,7,0
41698,41698,41699,7,8,1
41699,41699,41700,8,7,-1
41700,41700,41701,7,9,2
41701,41701,41702,9,2,-7
41702,41702,41703,2,6,4
41703,41703,41704,6,3,-3
41704,41704,41705,3,8,5
41705,41705,41706,8,9,1
41706,41706,41707,9,7,-2
41707,41707,41708,7,2,-5
41708,41708,41709,2,8,6
41709,41709,41710,8,2,-6
41710,41710,41711,2,6,4
41711,41711,41712,6,8,2
41712,41712,41713,8,0,-8
41713,41713,41714,0,4,4
41714,41714,41715,4,1,-3
41715,41715,41716,1,4,3
41716,41716,41717,4,7,3
41717,41717,41718,7,8,1
41718,41718,41719,8,5,-3
41719,41719,41720,5,3,-2
41720,41720,41721,3,2,-1
41721,41721,41722,2,4,2
41722,41722,41723,4,1,-3
41723,41723,41724,1,4,3
41724,41724,41725,4,7,3
41725,41725,41726,7,6,-1
41726,41726,41727,6,3,-3
41727,41727,41728,3,1,-2
41728,41728,41729,1,0,-1
41729,41729,41730,0,2,2
41730,41730,41731,2,5,3
41731,41731,41732,5,1,-4
41732,41732,41733,1,1,0
41733,41733,41734,1,9,8
41734,41734,41735,9,6,-3
41735,41735,41736,6,6,0
41736,41736,41737,6,5,-1
41737,41737,41738,5,9,4
41738,41738,41739,9,1,-8
41739,41739,41740,1,3,2
41740,41740,41741,3,2,-1
41741,41741,41742,2,3,1
41742,41742,41743,3,0,-3
41743,41743,41744,0,1,1
41744,41744,41745,1,2,1
41745,41745,41746,2,6,4
41746,41746,41747,6,3,-3
41747,41747,41748,3,1,-2
41748,41748,41749,1,4,3
41749,41749,41750,4,1,-3
41750,41750,41751,1,8,7
41751,41751,41752,8,5,-3
41752,41752,41753,5,3,-2
41753,41753,41754,3,5,2
41754,41754,41755,5,3,-2
41755,41755,41756,3,0,-3
41756,41756,41757,0,6,6
41757,41757,41758,6,8,2
41758,41758,41759,8,5,-3
41759,41759,41760,5,7,2
41760,41760,41761,7,9,2
41761,41761,41762,9,7,-2
41762,41762,41763,7,9,2
41763,41763,41764,9,8,-1
41764,41764,41765,8,3,-5
41765,41765,41766,3,2,-1
41766,41766,41767,2,3,1
41767,41767,41768,3,9,6
41768,41768,41769,9,7,-2
41769,41769,41770,7,0,-7
41770,41770,41771,0,9,9
41771,41771,41772,9,5,-4
41772,41772,41773,5,3,-2
41773,41773,41774,3,4,1
41774,41774,41775,4,4,0
41775,41775,41776,4,3,-1
41776,41776,41777,3,1,-2
41777,41777,41778,1,6,5
41778,41778,41779,6,7,1
41779,41779,41780,7,4,-3
41780,41780,41781,4,3,-1
41781,41781,41782,3,6,3
41782,41782,41783,6,9,3
41783,41783,41784,9,1,-8
41784,41784,41785,1,6,5
41785,41785,41786,6,5,-1
41786,41786,41787,5,9,4
41787,41787,41788,9,7,-2
41788,41788,41789,7,0,-7
41789,41789,41790,0,6,6
41790,41790,41791,6,9,3
41791,41791,41792,9,9,0
41792,41792,41793,9,6,-3
41793,41793,41794,6,2,-4
41794,41794,41795,2,0,-2
41795,41795,41796,0,4,4
41796,41796,41797,4,6,2
41797,41797,41798,6,5,-1
41798,41798,41799,5,1,-4
41799,41799,41800,1,6,5
41800,41800,41801,6,8,2
41801,41801,41802,8,2,-6
41802,41802,41803,2,5,3
41803,41803,41804,5,4,-1
41804,41804,41805,4,1,-3
41805,41805,41806,1,0,-1
41806,41806,41807,0,0,0
41807,41807,41808,0,5,5
41808,41808,41809,5,1,-4
41809,41809,41810,1,0,-1
41810,41810,41811,0,0,0
41811,41811,41812,0,1,1
41812,41812,41813,1,9,8
41813,41813,41814,9,6,-3
41814,41814,41815,6,5,-1
41815,41815,41816,5,1,-4
41816,41816,41817,1,9,8
41817,41817,41818,9,4,-5
41818,41818,41819,4,0,-4
41819,41819,41820,0,3,3
41820,41820,41821,3,2,-1
41821,41821,41822,2,3,1
41822,41822,41823,3,1,-2
41823,41823,41824,1,1,0
41824,41824,41825,1,4,3
41825,41825,41826,4,1,-3
41826,41826,41827,1,9,8
41827,41827,41828,9,6,-3
41828,41828,41829,6,6,0
41829,41829,41830,6,2,-4
41830,41830,41831,2,8,6
41831,41831,41832,8,2,-6
41832,41832,41833,2,9,7
41833,41833,41834,9,3,-6
41834,41834,41835,3,2,-1
41835,41835,41836,2,1,-1
41836,41836,41837,1,0,-1
41837,41837,41838,0,4,4
41838,41838,41839,4,1,-3
41839,41839,41840,1,9,8
41840,41840,41841,9,2,-7
41841,41841,41842,2,6,4
41842,41842,41843,6,3,-3
41843,41843,41844,3,7,4
41844,41844,41845,7,4,-3
41845,41845,41846,4,4,0
41846,41846,41847,4,5,1
41847,41847,41848,5,6,1
41848,41848,41849,6,6,0
41849,41849,41850,6,3,-3
41850,41850,41851,3,7,4
41851,41851,41852,7,1,-6
41852,41852,41853,1,8,7
41853,41853,41854,8,7,-1
41854,41854,41855,7,9,2
41855,41855,41856,9,0,-9
41856,41856,41857,0,0,0
41857,41857,41858,0,1,1
41858,41858,41859,1,1,0
41859,41859,41860,1,2,1
41860,41860,41861,2,2,0
41861,41861,41862,2,1,-1
41862,41862,41863,1,3,2
41863,41863,41864,3,4,1
41864,41864,41865,4,4,0
41865,41865,41866,4,8,4
41866,41866,41867,8,5,-3
41867,41867,41868,5,5,0
41868,41868,41869,5,6,1
41869,41869,41870,6,4,-2
41870,41870,41871,4,7,3
41871,41871,41872,7,7,0
41872,41872,41873,7,8,1
41873,41873,41874,8,6,-2
41874,41874,41875,6,9,3
41875,41875,41876,9,6,-3
41876,41876,41877,6,0,-6
41877,41877,41878,0,2,2
41878,41878,41879,2,1,-1
41879,41879,41880,1,0,-1
41880,41880,41881,0,2,2
41881,41881,41882,2,8,6
41882,41882,41883,8,3,-5
41883,41883,41884,3,1,-2
41884,41884,41885,1,4,3
41885,41885,41886,4,4,0
41886,41886,41887,4,5,1
41887,41887,41888,5,1,-4
41888,41888,41889,1,6,5
41889,41889,41890,6,6,0
41890,41890,41891,6,7,1
41891,41891,41892,7,7,0
41892,41892,41893,7,8,1
41893,41893,41894,8,1,-7
41894,41894,41895,1,9,8
41895,41895,41896,9,0,-9
41896,41896,41897,0,1,1
41897,41897,41898,1,1,0
41898,41898,41899,1,6,5
41899,41899,41900,6,2,-4
41900,41900,41901,2,8,6
41901,41901,41902,8,3,-5
41902,41902,41903,3,9,6
41903,41903,41904,9,5,-4
41904,41904,41905,5,9,4
41905,41905,41906,9,4,-5
41906,41906,41907,4,0,-4
41907,41907,41908,0,1,1
41908,41908,41909,1,1,0
41909,41909,41910,1,7,6
41910,41910,41911,7,2,-5
41911,41911,41912,2,6,4
41912,41912,41913,6,4,-2
41913,41913,41914,4,1,-3
41914,41914,41915,1,4,3
41915,41915,41916,4,2,-2
41916,41916,41917,2,3,1
41917,41917,41918,3,9,6
41918,41918,41919,9,7,-2
41919,41919,41920,7,7,0
41920,41920,41921,7,4,-3
41921,41921,41922,4,0,-4
41922,41922,41923,0,4,4
41923,41923,41924,4,9,5
41924,41924,41925,9,4,-5
41925,41925,41926,4,5,1
41926,41926,41927,5,0,-5
41927,41927,41928,0,7,7
41928,41928,41929,7,3,-4
41929,41929,41930,3,4,1
41930,41930,41931,4,8,4
41931,41931,41932,8,9,1
41932,41932,41933,9,5,-4
41933,41933,41934,5,5,0
41934,41934,41935,5,8,3
41935,41935,41936,8,2,-6
41936,41936,41937,2,2,0
41937,41937,41938,2,5,3
41938,41938,41939,5,1,-4
41939,41939,41940,1,6,5
41940,41940,41941,6,7,1
41941,41941,41942,7,9,2
41942,41942,41943,9,3,-6
41943,41943,41944,3,1,-2
41944,41944,41945,1,5,4
41945,41945,41946,5,2,-3
41946,41946,41947,2,8,6
41947,41947,41948,8,9,1
41948,41948,41949,9,5,-4
41949,41949,41950,5,4,-1
41950,41950,41951,4,5,1
41951,41951,41952,5,8,3
41952,41952,41953,8,9,1
41953,41953,41954,9,1,-8
41954,41954,41955,1,2,1
41955,41955,41956,2,1,-1
41956,41956,41957,1,5,4
41957,41957,41958,5,7,2
41958,41958,41959,7,1,-6
41959,41959,41960,1,3,2
41960,41960,41961,3,1,-2
41961,41961,41962,1,9,8
41962,41962,41963,9,6,-3
41963,41963,41964,6,4,-2
41964,41964,41965,4,2,-2
41965,41965,41966,2,2,0
41966,41966,41967,2,1,-1
41967,41967,41968,1,3,2
41968,41968,41969,3,3,0
41969,41969,41970,3,5,2
41970,41970,41971,5,1,-4
41971,41971,41972,1,7,6
41972,41972,41973,7,8,1
41973,41973,41974,8,6,-2
41974,41974,41975,6,6,0
41975,41975,41976,6,6,0
41976,41976,41977,6,4,-2
41977,41977,41978,4,3,-1
41978,41978,41979,3,9,6
41979,41979,41980,9,5,-4
41980,41980,41981,5,4,-1
41981,41981,41982,4,9,5
41982,41982,41983,9,9,0
41983,41983,41984,9,2,-7
41984,41984,41985,2,2,0
41985,41985,41986,2,1,-1
41986,41986,41987,1,0,-1
41987,41987,41988,0,6,6
41988,41988,41989,6,0,-6
41989,41989,41990,0,4,4
41990,41990,41991,4,4,0
41991,41991,41992,4,8,4
41992,41992,41993,8,4,-4
41993,41993,41994,4,3,-1
41994,41994,41995,3,6,3
41995,41995,41996,6,8,2
41996,41996,41997,8,2,-6
41997,41997,41998,2,7,5
41998,41998,41999,7,0,-7
41999,41999,42000,0,1,1
42000,42000,42001,1,2,1
42001,42001,42002,2,1,-1
42002,42002,42003,1,8,7
42003,42003,42004,8,7,-1
42004,42004,42005,7,0,-7
42005,42005,42006,0,8,8
42006,42006,42007,8,6,-2
42007,42007,42008,6,0,-6
42008,42008,42009,0,8,8
42009,42009,42010,8,0,-8
42010,42010,42011,0,7,7
42011,42011,42012,7,2,-5
42012,42012,42013,2,9,7
42013,42013,42014,9,2,-7
42014,42014,42015,2,1,-1
42015,42015,42016,1,7,6
42016,42016,42017,7,9,2
42017,42017,42018,9,4,-5
42018,42018,42019,4,2,-2
42019,42019,42020,2,9,7
42020,42020,42021,9,6,-3
42021,42021,42022,6,6,0
42022,42022,42023,6,7,1
42023,42023,42024,7,3,-4
42024,42024,42025,3,6,3
42025,42025,42026,6,1,-5
42026,42026,42027,1,6,5
42027,42027,42028,6,1,-5
42028,42028,42029,1,8,7
42029,42029,42030,8,7,-1
42030,42030,42031,7,7,0
42031,42031,42032,7,4,-3
42032,42032,42033,4,4,0
42033,42033,42034,4,8,4
42034,42034,42035,8,9,1
42035,42035,42036,9,7,-2
42036,42036,42037,7,2,-5
42037,42037,42038,2,0,-2
42038,42038,42039,0,1,1
42039,42039,42040,1,1,0
42040,42040,42041,1,3,2
42041,42041,42042,3,4,1
42042,42042,42043,4,3,-1
42043,42043,42044,3,1,-2
42044,42044,42045,1,0,-1
42045,42045,42046,0,5,5
42046,42046,42047,5,5,0
42047,42047,42048,5,9,4
42048,42048,42049,9,5,-4
42049,42049,42050,5,2,-3
42050,42050,42051,2,8,6
42051,42051,42052,8,9,1
42052,42052,42053,9,0,-9
42053,42053,42054,0,3,3
42054,42054,42055,3,3,0
42055,42055,42056,3,3,0
42056,42056,42057,3,7,4
42057,42057,42058,7,1,-6
42058,42058,42059,1,9,8
42059,42059,42060,9,8,-1
42060,42060,42061,8,7,-1
42061,42061,42062,7,7,0
42062,42062,42063,7,0,-7
42063,42063,42064,0,7,7
42064,42064,42065,7,2,-5
42065,42065,42066,2,6,4
42066,42066,42067,6,7,1
42067,42067,42068,7,2,-5
42068,42068,42069,2,9,7
42069,42069,42070,9,3,-6
42070,42070,42071,3,1,-2
42071,42071,42072,1,6,5
42072,42072,42073,6,3,-3
42073,42073,42074,3,0,-3
42074,42074,42075,0,6,6
42075,42075,42076,6,8,2
42076,42076,42077,8,7,-1
42077,42077,42078,7,4,-3
42078,42078,42079,4,8,4
42079,42079,42080,8,6,-2
42080,42080,42081,6,0,-6
42081,42081,42082,0,3,3
42082,42082,42083,3,3,0
42083,42083,42084,3,0,-3
42084,42084,42085,0,5,5
42085,42085,42086,5,9,4
42086,42086,42087,9,3,-6
42087,42087,42088,3,3,0
42088,42088,42089,3,6,3
42089,42089,42090,6,9,3
42090,42090,42091,9,0,-9
42091,42091,42092,0,2,2
42092,42092,42093,2,1,-1
42093,42093,42094,1,7,6
42094,42094,42095,7,2,-5
42095,42095,42096,2,8,6
42096,42096,42097,8,3,-5
42097,42097,42098,3,1,-2
42098,42098,42099,1,4,3
42099,42099,42100,4,0,-4
42100,42100,42101,0,5,5
42101,42101,42102,5,1,-4
42102,42102,42103,1,6,5
42103,42103,42104,6,8,2
42104,42104,42105,8,7,-1
42105,42105,42106,7,9,2
42106,42106,42107,9,8,-1
42107,42107,42108,8,5,-3
42108,42108,42109,5,9,4
42109,42109,42110,9,5,-4
42110,42110,42111,5,0,-5
42111,42111,42112,0,8,8
42112,42112,42113,8,1,-7
42113,42113,42114,1,3,2
42114,42114,42115,3,2,-1
42115,42115,42116,2,4,2
42116,42116,42117,4,3,-1
42117,42117,42118,3,9,6
42118,42118,42119,9,4,-5
42119,42119,42120,4,3,-1
42120,42120,42121,3,5,2
42121,42121,42122,5,5,0
42122,42122,42123,5,6,1
42123,42123,42124,6,9,3
42124,42124,42125,9,7,-2
42125,42125,42126,7,2,-5
42126,42126,42127,2,8,6
42127,42127,42128,8,4,-4
42128,42128,42129,4,9,5
42129,42129,42130,9,8,-1
42130,42130,42131,8,0,-8
42131,42131,42132,0,1,1
42132,42132,42133,1,1,0
42133,42133,42134,1,7,6
42134,42134,42135,7,2,-5
42135,42135,42136,2,0,-2
42136,42136,42137,0,3,3
42137,42137,42138,3,2,-1
42138,42138,42139,2,4,2
42139,42139,42140,4,3,-1
42140,42140,42141,3,5,2
42141,42141,42142,5,2,-3
42142,42142,42143,2,6,4
42143,42143,42144,6,9,3
42144,42144,42145,9,7,-2
42145,42145,42146,7,7,0
42146,42146,42147,7,8,1
42147,42147,42148,8,7,-1
42148,42148,42149,7,9,2
42149,42149,42150,9,3,-6
42150,42150,42151,3,6,3
42151,42151,42152,6,9,3
42152,42152,42153,9,0,-9
42153,42153,42154,0,6,6
42154,42154,42155,6,8,2
42155,42155,42156,8,1,-7
42156,42156,42157,1,0,-1
42157,42157,42158,0,2,2
42158,42158,42159,2,2,0
42159,42159,42160,2,6,4
42160,42160,42161,6,3,-3
42161,42161,42162,3,6,3
42162,42162,42163,6,7,1
42163,42163,42164,7,7,0
42164,42164,42165,7,9,2
42165,42165,42166,9,6,-3
42166,42166,42167,6,4,-2
42167,42167,42168,4,2,-2
42168,42168,42169,2,7,5
42169,42169,42170,7,0,-7
42170,42170,42171,0,1,1
42171,42171,42172,1,6,5
42172,42172,42173,6,9,3
42173,42173,42174,9,6,-3
42174,42174,42175,6,1,-5
42175,42175,42176,1,1,0
42176,42176,42177,1,7,6
42177,42177,42178,7,3,-4
42178,42178,42179,3,1,-2
42179,42179,42180,1,0,-1
42180,42180,42181,0,4,4
42181,42181,42182,4,1,-3
42182,42182,42183,1,0,-1
42183,42183,42184,0,1,1
42184,42184,42185,1,0,-1
42185,42185,42186,0,3,3
42186,42186,42187,3,4,1
42187,42187,42188,4,2,-2
42188,42188,42189,2,1,-1
42189,42189,42190,1,6,5
42190,42190,42191,6,7,1
42191,42191,42192,7,9,2
42192,42192,42193,9,5,-4
42193,42193,42194,5,1,-4
42194,42194,42195,1,7,6
42195,42195,42196,7,8,1
42196,42196,42197,8,1,-7
42197,42197,42198,1,4,3
42198,42198,42199,4,3,-1
42199,42199,42200,3,7,4
42200,42200,42201,7,3,-4
42201,42201,42202,3,7,4
42202,42202,42203,7,3,-4
42203,42203,42204,3,7,4
42204,42204,42205,7,1,-6
42205,42205,42206,1,2,1
42206,42206,42207,2,6,4
42207,42207,42208,6,8,2
42208,42208,42209,8,9,1
42209,42209,42210,9,3,-6
42210,42210,42211,3,7,4
42211,42211,42212,7,3,-4
42212,42212,42213,3,4,1
42213,42213,42214,4,9,5
42214,42214,42215,9,3,-6
42215,42215,42216,3,4,1
42216,42216,42217,4,0,-4
42217,42217,42218,0,8,8
42218,42218,42219,8,2,-6
42219,42219,42220,2,3,1
42220,42220,42221,3,5,2
42221,42221,42222,5,9,4
42222,42222,42223,9,2,-7
42223,42223,42224,2,0,-2
42224,42224,42225,0,6,6
42225,42225,42226,6,8,2
42226,42226,42227,8,0,-8
42227,42227,42228,0,9,9
42228,42228,42229,9,8,-1
42229,42229,42230,8,0,-8
42230,42230,42231,0,9,9
42231,42231,42232,9,5,-4
42232,42232,42233,5,4,-1
42233,42233,42234,4,6,2
42234,42234,42235,6,3,-3
42235,42235,42236,3,4,1
42236,42236,42237,4,5,1
42237,42237,42238,5,8,3
42238,42238,42239,8,4,-4
42239,42239,42240,4,2,-2
42240,42240,42241,2,8,6
42241,42241,42242,8,1,-7
42242,42242,42243,1,1,0
42243,42243,42244,1,5,4
42244,42244,42245,5,0,-5
42245,42245,42246,0,9,9
42246,42246,42247,9,6,-3
42247,42247,42248,6,3,-3
42248,42248,42249,3,4,1
42249,42249,42250,4,0,-4
42250,42250,42251,0,3,3
42251,42251,42252,3,5,2
42252,42252,42253,5,6,1
42253,42253,42254,6,3,-3
42254,42254,42255,3,3,0
42255,42255,42256,3,6,3
42256,42256,42257,6,3,-3
42257,42257,42258,3,9,6
42258,42258,42259,9,8,-1
42259,42259,42260,8,1,-7
42260,42260,42261,1,1,0
42261,42261,42262,1,0,-1
42262,42262,42263,0,4,4
42263,42263,42264,4,3,-1
42264,42264,42265,3,7,4
42265,42265,42266,7,8,1
42266,42266,42267,8,5,-3
42267,42267,42268,5,1,-4
42268,42268,42269,1,7,6
42269,42269,42270,7,0,-7
42270,42270,42271,0,2,2
42271,42271,42272,2,4,2
42272,42272,42273,4,2,-2
42273,42273,42274,2,5,3
42274,42274,42275,5,0,-5
42275,42275,42276,0,1,1
42276,42276,42277,1,0,-1
42277,42277,42278,0,2,2
42278,42278,42279,2,1,-1
42279,42279,42280,1,2,1
42280,42280,42281,2,7,5
42281,42281,42282,7,7,0
42282,42282,42283,7,7,0
42283,42283,42284,7,3,-4
42284,42284,42285,3,9,6
42285,42285,42286,9,4,-5
42286,42286,42287,4,5,1
42287,42287,42288,5,1,-4
42288,42288,42289,1,9,8
42289,42289,42290,9,7,-2
42290,42290,42291,7,8,1
42291,42291,42292,8,7,-1
42292,42292,42293,7,9,2
42293,42293,42294,9,0,-9
42294,42294,42295,0,6,6
42295,42295,42296,6,7,1
42296,42296,42297,7,8,1
42297,42297,42298,8,9,1
42298,42298,42299,9,8,-1
42299,42299,42300,8,4,-4
42300,42300,42301,4,2,-2
42301,42301,42302,2,4,2
42302,42302,42303,4,3,-1
42303,42303,42304,3,4,1
42304,42304,42305,4,6,2
42305,42305,42306,6,9,3
42306,42306,42307,9,1,-8
42307,42307,42308,1,2,1
42308,42308,42309,2,2,0
42309,42309,42310,2,2,0
42310,42310,42311,2,9,7
42311,42311,42312,9,5,-4
42312,42312,42313,5,8,3
42313,42313,42314,8,8,0
42314,42314,42315,8,9,1
42315,42315,42316,9,1,-8
42316,42316,42317,1,5,4
42317,42317,42318,5,9,4
42318,42318,42319,9,2,-7
42319,42319,42320,2,7,5
42320,42320,42321,7,5,-2
42321,42321,42322,5,5,0
42322,42322,42323,5,2,-3
42323,42323,42324,2,0,-2
42324,42324,42325,0,6,6
42325,42325,42326,6,1,-5
42326,42326,42327,1,2,1
42327,42327,42328,2,2,0
42328,42328,42329,2,4,2
42329,42329,42330,4,4,0
42330,42330,42331,4,8,4
42331,42331,42332,8,1,-7
42332,42332,42333,1,4,3
42333,42333,42334,4,5,1
42334,42334,42335,5,6,1
42335,42335,42336,6,2,-4
42336,42336,42337,2,5,3
42337,42337,42338,5,5,0
42338,42338,42339,5,1,-4
42339,42339,42340,1,6,5
42340,42340,42341,6,2,-4
42341,42341,42342,2,0,-2
42342,42342,42343,0,3,3
42343,42343,42344,3,9,6
42344,42344,42345,9,4,-5
42345,42345,42346,4,4,0
42346,42346,42347,4,8,4
42347,42347,42348,8,1,-7
42348,42348,42349,1,0,-1
42349,42349,42350,0,6,6
42350,42350,42351,6,1,-5
42351,42351,42352,1,7,6
42352,42352,42353,7,2,-5
42353,42353,42354,2,7,5
42354,42354,42355,7,3,-4
42355,42355,42356,3,9,6
42356,42356,42357,9,4,-5
42357,42357,42358,4,0,-4
42358,42358,42359,0,5,5
42359,42359,42360,5,9,4
42360,42360,42361,9,6,-3
42361,42361,42362,6,0,-6
42362,42362,42363,0,7,7
42363,42363,42364,7,8,1
42364,42364,42365,8,8,0
42365,42365,42366,8,2,-6
42366,42366,42367,2,9,7
42367,42367,42368,9,7,-2
42368,42368,42369,7,0,-7
42369,42369,42370,0,6,6
42370,42370,42371,6,1,-5
42371,42371,42372,1,5,4
42372,42372,42373,5,2,-3
42373,42373,42374,2,0,-2
42374,42374,42375,0,3,3
42375,42375,42376,3,9,6
42376,42376,42377,9,4,-5
42377,42377,42378,4,7,3
42378,42378,42379,7,5,-2
42379,42379,42380,5,1,-4
42380,42380,42381,1,6,5
42381,42381,42382,6,4,-2
42382,42382,42383,4,8,4
42383,42383,42384,8,8,0
42384,42384,42385,8,9,1
42385,42385,42386,9,6,-3
42386,42386,42387,6,5,-1
42387,42387,42388,5,8,3
42388,42388,42389,8,0,-8
42389,42389,42390,0,5,5
42390,42390,42391,5,3,-2
42391,42391,42392,3,5,2
42392,42392,42393,5,1,-4
42393,42393,42394,1,2,1
42394,42394,42395,2,6,4
42395,42395,42396,6,6,0
42396,42396,42397,6,8,2
42397,42397,42398,8,3,-5
42398,42398,42399,3,4,1
42399,42399,42400,4,9,5
42400,42400,42401,9,1,-8
42401,42401,42402,1,0,-1
42402,42402,42403,0,7,7
42403,42403,42404,7,1,-6
42404,42404,42405,1,6,5
42405,42405,42406,6,1,-5
42406,42406,42407,1,5,4
42407,42407,42408,5,8,3
42408,42408,42409,8,6,-2
42409,42409,42410,6,7,1
42410,42410,42411,7,4,-3
42411,42411,42412,4,1,-3
42412,42412,42413,1,2,1
42413,42413,42414,2,5,3
42414,42414,42415,5,7,2
42415,42415,42416,7,7,0
42416,42416,42417,7,8,1
42417,42417,42418,8,7,-1
42418,42418,42419,7,3,-4
42419,42419,42420,3,6,3
42420,42420,42421,6,4,-2
42421,42421,42422,4,1,-3
42422,42422,42423,1,3,2
42423,42423,42424,3,1,-2
42424,42424,42425,1,4,3
42425,42425,42426,4,9,5
42426,42426,42427,9,7,-2
42427,42427,42428,7,5,-2
42428,42428,42429,5,2,-3
42429,42429,42430,2,7,5
42430,42430,42431,7,5,-2
42431,42431,42432,5,3,-2
42432,42432,42433,3,0,-3
42433,42433,42434,0,3,3
42434,42434,42435,3,1,-2
42435,42435,42436,1,5,4
42436,42436,42437,5,9,4
42437,42437,42438,9,9,0
42438,42438,42439,9,2,-7
42439,42439,42440,2,1,-1
42440,42440,42441,1,3,2
42441,42441,42442,3,8,5
42442,42442,42443,8,2,-6
42443,42443,42444,2,0,-2
42444,42444,42445,0,3,3
42445,42445,42446,3,0,-3
42446,42446,42447,0,5,5
42447,42447,42448,5,0,-5
42448,42448,42449,0,5,5
42449,42449,42450,5,6,1
42450,42450,42451,6,7,1
42451,42451,42452,7,6,-1
42452,42452,42453,6,8,2
42453,42453,42454,8,2,-6
42454,42454,42455,2,4,2
42455,42455,42456,4,0,-4
42456,42456,42457,0,9,9
42457,42457,42458,9,9,0
42458,42458,42459,9,9,0
42459,42459,42460,9,1,-8
42460,42460,42461,1,7,6
42461,42461,42462,7,1,-6
42462,42462,42463,1,1,0
42463,42463,42464,1,4,3
42464,42464,42465,4,9,5
42465,42465,42466,9,7,-2
42466,42466,42467,7,8,1
42467,42467,42468,8,7,-1
42468,42468,42469,7,3,-4
42469,42469,42470,3,8,5
42470,42470,42471,8,4,-4
42471,42471,42472,4,2,-2
42472,42472,42473,2,8,6
42473,42473,42474,8,2,-6
42474,42474,42475,2,6,4
42475,42475,42476,6,3,-3
42476,42476,42477,3,3,0
42477,42477,42478,3,8,5
42478,42478,42479,8,8,0
42479,42479,42480,8,5,-3
42480,42480,42481,5,6,1
42481,42481,42482,6,9,3
42482,42482,42483,9,0,-9
42483,42483,42484,0,4,4
42484,42484,42485,4,1,-3
42485,42485,42486,1,1,0
42486,42486,42487,1,0,-1
42487,42487,42488,0,0,0
42488,42488,42489,0,6,6
42489,42489,42490,6,6,0
42490,42490,42491,6,2,-4
42491,42491,42492,2,9,7
42492,42492,42493,9,3,-6
42493,42493,42494,3,1,-2
42494,42494,42495,1,8,7
42495,42495,42496,8,2,-6
42496,42496,42497,2,9,7
42497,42497,42498,9,6,-3
42498,42498,42499,6,0,-6
42499,42499,42500,0,9,9
42500,42500,42501,9,7,-2
42501,42501,42502,7,1,-6
42502,42502,42503,1,2,1
42503,42503,42504,2,8,6
42504,42504,42505,8,3,-5
42505,42505,42506,3,1,-2
42506,42506,42507,1,4,3
42507,42507,42508,4,3,-1
42508,42508,42509,3,5,2
42509,42509,42510,5,1,-4
42510,42510,42511,1,5,4
42511,42511,42512,5,9,4
42512,42512,42513,9,2,-7
42513,42513,42514,2,7,5
42514,42514,42515,7,8,1
42515,42515,42516,8,9,1
42516,42516,42517,9,5,-4
42517,42517,42518,5,1,-4
42518,42518,42519,1,4,3
42519,42519,42520,4,5,1
42520,42520,42521,5,6,1
42521,42521,42522,6,2,-4
42522,42522,42523,2,6,4
42523,42523,42524,6,9,3
42524,42524,42525,9,6,-3
42525,42525,42526,6,3,-3
42526,42526,42527,3,7,4
42527,42527,42528,7,7,0
42528,42528,42529,7,9,2
42529,42529,42530,9,6,-3
42530,42530,42531,6,1,-5
42531,42531,42532,1,2,1
42532,42532,42533,2,8,6
42533,42533,42534,8,3,-5
42534,42534,42535,3,2,-1
42535,42535,42536,2,4,2
42536,42536,42537,4,1,-3
42537,42537,42538,1,2,1
42538,42538,42539,2,2,0
42539,42539,42540,2,8,6
42540,42540,42541,8,6,-2
42541,42541,42542,6,9,3
42542,42542,42543,9,5,-4
42543,42543,42544,5,7,2
42544,42544,42545,7,3,-4
42545,42545,42546,3,1,-2
42546,42546,42547,1,4,3
42547,42547,42548,4,7,3
42548,42548,42549,7,7,0
42549,42549,42550,7,9,2
42550,42550,42551,9,9,0
42551,42551,42552,9,0,-9
42552,42552,42553,0,4,4
42553,42553,42554,4,5,1
42554,42554,42555,5,5,0
42555,42555,42556,5,5,0
42556,42556,42557,5,9,4
42557,42557,42558,9,6,-3
42558,42558,42559,6,0,-6
42559,42559,42560,0,5,5
42560,42560,42561,5,1,-4
42561,42561,42562,1,2,1
42562,42562,42563,2,2,0
42563,42563,42564,2,9,7
42564,42564,42565,9,3,-6
42565,42565,42566,3,9,6
42566,42566,42567,9,4,-5
42567,42567,42568,4,2,-2
42568,42568,42569,2,5,3
42569,42569,42570,5,6,1
42570,42570,42571,6,6,0
42571,42571,42572,6,5,-1
42572,42572,42573,5,7,2
42573,42573,42574,7,4,-3
42574,42574,42575,4,8,4
42575,42575,42576,8,8,0
42576,42576,42577,8,9,1
42577,42577,42578,9,1,-8
42578,42578,42579,1,0,-1
42579,42579,42580,0,8,8
42580,42580,42581,8,1,-7
42581,42581,42582,1,7,6
42582,42582,42583,7,2,-5
42583,42583,42584,2,1,-1
42584,42584,42585,1,3,2
42585,42585,42586,3,1,-2
42586,42586,42587,1,4,3
42587,42587,42588,4,3,-1
42588,42588,42589,3,5,2
42589,42589,42590,5,5,0
42590,42590,42591,5,6,1
42591,42591,42592,6,7,1
42592,42592,42593,7,7,0
42593,42593,42594,7,7,0
42594,42594,42595,7,8,1
42595,42595,42596,8,2,-6
42596,42596,42597,2,9,7
42597,42597,42598,9,2,-7
42598,42598,42599,2,0,-2
42599,42599,42600,0,6,6
42600,42600,42601,6,1,-5
42601,42601,42602,1,1,0
42602,42602,42603,1,2,1
42603,42603,42604,2,5,3
42604,42604,42605,5,3,-2
42605,42605,42606,3,7,4
42606,42606,42607,7,4,-3
42607,42607,42608,4,0,-4
42608,42608,42609,0,5,5
42609,42609,42610,5,0,-5
42610,42610,42611,0,6,6
42611,42611,42612,6,0,-6
42612,42612,42613,0,7,7
42613,42613,42614,7,0,-7
42614,42614,42615,0,8,8
42615,42615,42616,8,4,-4
42616,42616,42617,4,8,4
42617,42617,42618,8,1,-7
42618,42618,42619,1,7,6
42619,42619,42620,7,4,-3
42620,42620,42621,4,7,3
42621,42621,42622,7,2,-5
42622,42622,42623,2,0,-2
42623,42623,42624,0,8,8
42624,42624,42625,8,1,-7
42625,42625,42626,1,5,4
42626,42626,42627,5,3,-2
42627,42627,42628,3,9,6
42628,42628,42629,9,7,-2
42629,42629,42630,7,1,-6
42630,42630,42631,1,5,4
42631,42631,42632,5,0,-5
42632,42632,42633,0,2,2
42633,42633,42634,2,0,-2
42634,42634,42635,0,8,8
42635,42635,42636,8,3,-5
42636,42636,42637,3,0,-3
42637,42637,42638,0,4,4
42638,42638,42639,4,7,3
42639,42639,42640,7,9,2
42640,42640,42641,9,5,-4
42641,42641,42642,5,9,4
42642,42642,42643,9,9,0
42643,42643,42644,9,1,-8
42644,42644,42645,1,9,8
42645,42645,42646,9,7,-2
42646,42646,42647,7,6,-1
42647,42647,42648,6,7,1
42648,42648,42649,7,0,-7
42649,42649,42650,0,7,7
42650,42650,42651,7,9,2
42651,42651,42652,9,5,-4
42652,42652,42653,5,4,-1
42653,42653,42654,4,2,-2
42654,42654,42655,2,1,-1
42655,42655,42656,1,8,7
42656,42656,42657,8,1,-7
42657,42657,42658,1,0,-1
42658,42658,42659,0,5,5
42659,42659,42660,5,5,0
42660,42660,42661,5,8,3
42661,42661,42662,8,8,0
42662,42662,42663,8,5,-3
42663,42663,42664,5,0,-5
42664,42664,42665,0,8,8
42665,42665,42666,8,1,-7
42666,42666,42667,1,6,5
42667,42667,42668,6,9,3
42668,42668,42669,9,3,-6
42669,42669,42670,3,7,4
42670,42670,42671,7,2,-5
42671,42671,42672,2,7,5
42672,42672,42673,7,1,-6
42673,42673,42674,1,0,-1
42674,42674,42675,0,2,2
42675,42675,42676,2,4,2
42676,42676,42677,4,3,-1
42677,42677,42678,3,3,0
42678,42678,42679,3,8,5
42679,42679,42680,8,5,-3
42680,42680,42681,5,3,-2
42681,42681,42682,3,8,5
42682,42682,42683,8,2,-6
42683,42683,42684,2,4,2
42684,42684,42685,4,6,2
42685,42685,42686,6,2,-4
42686,42686,42687,2,5,3
42687,42687,42688,5,8,3
42688,42688,42689,8,6,-2
42689,42689,42690,6,1,-5
42690,42690,42691,1,8,7
42691,42691,42692,8,2,-6
42692,42692,42693,2,2,0
42693,42693,42694,2,6,4
42694,42694,42695,6,7,1
42695,42695,42696,7,9,2
42696,42696,42697,9,4,-5
42697,42697,42698,4,5,1
42698,42698,42699,5,8,3
42699,42699,42700,8,6,-2
42700,42700,42701,6,1,-5
42701,42701,42702,1,1,0
42702,42702,42703,1,0,-1
42703,42703,42704,0,8,8
42704,42704,42705,8,5,-3
42705,42705,42706,5,8,3
42706,42706,42707,8,3,-5
42707,42707,42708,3,2,-1
42708,42708,42709,2,9,7
42709,42709,42710,9,4,-5
42710,42710,42711,4,4,0
42711,42711,42712,4,8,4
42712,42712,42713,8,1,-7
42713,42713,42714,1,6,5
42714,42714,42715,6,9,3
42715,42715,42716,9,1,-8
42716,42716,42717,1,2,1
42717,42717,42718,2,9,7
42718,42718,42719,9,1,-8
42719,42719,42720,1,0,-1
42720,42720,42721,0,9,9
42721,42721,42722,9,7,-2
42722,42722,42723,7,6,-1
42723,42723,42724,6,8,2
42724,42724,42725,8,7,-1
42725,42725,42726,7,2,-5
42726,42726,42727,2,9,7
42727,42727,42728,9,9,0
42728,42728,42729,9,6,-3
42729,42729,42730,6,6,0
42730,42730,42731,6,1,-5
42731,42731,42732,1,0,-1
42732,42732,42733,0,7,7
42733,42733,42734,7,2,-5
42734,42734,42735,2,3,1
42735,42735,42736,3,8,5
42736,42736,42737,8,8,0
42737,42737,42738,8,9,1
42738,42738,42739,9,7,-2
42739,42739,42740,7,1,-6
42740,42740,42741,1,2,1
42741,42741,42742,2,4,2
42742,42742,42743,4,9,5
42743,42743,42744,9,0,-9
42744,42744,42745,0,6,6
42745,42745,42746,6,2,-4
42746,42746,42747,2,5,3
42747,42747,42748,5,7,2
42748,42748,42749,7,8,1
42749,42749,42750,8,4,-4
42750,42750,42751,4,7,3
42751,42751,42752,7,0,-7
42752,42752,42753,0,5,5
42753,42753,42754,5,2,-3
42754,42754,42755,2,3,1
42755,42755,42756,3,5,2
42756,42756,42757,5,9,4
42757,42757,42758,9,3,-6
42758,42758,42759,3,0,-3
42759,42759,42760,0,5,5
42760,42760,42761,5,5,0
42761,42761,42762,5,5,0
42762,42762,42763,5,7,2
42763,42763,42764,7,0,-7
42764,42764,42765,0,1,1
42765,42765,42766,1,4,3
42766,42766,42767,4,6,2
42767,42767,42768,6,1,-5
42768,42768,42769,1,1,0
42769,42769,42770,1,4,3
42770,42770,42771,4,0,-4
42771,42771,42772,0,7,7
42772,42772,42773,7,9,2
42773,42773,42774,9,4,-5
42774,42774,42775,4,3,-1
42775,42775,42776,3,0,-3
42776,42776,42777,0,3,3
42777,42777,42778,3,8,5
42778,42778,42779,8,4,-4
42779,42779,42780,4,7,3
42780,42780,42781,7,4,-3
42781,42781,42782,4,7,3
42782,42782,42783,7,0,-7
42783,42783,42784,0,7,7
42784,42784,42785,7,6,-1
42785,42785,42786,6,1,-5
42786,42786,42787,1,4,3
42787,42787,42788,4,6,2
42788,42788,42789,6,2,-4
42789,42789,42790,2,7,5
42790,42790,42791,7,3,-4
42791,42791,42792,3,2,-1
42792,42792,42793,2,4,2
42793,42793,42794,4,3,-1
42794,42794,42795,3,0,-3
42795,42795,42796,0,9,9
42796,42796,42797,9,0,-9
42797,42797,42798,0,7,7
42798,42798,42799,7,2,-5
42799,42799,42800,2,7,5
42800,42800,42801,7,0,-7
42801,42801,42802,0,9,9
42802,42802,42803,9,1,-8
42803,42803,42804,1,3,2
42804,42804,42805,3,2,-1
42805,42805,42806,2,1,-1
42806,42806,42807,1,3,2
42807,42807,42808,3,9,6
42808,42808,42809,9,4,-5
42809,42809,42810,4,2,-2
42810,42810,42811,2,7,5
42811,42811,42812,7,4,-3
42812,42812,42813,4,8,4
42813,42813,42814,8,2,-6
42814,42814,42815,2,9,7
42815,42815,42816,9,4,-5
42816,42816,42817,4,0,-4
42817,42817,42818,0,0,0
42818,42818,42819,0,1,1
42819,42819,42820,1,8,7
42820,42820,42821,8,2,-6
42821,42821,42822,2,4,2
42822,42822,42823,4,3,-1
42823,42823,42824,3,7,4
42824,42824,42825,7,4,-3
42825,42825,42826,4,9,5
42826,42826,42827,9,5,-4
42827,42827,42828,5,7,2
42828,42828,42829,7,6,-1
42829,42829,42830,6,2,-4
42830,42830,42831,2,7,5
42831,42831,42832,7,8,1
42832,42832,42833,8,8,0
42833,42833,42834,8,1,-7
42834,42834,42835,1,0,-1
42835,42835,42836,0,5,5
42836,42836,42837,5,1,-4
42837,42837,42838,1,9,8
42838,42838,42839,9,2,-7
42839,42839,42840,2,3,1
42840,42840,42841,3,3,0
42841,42841,42842,3,2,-1
42842,42842,42843,2,6,4
42843,42843,42844,6,7,1
42844,42844,42845,7,9,2
42845,42845,42846,9,1,-8
42846,42846,42847,1,6,5
42847,42847,42848,6,0,-6
42848,42848,42849,0,1,1
42849,42849,42850,1,5,4
42850,42850,42851,5,9,4
42851,42851,42852,9,1,-8
42852,42852,42853,1,9,8
42853,42853,42854,9,4,-5
42854,42854,42855,4,9,5
42855,42855,42856,9,6,-3
42856,42856,42857,6,4,-2
42857,42857,42858,4,4,0
42858,42858,42859,4,1,-3
42859,42859,42860,1,9,8
42860,42860,42861,9,2,-7
42861,42861,42862,2,0,-2
42862,42862,42863,0,5,5
42863,42863,42864,5,5,0
42864,42864,42865,5,0,-5
42865,42865,42866,0,2,2
42866,42866,42867,2,0,-2
42867,42867,42868,0,8,8
42868,42868,42869,8,6,-2
42869,42869,42870,6,9,3
42870,42870,42871,9,0,-9
42871,42871,42872,0,8,8
42872,42872,42873,8,8,0
42873,42873,42874,8,1,-7
42874,42874,42875,1,1,0
42875,42875,42876,1,7,6
42876,42876,42877,7,0,-7
42877,42877,42878,0,8,8
42878,42878,42879,8,9,1
42879,42879,42880,9,8,-1
42880,42880,42881,8,1,-7
42881,42881,42882,1,9,8
42882,42882,42883,9,2,-7
42883,42883,42884,2,9,7
42884,42884,42885,9,2,-7
42885,42885,42886,2,3,1
42886,42886,42887,3,2,-1
42887,42887,42888,2,1,-1
42888,42888,42889,1,5,4
42889,42889,42890,5,9,4
42890,42890,42891,9,2,-7
42891,42891,42892,2,7,5
42892,42892,42893,7,1,-6
42893,42893,42894,1,1,0
42894,42894,42895,1,4,3
42895,42895,42896,4,0,-4
42896,42896,42897,0,7,7
42897,42897,42898,7,3,-4
42898,42898,42899,3,1,-2
42899,42899,42900,1,8,7
42900,42900,42901,8,7,-1
42901,42901,42902,7,3,-4
42902,42902,42903,3,9,6
42903,42903,42904,9,6,-3
42904,42904,42905,6,6,0
42905,42905,42906,6,3,-3
42906,42906,42907,3,3,0
42907,42907,42908,3,3,0
42908,42908,42909,3,3,0
42909,42909,42910,3,5,2
42910,42910,42911,5,1,-4
42911,42911,42912,1,6,5
42912,42912,42913,6,0,-6
42913,42913,42914,0,3,3
42914,42914,42915,3,0,-3
42915,42915,42916,0,2,2
42916,42916,42917,2,5,3
42917,42917,42918,5,2,-3
42918,42918,42919,2,6,4
42919,42919,42920,6,8,2
42920,42920,42921,8,6,-2
42921,42921,42922,6,6,0
42922,42922,42923,6,8,2
42923,42923,42924,8,9,1
42924,42924,42925,9,0,-9
42925,42925,42926,0,2,2
42926,42926,42927,2,1,-1
42927,42927,42928,1,7,6
42928,42928,42929,7,2,-5
42929,42929,42930,2,3,1
42930,42930,42931,3,3,0
42931,42931,42932,3,1,-2
42932,42932,42933,1,4,3
42933,42933,42934,4,2,-2
42934,42934,42935,2,5,3
42935,42935,42936,5,2,-3
42936,42936,42937,2,6,4
42937,42937,42938,6,3,-3
42938,42938,42939,3,7,4
42939,42939,42940,7,5,-2
42940,42940,42941,5,8,3
42941,42941,42942,8,6,-2
42942,42942,42943,6,9,3
42943,42943,42944,9,8,-1
42944,42944,42945,8,0,-8
42945,42945,42946,0,9,9
42946,42946,42947,9,1,-8
42947,42947,42948,1,6,5
42948,42948,42949,6,2,-4
42949,42949,42950,2,2,0
42950,42950,42951,2,3,1
42951,42951,42952,3,4,1
42952,42952,42953,4,4,0
42953,42953,42954,4,3,-1
42954,42954,42955,3,5,2
42955,42955,42956,5,4,-1
42956,42956,42957,4,6,2
42957,42957,42958,6,2,-4
42958,42958,42959,2,7,5
42959,42959,42960,7,6,-1
42960,42960,42961,6,8,2
42961,42961,42962,8,3,-5
42962,42962,42963,3,9,6
42963,42963,42964,9,5,-4
42964,42964,42965,5,0,-5
42965,42965,42966,0,3,3
42966,42966,42967,3,1,-2
42967,42967,42968,1,1,0
42968,42968,42969,1,2,1
42969,42969,42970,2,5,3
42970,42970,42971,5,3,-2
42971,42971,42972,3,6,3
42972,42972,42973,6,4,-2
42973,42973,42974,4,1,-3
42974,42974,42975,1,6,5
42975,42975,42976,6,7,1
42976,42976,42977,7,7,0
42977,42977,42978,7,6,-1
42978,42978,42979,6,8,2
42979,42979,42980,8,0,-8
42980,42980,42981,0,0,0
42981,42981,42982,0,2,2
42982,42982,42983,2,5,3
42983,42983,42984,5,5,0
42984,42984,42985,5,0,-5
42985,42985,42986,0,1,1
42986,42986,42987,1,8,7
42987,42987,42988,8,8,0
42988,42988,42989,8,0,-8
42989,42989,42990,0,8,8
42990,42990,42991,8,2,-6
42991,42991,42992,2,6,4
42992,42992,42993,6,9,3
42993,42993,42994,9,3,-6
42994,42994,42995,3,4,1
42995,42995,42996,4,6,2
42996,42996,42997,6,7,1
42997,42997,42998,7,8,1
42998,42998,42999,8,1,-7
42999,42999,43000,1,9,8
43000,43000,43001,9,9,0
43001,43001,43002,9,2,-7
43002,43002,43003,2,1,-1
43003,43003,43004,1,8,7
43004,43004,43005,8,7,-1
43005,43005,43006,7,1,-6
43006,43006,43007,1,1,0
43007,43007,43008,1,8,7
43008,43008,43009,8,4,-4
43009,43009,43010,4,4,0
43010,43010,43011,4,0,-4
43011,43011,43012,0,3,3
43012,43012,43013,3,0,-3
43013,43013,43014,0,3,3
43014,43014,43015,3,4,1
43015,43015,43016,4,1,-3
43016,43016,43017,1,1,0
43017,43017,43018,1,8,7
43018,43018,43019,8,7,-1
43019,43019,43020,7,0,-7
43020,43020,43021,0,5,5
43021,43021,43022,5,4,-1
43022,43022,43023,4,7,3
43023,43023,43024,7,7,0
43024,43024,43025,7,1,-6
43025,43025,43026,1,4,3
43026,43026,43027,4,3,-1
43027,43027,43028,3,9,6
43028,43028,43029,9,3,-6
43029,43029,43030,3,1,-2
43030,43030,43031,1,3,2
43031,43031,43032,3,2,-1
43032,43032,43033,2,1,-1
43033,43033,43034,1,9,8
43034,43034,43035,9,6,-3
43035,43035,43036,6,7,1
43036,43036,43037,7,9,2
43037,43037,43038,9,4,-5
43038,43038,43039,4,7,3
43039,43039,43040,7,2,-5
43040,43040,43041,2,4,2
43041,43041,43042,4,8,4
43042,43042,43043,8,3,-5
43043,43043,43044,3,1,-2
43044,43044,43045,1,0,-1
43045,43045,43046,0,7,7
43046,43046,43047,7,2,-5
43047,43047,43048,2,5,3
43048,43048,43049,5,6,1
43049,43049,43050,6,0,-6
43050,43050,43051,0,8,8
43051,43051,43052,8,7,-1
43052,43052,43053,7,1,-6
43053,43053,43054,1,6,5
43054,43054,43055,6,5,-1
43055,43055,43056,5,5,0
43056,43056,43057,5,9,4
43057,43057,43058,9,9,0
43058,43058,43059,9,0,-9
43059,43059,43060,0,8,8
43060,43060,43061,8,6,-2
43061,43061,43062,6,8,2
43062,43062,43063,8,6,-2
43063,43063,43064,6,3,-3
43064,43064,43065,3,3,0
43065,43065,43066,3,5,2
43066,43066,43067,5,3,-2
43067,43067,43068,3,4,1
43068,43068,43069,4,8,4
43069,43069,43070,8,3,-5
43070,43070,43071,3,1,-2
43071,43071,43072,1,8,7
43072,43072,43073,8,4,-4
43073,43073,43074,4,0,-4
43074,43074,43075,0,7,7
43075,43075,43076,7,3,-4
43076,43076,43077,3,2,-1
43077,43077,43078,2,4,2
43078,43078,43079,4,2,-2
43079,43079,43080,2,3,1
43080,43080,43081,3,0,-3
43081,43081,43082,0,7,7
43082,43082,43083,7,0,-7
43083,43083,43084,0,5,5
43084,43084,43085,5,1,-4
43085,43085,43086,1,9,8
43086,43086,43087,9,7,-2
43087,43087,43088,7,0,-7
43088,43088,43089,0,7,7
43089,43089,43090,7,3,-4
43090,43090,43091,3,8,5
43091,43091,43092,8,0,-8
43092,43092,43093,0,9,9
43093,43093,43094,9,9,0
43094,43094,43095,9,6,-3
43095,43095,43096,6,8,2
43096,43096,43097,8,8,0
43097,43097,43098,8,5,-3
43098,43098,43099,5,8,3
43099,43099,43100,8,3,-5
43100,43100,43101,3,2,-1
43101,43101,43102,2,0,-2
43102,43102,43103,0,3,3
43103,43103,43104,3,7,4
43104,43104,43105,7,2,-5
43105,43105,43106,2,4,2
43106,43106,43107,4,9,5
43107,43107,43108,9,7,-2
43108,43108,43109,7,8,1
43109,43109,43110,8,8,0
43110,43110,43111,8,5,-3
43111,43111,43112,5,4,-1
43112,43112,43113,4,2,-2
43113,43113,43114,2,9,7
43114,43114,43115,9,6,-3
43115,43115,43116,6,2,-4
43116,43116,43117,2,2,0
43117,43117,43118,2,1,-1
43118,43118,43119,1,4,3
43119,43119,43120,4,9,5
43120,43120,43121,9,8,-1
43121,43121,43122,8,2,-6
43122,43122,43123,2,4,2
43123,43123,43124,4,2,-2
43124,43124,43125,2,6,4
43125,43125,43126,6,3,-3
43126,43126,43127,3,5,2
43127,43127,43128,5,1,-4
43128,43128,43129,1,0,-1
43129,43129,43130,0,4,4
43130,43130,43131,4,1,-3
43131,43131,43132,1,3,2
43132,43132,43133,3,2,-1
43133,43133,43134,2,0,-2
43134,43134,43135,0,3,3
43135,43135,43136,3,5,2
43136,43136,43137,5,4,-1
43137,43137,43138,4,9,5
43138,43138,43139,9,5,-4
43139,43139,43140,5,3,-2
43140,43140,43141,3,6,3
43141,43141,43142,6,1,-5
43142,43142,43143,1,7,6
43143,43143,43144,7,5,-2
43144,43144,43145,5,8,3
43145,43145,43146,8,9,1
43146,43146,43147,9,9,0
43147,43147,43148,9,5,-4
43148,43148,43149,5,0,-5
43149,43149,43150,0,4,4
43150,43150,43151,4,1,-3
43151,43151,43152,1,4,3
43152,43152,43153,4,2,-2
43153,43153,43154,2,6,4
43154,43154,43155,6,3,-3
43155,43155,43156,3,4,1
43156,43156,43157,4,4,0
43157,43157,43158,4,9,5
43158,43158,43159,9,5,-4
43159,43159,43160,5,7,2
43160,43160,43161,7,6,-1
43161,43161,43162,6,1,-5
43162,43162,43163,1,7,6
43163,43163,43164,7,6,-1
43164,43164,43165,6,8,2
43165,43165,43166,8,6,-2
43166,43166,43167,6,9,3
43167,43167,43168,9,7,-2
43168,43168,43169,7,0,-7
43169,43169,43170,0,0,0
43170,43170,43171,0,3,3
43171,43171,43172,3,2,-1
43172,43172,43173,2,4,2
43173,43173,43174,4,9,5
43174,43174,43175,9,5,-4
43175,43175,43176,5,2,-3
43176,43176,43177,2,6,4
43177,43177,43178,6,7,1
43178,43178,43179,7,7,0
43179,43179,43180,7,3,-4
43180,43180,43181,3,8,5
43181,43181,43182,8,8,0
43182,43182,43183,8,9,1
43183,43183,43184,9,2,-7
43184,43184,43185,2,9,7
43185,43185,43186,9,0,-9
43186,43186,43187,0,7,7
43187,43187,43188,7,0,-7
43188,43188,43189,0,5,5
43189,43189,43190,5,7,2
43190,43190,43191,7,2,-5
43191,43191,43192,2,3,1
43192,43192,43193,3,9,6
43193,43193,43194,9,8,-1
43194,43194,43195,8,0,-8
43195,43195,43196,0,3,3
43196,43196,43197,3,1,-2
43197,43197,43198,1,3,2
43198,43198,43199,3,5,2
43199,43199,43200,5,3,-2
43200,43200,43201,3,8,5
43201,43201,43202,8,7,-1
43202,43202,43203,7,8,1
43203,43203,43204,8,3,-5
43204,43204,43205,3,0,-3
43205,43205,43206,0,5,5
43206,43206,43207,5,9,4
43207,43207,43208,9,3,-6
43208,43208,43209,3,3,0
43209,43209,43210,3,9,6
43210,43210,43211,9,2,-7
43211,43211,43212,2,5,3
43212,43212,43213,5,7,2
43213,43213,43214,7,1,-6
43214,43214,43215,1,8,7
43215,43215,43216,8,0,-8
43216,43216,43217,0,4,4
43217,43217,43218,4,5,1
43218,43218,43219,5,4,-1
43219,43219,43220,4,2,-2
43220,43220,43221,2,5,3
43221,43221,43222,5,7,2
43222,43222,43223,7,9,2
43223,43223,43224,9,3,-6
43224,43224,43225,3,6,3
43225,43225,43226,6,8,2
43226,43226,43227,8,1,-7
43227,43227,43228,1,4,3
43228,43228,43229,4,0,-4
43229,43229,43230,0,3,3
43230,43230,43231,3,4,1
43231,43231,43232,4,1,-3
43232,43232,43233,1,5,4
43233,43233,43234,5,8,3
43234,43234,43235,8,3,-5
43235,43235,43236,3,0,-3
43236,43236,43237,0,9,9
43237,43237,43238,9,7,-2
43238,43238,43239,7,4,-3
43239,43239,43240,4,2,-2
43240,43240,43241,2,2,0
43241,43241,43242,2,8,6
43242,43242,43243,8,0,-8
43243,43243,43244,0,5,5
43244,43244,43245,5,5,0
43245,43245,43246,5,1,-4
43246,43246,43247,1,0,-1
43247,43247,43248,0,9,9
43248,43248,43249,9,1,-8
43249,43249,43250,1,8,7
43250,43250,43251,8,6,-2
43251,43251,43252,6,3,-3
43252,43252,43253,3,9,6
43253,43253,43254,9,2,-7
43254,43254,43255,2,3,1
43255,43255,43256,3,3,0
43256,43256,43257,3,2,-1
43257,43257,43258,2,0,-2
43258,43258,43259,0,9,9
43259,43259,43260,9,6,-3
43260,43260,43261,6,1,-5
43261,43261,43262,1,5,4
43262,43262,43263,5,6,1
43263,43263,43264,6,6,0
43264,43264,43265,6,0,-6
43265,43265,43266,0,0,0
43266,43266,43267,0,1,1
43267,43267,43268,1,8,7
43268,43268,43269,8,1,-7
43269,43269,43270,1,6,5
43270,43270,43271,6,8,2
43271,43271,43272,8,4,-4
43272,43272,43273,4,0,-4
43273,43273,43274,0,4,4
43274,43274,43275,4,4,0
43275,43275,43276,4,0,-4
43276,43276,43277,0,7,7
43277,43277,43278,7,4,-3
43278,43278,43279,4,7,3
43279,43279,43280,7,3,-4
43280,43280,43281,3,6,3
43281,43281,43282,6,9,3
43282,43282,43283,9,0,-9
43283,43283,43284,0,7,7
43284,43284,43285,7,7,0
43285,43285,43286,7,1,-6
43286,43286,43287,1,3,2
43287,43287,43288,3,7,4
43288,43288,43289,7,5,-2
43289,43289,43290,5,8,3
43290,43290,43291,8,4,-4
43291,43291,43292,4,2,-2
43292,43292,43293,2,2,0
43293,43293,43294,2,2,0
43294,43294,43295,2,4,2
43295,43295,43296,4,1,-3
43296,43296,43297,1,1,0
43297,43297,43298,1,3,2
43298,43298,43299,3,8,5
43299,43299,43300,8,1,-7
43300,43300,43301,1,3,2
43301,43301,43302,3,4,1
43302,43302,43303,4,5,1
43303,43303,43304,5,6,1
43304,43304,43305,6,6,0
43305,43305,43306,6,8,2
43306,43306,43307,8,7,-1
43307,43307,43308,7,5,-2
43308,43308,43309,5,0,-5
43309,43309,43310,0,9,9
43310,43310,43311,9,6,-3
43311,43311,43312,6,2,-4
43312,43312,43313,2,7,5
43313,43313,43314,7,2,-5
43314,43314,43315,2,1,-1
43315,43315,43316,1,1,0
43316,43316,43317,1,2,1
43317,43317,43318,2,5,3
43318,43318,43319,5,5,0
43319,43319,43320,5,6,1
43320,43320,43321,6,8,2
43321,43321,43322,8,8,0
43322,43322,43323,8,1,-7
43323,43323,43324,1,9,8
43324,43324,43325,9,9,0
43325,43325,43326,9,2,-7
43326,43326,43327,2,3,1
43327,43327,43328,3,5,2
43328,43328,43329,5,8,3
43329,43329,43330,8,3,-5
43330,43330,43331,3,2,-1
43331,43331,43332,2,1,-1
43332,43332,43333,1,8,7
43333,43333,43334,8,8,0
43334,43334,43335,8,8,0
43335,43335,43336,8,1,-7
43336,43336,43337,1,7,6
43337,43337,43338,7,2,-5
43338,43338,43339,2,1,-1
43339,43339,43340,1,7,6
43340,43340,43341,7,7,0
43341,43341,43342,7,8,1
43342,43342,43343,8,9,1
43343,43343,43344,9,1,-8
43344,43344,43345,1,2,1
43345,43345,43346,2,7,5
43346,43346,43347,7,0,-7
43347,43347,43348,0,6,6
43348,43348,43349,6,1,-5
43349,43349,43350,1,1,0
43350,43350,43351,1,2,1
43351,43351,43352,2,7,5
43352,43352,43353,7,3,-4
43353,43353,43354,3,7,4
43354,43354,43355,7,4,-3
43355,43355,43356,4,7,3
43356,43356,43357,7,5,-2
43357,43357,43358,5,9,4
43358,43358,43359,9,6,-3
43359,43359,43360,6,2,-4
43360,43360,43361,2,7,5
43361,43361,43362,7,7,0
43362,43362,43363,7,8,1
43363,43363,43364,8,4,-4
43364,43364,43365,4,9,5
43365,43365,43366,9,0,-9
43366,43366,43367,0,0,0
43367,43367,43368,0,5,5
43368,43368,43369,5,1,-4
43369,43369,43370,1,4,3
43370,43370,43371,4,2,-2
43371,43371,43372,2,8,6
43372,43372,43373,8,3,-5
43373,43373,43374,3,7,4
43374,43374,43375,7,4,-3
43375,43375,43376,4,2,-2
43376,43376,43377,2,5,3
43377,43377,43378,5,7,2
43378,43378,43379,7,6,-1
43379,43379,43380,6,3,-3
43380,43380,43381,3,7,4
43381,43381,43382,7,7,0
43382,43382,43383,7,8,1
43383,43383,43384,8,7,-1
43384,43384,43385,7,9,2
43385,43385,43386,9,6,-3
43386,43386,43387,6,0,-6
43387,43387,43388,0,8,8
43388,43388,43389,8,1,-7
43389,43389,43390,1,7,6
43390,43390,43391,7,2,-5
43391,43391,43392,2,9,7
43392,43392,43393,9,3,-6
43393,43393,43394,3,2,-1
43394,43394,43395,2,4,2
43395,43395,43396,4,6,2
43396,43396,43397,6,5,-1
43397,43397,43398,5,4,-1
43398,43398,43399,4,6,2
43399,43399,43400,6,7,1
43400,43400,43401,7,7,0
43401,43401,43402,7,5,-2
43402,43402,43403,5,8,3
43403,43403,43404,8,0,-8
43404,43404,43405,0,9,9
43405,43405,43406,9,1,-8
43406,43406,43407,1,2,1
43407,43407,43408,2,7,5
43408,43408,43409,7,5,-2
43409,43409,43410,5,8,3
43410,43410,43411,8,1,-7
43411,43411,43412,1,5,4
43412,43412,43413,5,6,1
43413,43413,43414,6,7,1
43414,43414,43415,7,4,-3
43415,43415,43416,4,9,5
43416,43416,43417,9,3,-6
43417,43417,43418,3,0,-3
43418,43418,43419,0,9,9
43419,43419,43420,9,6,-3
43420,43420,43421,6,9,3
43421,43421,43422,9,0,-9
43422,43422,43423,0,0,0
43423,43423,43424,0,6,6
43424,43424,43425,6,9,3
43425,43425,43426,9,1,-8
43426,43426,43427,1,7,6
43427,43427,43428,7,3,-4
43428,43428,43429,3,1,-2
43429,43429,43430,1,2,1
43430,43430,43431,2,6,4
43431,43431,43432,6,5,-1
43432,43432,43433,5,4,-1
43433,43433,43434,4,2,-2
43434,43434,43435,2,3,1
43435,43435,43436,3,2,-1
43436,43436,43437,2,6,4
43437,43437,43438,6,3,-3
43438,43438,43439,3,2,-1
43439,43439,43440,2,6,4
43440,43440,43441,6,2,-4
43441,43441,43442,2,5,3
43442,43442,43443,5,0,-5
43443,43443,43444,0,1,1
43444,43444,43445,1,0,-1
43445,43445,43446,0,1,1
43446,43446,43447,1,8,7
43447,43447,43448,8,3,-5
43448,43448,43449,3,2,-1
43449,43449,43450,2,2,0
43450,43450,43451,2,5,3
43451,43451,43452,5,4,-1
43452,43452,43453,4,9,5
43453,43453,43454,9,5,-4
43454,43454,43455,5,8,3
43455,43455,43456,8,3,-5
43456,43456,43457,3,6,3
43457,43457,43458,6,1,-5
43458,43458,43459,1,5,4
43459,43459,43460,5,3,-2
43460,43460,43461,3,7,4
43461,43461,43462,7,6,-1
43462,43462,43463,6,0,-6
43463,43463,43464,0,8,8
43464,43464,43465,8,0,-8
43465,43465,43466,0,3,3
43466,43466,43467,3,4,1
43467,43467,43468,4,0,-4
43468,43468,43469,0,1,1
43469,43469,43470,1,7,6
43470,43470,43471,7,7,0
43471,43471,43472,7,0,-7
43472,43472,43473,0,4,4
43473,43473,43474,4,3,-1
43474,43474,43475,3,3,0
43475,43475,43476,3,3,0
43476,43476,43477,3,2,-1
43477,43477,43478,2,9,7
43478,43478,43479,9,2,-7
43479,43479,43480,2,1,-1
43480,43480,43481,1,4,3
43481,43481,43482,4,3,-1
43482,43482,43483,3,7,4
43483,43483,43484,7,1,-6
43484,43484,43485,1,6,5
43485,43485,43486,6,2,-4
43486,43486,43487,2,4,2
43487,43487,43488,4,5,1
43488,43488,43489,5,7,2
43489,43489,43490,7,1,-6
43490,43490,43491,1,7,6
43491,43491,43492,7,3,-4
43492,43492,43493,3,7,4
43493,43493,43494,7,3,-4
43494,43494,43495,3,2,-1
43495,43495,43496,2,7,5
43496,43496,43497,7,0,-7
43497,43497,43498,0,6,6
43498,43498,43499,6,9,3
43499,43499,43500,9,1,-8
43500,43500,43501,1,8,7
43501,43501,43502,8,9,1
43502,43502,43503,9,5,-4
43503,43503,43504,5,8,3
43504,43504,43505,8,6,-2
43505,43505,43506,6,5,-1
43506,43506,43507,5,4,-1
43507,43507,43508,4,5,1
43508,43508,43509,5,3,-2
43509,43509,43510,3,5,2
43510,43510,43511,5,8,3
43511,43511,43512,8,9,1
43512,43512,43513,9,2,-7
43513,43513,43514,2,2,0
43514,43514,43515,2,8,6
43515,43515,43516,8,4,-4
43516,43516,43517,4,3,-1
43517,43517,43518,3,6,3
43518,43518,43519,6,8,2
43519,43519,43520,8,7,-1
43520,43520,43521,7,9,2
43521,43521,43522,9,8,-1
43522,43522,43523,8,5,-3
43523,43523,43524,5,8,3
43524,43524,43525,8,8,0
43525,43525,43526,8,9,1
43526,43526,43527,9,0,-9
43527,43527,43528,0,7,7
43528,43528,43529,7,5,-2
43529,43529,43530,5,4,-1
43530,43530,43531,4,4,0
43531,43531,43532,4,8,4
43532,43532,43533,8,7,-1
43533,43533,43534,7,8,1
43534,43534,43535,8,1,-7
43535,43535,43536,1,0,-1
43536,43536,43537,0,3,3
43537,43537,43538,3,8,5
43538,43538,43539,8,1,-7
43539,43539,43540,1,5,4
43540,43540,43541,5,7,2
43541,43541,43542,7,7,0
43542,43542,43543,7,9,2
43543,43543,43544,9,9,0
43544,43544,43545,9,6,-3
43545,43545,43546,6,2,-4
43546,43546,43547,2,2,0
43547,43547,43548,2,8,6
43548,43548,43549,8,0,-8
43549,43549,43550,0,9,9
43550,43550,43551,9,9,0
43551,43551,43552,9,3,-6
43552,43552,43553,3,1,-2
43553,43553,43554,1,0,-1
43554,43554,43555,0,7,7
43555,43555,43556,7,0,-7
43556,43556,43557,0,3,3
43557,43557,43558,3,8,5
43558,43558,43559,8,8,0
43559,43559,43560,8,5,-3
43560,43560,43561,5,0,-5
43561,43561,43562,0,3,3
43562,43562,43563,3,3,0
43563,43563,43564,3,6,3
43564,43564,43565,6,9,3
43565,43565,43566,9,2,-7
43566,43566,43567,2,1,-1
43567,43567,43568,1,5,4
43568,43568,43569,5,6,1
43569,43569,43570,6,1,-5
43570,43570,43571,1,4,3
43571,43571,43572,4,6,2
43572,43572,43573,6,3,-3
43573,43573,43574,3,5,2
43574,43574,43575,5,2,-3
43575,43575,43576,2,2,0
43576,43576,43577,2,1,-1
43577,43577,43578,1,1,0
43578,43578,43579,1,8,7
43579,43579,43580,8,8,0
43580,43580,43581,8,6,-2
43581,43581,43582,6,6,0
43582,43582,43583,6,1,-5
43583,43583,43584,1,7,6
43584,43584,43585,7,5,-2
43585,43585,43586,5,6,1
43586,43586,43587,6,5,-1
43587,43587,43588,5,8,3
43588,43588,43589,8,6,-2
43589,43589,43590,6,2,-4
43590,43590,43591,2,5,3
43591,43591,43592,5,6,1
43592,43592,43593,6,0,-6
43593,43593,43594,0,6,6
43594,43594,43595,6,1,-5
43595,43595,43596,1,9,8
43596,43596,43597,9,2,-7
43597,43597,43598,2,7,5
43598,43598,43599,7,3,-4
43599,43599,43600,3,4,1
43600,43600,43601,4,4,0
43601,43601,43602,4,0,-4
43602,43602,43603,0,5,5
43603,43603,43604,5,4,-1
43604,43604,43605,4,6,2
43605,43605,43606,6,8,2
43606,43606,43607,8,7,-1
43607,43607,43608,7,4,-3
43608,43608,43609,4,8,4
43609,43609,43610,8,0,-8
43610,43610,43611,0,9,9
43611,43611,43612,9,4,-5
43612,43612,43613,4,0,-4
43613,43613,43614,0,4,4
43614,43614,43615,4,1,-3
43615,43615,43616,1,1,0
43616,43616,43617,1,2,1
43617,43617,43618,2,7,5
43618,43618,43619,7,3,-4
43619,43619,43620,3,6,3
43620,43620,43621,6,4,-2
43621,43621,43622,4,4,0
43622,43622,43623,4,5,1
43623,43623,43624,5,0,-5
43624,43624,43625,0,6,6
43625,43625,43626,6,4,-2
43626,43626,43627,4,7,3
43627,43627,43628,7,7,0
43628,43628,43629,7,8,1
43629,43629,43630,8,2,-6
43630,43630,43631,2,0,-2
43631,43631,43632,0,2,2
43632,43632,43633,2,1,-1
43633,43633,43634,1,4,3
43634,43634,43635,4,2,-2
43635,43635,43636,2,4,2
43636,43636,43637,4,3,-1
43637,43637,43638,3,5,2
43638,43638,43639,5,4,-1
43639,43639,43640,4,6,2
43640,43640,43641,6,5,-1
43641,43641,43642,5,2,-3
43642,43642,43643,2,6,4
43643,43643,43644,6,3,-3
43644,43644,43645,3,7,4
43645,43645,43646,7,6,-1
43646,43646,43647,6,8,2
43647,43647,43648,8,5,-3
43648,43648,43649,5,2,-3
43649,43649,43650,2,9,7
43650,43650,43651,9,5,-4
43651,43651,43652,5,1,-4
43652,43652,43653,1,1,0
43653,43653,43654,1,3,2
43654,43654,43655,3,6,3
43655,43655,43656,6,8,2
43656,43656,43657,8,4,-4
43657,43657,43658,4,3,-1
43658,43658,43659,3,3,0
43659,43659,43660,3,9,6
43660,43660,43661,9,9,0
43661,43661,43662,9,0,-9
43662,43662,43663,0,9,9
43663,43663,43664,9,1,-8
43664,43664,43665,1,0,-1
43665,43665,43666,0,3,3
43666,43666,43667,3,9,6
43667,43667,43668,9,6,-3
43668,43668,43669,6,7,1
43669,43669,43670,7,3,-4
43670,43670,43671,3,1,-2
43671,43671,43672,1,3,2
43672,43672,43673,3,6,3
43673,43673,43674,6,2,-4
43674,43674,43675,2,4,2
43675,43675,43676,4,5,1
43676,43676,43677,5,3,-2
43677,43677,43678,3,6,3
43678,43678,43679,6,6,0
43679,43679,43680,6,5,-1
43680,43680,43681,5,2,-3
43681,43681,43682,2,6,4
43682,43682,43683,6,2,-4
43683,43683,43684,2,1,-1
43684,43684,43685,1,0,-1
43685,43685,43686,0,7,7
43686,43686,43687,7,8,1
43687,43687,43688,8,4,-4
43688,43688,43689,4,2,-2
43689,43689,43690,2,8,6
43690,43690,43691,8,5,-3
43691,43691,43692,5,8,3
43692,43692,43693,8,9,1
43693,43693,43694,9,6,-3
43694,43694,43695,6,8,2
43695,43695,43696,8,5,-3
43696,43696,43697,5,6,1
43697,43697,43698,6,8,2
43698,43698,43699,8,5,-3
43699,43699,43700,5,4,-1
43700,43700,43701,4,0,-4
43701,43701,43702,0,3,3
43702,43702,43703,3,4,1
43703,43703,43704,4,1,-3
43704,43704,43705,1,1,0
43705,43705,43706,1,0,-1
43706,43706,43707,0,7,7
43707,43707,43708,7,1,-6
43708,43708,43709,1,4,3
43709,43709,43710,4,7,3
43710,43710,43711,7,3,-4
43711,43711,43712,3,0,-3
43712,43712,43713,0,4,4
43713,43713,43714,4,1,-3
43714,43714,43715,1,1,0
43715,43715,43716,1,5,4
43716,43716,43717,5,3,-2
43717,43717,43718,3,9,6
43718,43718,43719,9,7,-2
43719,43719,43720,7,6,-1
43720,43720,43721,6,4,-2
43721,43721,43722,4,7,3
43722,43722,43723,7,7,0
43723,43723,43724,7,8,1
43724,43724,43725,8,7,-1
43725,43725,43726,7,6,-1
43726,43726,43727,6,0,-6
43727,43727,43728,0,0,0
43728,43728,43729,0,9,9
43729,43729,43730,9,3,-6
43730,43730,43731,3,8,5
43731,43731,43732,8,4,-4
43732,43732,43733,4,5,1
43733,43733,43734,5,9,4
43734,43734,43735,9,6,-3
43735,43735,43736,6,6,0
43736,43736,43737,6,4,-2
43737,43737,43738,4,9,5
43738,43738,43739,9,3,-6
43739,43739,43740,3,4,1
43740,43740,43741,4,8,4
43741,43741,43742,8,6,-2
43742,43742,43743,6,2,-4
43743,43743,43744,2,6,4
43744,43744,43745,6,8,2
43745,43745,43746,8,1,-7
43746,43746,43747,1,3,2
43747,43747,43748,3,5,2
43748,43748,43749,5,8,3
43749,43749,43750,8,9,1
43750,43750,43751,9,9,0
43751,43751,43752,9,6,-3
43752,43752,43753,6,5,-1
43753,43753,43754,5,8,3
43754,43754,43755,8,8,0
43755,43755,43756,8,4,-4
43756,43756,43757,4,4,0
43757,43757,43758,4,3,-1
43758,43758,43759,3,3,0
43759,43759,43760,3,2,-1
43760,43760,43761,2,1,-1
43761,43761,43762,1,3,2
43762,43762,43763,3,7,4
43763,43763,43764,7,1,-6
43764,43764,43765,1,9,8
43765,43765,43766,9,5,-4
43766,43766,43767,5,6,1
43767,43767,43768,6,2,-4
43768,43768,43769,2,2,0
43769,43769,43770,2,1,-1
43770,43770,43771,1,7,6
43771,43771,43772,7,5,-2
43772,43772,43773,5,3,-2
43773,43773,43774,3,7,4
43774,43774,43775,7,3,-4
43775,43775,43776,3,5,2
43776,43776,43777,5,9,4
43777,43777,43778,9,0,-9
43778,43778,43779,0,1,1
43779,43779,43780,1,5,4
43780,43780,43781,5,4,-1
43781,43781,43782,4,3,-1
43782,43782,43783,3,3,0
43783,43783,43784,3,1,-2
43784,43784,43785,1,9,8
43785,43785,43786,9,9,0
43786,43786,43787,9,8,-1
43787,43787,43788,8,8,0
43788,43788,43789,8,2,-6
43789,43789,43790,2,1,-1
43790,43790,43791,1,1,0
43791,43791,43792,1,9,8
43792,43792,43793,9,8,-1
43793,43793,43794,8,2,-6
43794,43794,43795,2,6,4
43795,43795,43796,6,7,1
43796,43796,43797,7,4,-3
43797,43797,43798,4,7,3
43798,43798,43799,7,5,-2
43799,43799,43800,5,6,1
43800,43800,43801,6,1,-5
43801,43801,43802,1,7,6
43802,43802,43803,7,5,-2
43803,43803,43804,5,6,1
43804,43804,43805,6,5,-1
43805,43805,43806,5,2,-3
43806,43806,43807,2,6,4
43807,43807,43808,6,1,-5
43808,43808,43809,1,5,4
43809,43809,43810,5,9,4
43810,43810,43811,9,0,-9
43811,43811,43812,0,4,4
43812,43812,43813,4,1,-3
43813,43813,43814,1,9,8
43814,43814,43815,9,2,-7
43815,43815,43816,2,3,1
43816,43816,43817,3,3,0
43817,43817,43818,3,2,-1
43818,43818,43819,2,4,2
43819,43819,43820,4,5,1
43820,43820,43821,5,7,2
43821,43821,43822,7,6,-1
43822,43822,43823,6,8,2
43823,43823,43824,8,8,0
43824,43824,43825,8,9,1
43825,43825,43826,9,2,-7
43826,43826,43827,2,0,-2
43827,43827,43828,0,8,8
43828,43828,43829,8,1,-7
43829,43829,43830,1,9,8
43830,43830,43831,9,2,-7
43831,43831,43832,2,4,2
43832,43832,43833,4,3,-1
43833,43833,43834,3,0,-3
43834,43834,43835,0,4,4
43835,43835,43836,4,1,-3
43836,43836,43837,1,5,4
43837,43837,43838,5,5,0
43838,43838,43839,5,6,1
43839,43839,43840,6,7,1
43840,43840,43841,7,7,0
43841,43841,43842,7,2,-5
43842,43842,43843,2,8,6
43843,43843,43844,8,1,-7
43844,43844,43845,1,9,8
43845,43845,43846,9,8,-1
43846,43846,43847,8,0,-8
43847,43847,43848,0,8,8
43848,43848,43849,8,1,-7
43849,43849,43850,1,2,1
43850,43850,43851,2,2,0
43851,43851,43852,2,2,0
43852,43852,43853,2,3,1
43853,43853,43854,3,2,-1
43854,43854,43855,2,5,3
43855,43855,43856,5,5,0
43856,43856,43857,5,6,1
43857,43857,43858,6,4,-2
43858,43858,43859,4,7,3
43859,43859,43860,7,7,0
43860,43860,43861,7,8,1
43861,43861,43862,8,9,1
43862,43862,43863,9,9,0
43863,43863,43864,9,9,0
43864,43864,43865,9,3,-6
43865,43865,43866,3,6,3
43866,43866,43867,6,5,-1
43867,43867,43868,5,3,-2
43868,43868,43869,3,3,0
43869,43869,43870,3,9,6
43870,43870,43871,9,2,-7
43871,43871,43872,2,1,-1
43872,43872,43873,1,9,8
43873,43873,43874,9,2,-7
43874,43874,43875,2,3,1
43875,43875,43876,3,8,5
43876,43876,43877,8,2,-6
43877,43877,43878,2,2,0
43878,43878,43879,2,1,-1
43879,43879,43880,1,8,7
43880,43880,43881,8,4,-4
43881,43881,43882,4,5,1
43882,43882,43883,5,3,-2
43883,43883,43884,3,0,-3
43884,43884,43885,0,2,2
43885,43885,43886,2,7,5
43886,43886,43887,7,1,-6
43887,43887,43888,1,9,8
43888,43888,43889,9,3,-6
43889,43889,43890,3,7,4
43890,43890,43891,7,9,2
43891,43891,43892,9,6,-3
43892,43892,43893,6,7,1
43893,43893,43894,7,8,1
43894,43894,43895,8,2,-6
43895,43895,43896,2,9,7
43896,43896,43897,9,1,-8
43897,43897,43898,1,7,6
43898,43898,43899,7,2,-5
43899,43899,43900,2,8,6
43900,43900,43901,8,8,0
43901,43901,43902,8,3,-5
43902,43902,43903,3,9,6
43903,43903,43904,9,4,-5
43904,43904,43905,4,1,-3
43905,43905,43906,1,4,3
43906,43906,43907,4,8,4
43907,43907,43908,8,6,-2
43908,43908,43909,6,8,2
43909,43909,43910,8,1,-7
43910,43910,43911,1,7,6
43911,43911,43912,7,7,0
43912,43912,43913,7,0,-7
43913,43913,43914,0,6,6
43914,43914,43915,6,0,-6
43915,43915,43916,0,9,9
43916,43916,43917,9,7,-2
43917,43917,43918,7,9,2
43918,43918,43919,9,7,-2
43919,43919,43920,7,9,2
43920,43920,43921,9,8,-1
43921,43921,43922,8,3,-5
43922,43922,43923,3,7,4
43923,43923,43924,7,7,0
43924,43924,43925,7,6,-1
43925,43925,43926,6,7,1
43926,43926,43927,7,1,-6
43927,43927,43928,1,4,3
43928,43928,43929,4,4,0
43929,43929,43930,4,8,4
43930,43930,43931,8,6,-2
43931,43931,43932,6,0,-6
43932,43932,43933,0,1,1
43933,43933,43934,1,4,3
43934,43934,43935,4,2,-2
43935,43935,43936,2,5,3
43936,43936,43937,5,5,0
43937,43937,43938,5,8,3
43938,43938,43939,8,0,-8
43939,43939,43940,0,6,6
43940,43940,43941,6,0,-6
43941,43941,43942,0,3,3
43942,43942,43943,3,3,0
43943,43943,43944,3,8,5
43944,43944,43945,8,8,0
43945,43945,43946,8,5,-3
43946,43946,43947,5,4,-1
43947,43947,43948,4,1,-3
43948,43948,43949,1,4,3
43949,43949,43950,4,9,5
43950,43950,43951,9,1,-8
43951,43951,43952,1,3,2
43952,43952,43953,3,8,5
43953,43953,43954,8,4,-4
43954,43954,43955,4,6,2
43955,43955,43956,6,7,1
43956,43956,43957,7,5,-2
43957,43957,43958,5,8,3
43958,43958,43959,8,9,1
43959,43959,43960,9,0,-9
43960,43960,43961,0,0,0
43961,43961,43962,0,3,3
43962,43962,43963,3,0,-3
43963,43963,43964,0,2,2
43964,43964,43965,2,0,-2
43965,43965,43966,0,9,9
43966,43966,43967,9,3,-6
43967,43967,43968,3,8,5
43968,43968,43969,8,7,-1
43969,43969,43970,7,9,2
43970,43970,43971,9,1,-8
43971,43971,43972,1,1,0
43972,43972,43973,1,6,5
43973,43973,43974,6,2,-4
43974,43974,43975,2,2,0
43975,43975,43976,2,0,-2
43976,43976,43977,0,6,6
43977,43977,43978,6,3,-3
43978,43978,43979,3,6,3
43979,43979,43980,6,1,-5
43980,43980,43981,1,0,-1
43981,43981,43982,0,9,9
43982,43982,43983,9,4,-5
43983,43983,43984,4,1,-3
43984,43984,43985,1,5,4
43985,43985,43986,5,8,3
43986,43986,43987,8,4,-4
43987,43987,43988,4,2,-2
43988,43988,43989,2,1,-1
43989,43989,43990,1,7,6
43990,43990,43991,7,3,-4
43991,43991,43992,3,9,6
43992,43992,43993,9,8,-1
43993,43993,43994,8,2,-6
43994,43994,43995,2,6,4
43995,43995,43996,6,2,-4
43996,43996,43997,2,3,1
43997,43997,43998,3,7,4
43998,43998,43999,7,9,2
43999,43999,44000,9,0,-9
44000,44000,44001,0,9,9
44001,44001,44002,9,8,-1
44002,44002,44003,8,5,-3
44003,44003,44004,5,3,-2
44004,44004,44005,3,7,4
44005,44005,44006,7,5,-2
44006,44006,44007,5,8,3
44007,44007,44008,8,9,1
44008,44008,44009,9,5,-4
44009,44009,44010,5,9,4
44010,44010,44011,9,6,-3
44011,44011,44012,6,1,-5
44012,44012,44013,1,4,3
44013,44013,44014,4,5,1
44014,44014,44015,5,7,2
44015,44015,44016,7,9,2
44016,44016,44017,9,6,-3
44017,44017,44018,6,5,-1
44018,44018,44019,5,2,-3
44019,44019,44020,2,3,1
44020,44020,44021,3,2,-1
44021,44021,44022,2,9,7
44022,44022,44023,9,0,-9
44023,44023,44024,0,8,8
44024,44024,44025,8,9,1
44025,44025,44026,9,9,0
44026,44026,44027,9,4,-5
44027,44027,44028,4,9,5
44028,44028,44029,9,0,-9
44029,44029,44030,0,0,0
44030,44030,44031,0,1,1
44031,44031,44032,1,3,2
44032,44032,44033,3,2,-1
44033,44033,44034,2,3,1
44034,44034,44035,3,3,0
44035,44035,44036,3,1,-2
44036,44036,44037,1,4,3
44037,44037,44038,4,1,-3
44038,44038,44039,1,7,6
44039,44039,44040,7,0,-7
44040,44040,44041,0,8,8
44041,44041,44042,8,7,-1
44042,44042,44043,7,9,2
44043,44043,44044,9,9,0
44044,44044,44045,9,0,-9
44045,44045,44046,0,1,1
44046,44046,44047,1,1,0
44047,44047,44048,1,9,8
44048,44048,44049,9,2,-7
44049,44049,44050,2,7,5
44050,44050,44051,7,3,-4
44051,44051,44052,3,4,1
44052,44052,44053,4,4,0
44053,44053,44054,4,2,-2
44054,44054,44055,2,5,3
44055,44055,44056,5,8,3
44056,44056,44057,8,6,-2
44057,44057,44058,6,3,-3
44058,44058,44059,3,7,4
44059,44059,44060,7,0,-7
44060,44060,44061,0,8,8
44061,44061,44062,8,7,-1
44062,44062,44063,7,0,-7
44063,44063,44064,0,7,7
44064,44064,44065,7,1,-6
44065,44065,44066,1,6,5
44066,44066,44067,6,7,1
44067,44067,44068,7,4,-3
44068,44068,44069,4,8,4
44069,44069,44070,8,6,-2
44070,44070,44071,6,9,3
44071,44071,44072,9,8,-1
44072,44072,44073,8,6,-2
44073,44073,44074,6,9,3
44074,44074,44075,9,9,0
44075,44075,44076,9,0,-9
44076,44076,44077,0,6,6
44077,44077,44078,6,6,0
44078,44078,44079,6,1,-5
44079,44079,44080,1,7,6
44080,44080,44081,7,9,2
44081,44081,44082,9,6,-3
44082,44082,44083,6,9,3
44083,44083,44084,9,9,0
44084,44084,44085,9,9,0
44085,44085,44086,9,4,-5
44086,44086,44087,4,8,4
44087,44087,44088,8,4,-4
44088,44088,44089,4,1,-3
44089,44089,44090,1,2,1
44090,44090,44091,2,4,2
44091,44091,44092,4,2,-2
44092,44092,44093,2,1,-1
44093,44093,44094,1,0,-1
44094,44094,44095,0,2,2
44095,44095,44096,2,0,-2
44096,44096,44097,0,9,9
44097,44097,44098,9,2,-7
44098,44098,44099,2,5,3
44099,44099,44100,5,4,-1
44100,44100,44101,4,3,-1
44101,44101,44102,3,6,3
44102,44102,44103,6,0,-6
44103,44103,44104,0,9,9
44104,44104,44105,9,4,-5
44105,44105,44106,4,5,1
44106,44106,44107,5,9,4
44107,44107,44108,9,1,-8
44108,44108,44109,1,1,0
44109,44109,44110,1,4,3
44110,44110,44111,4,7,3
44111,44111,44112,7,3,-4
44112,44112,44113,3,1,-2
44113,44113,44114,1,6,5
44114,44114,44115,6,8,2
44115,44115,44116,8,9,1
44116,44116,44117,9,7,-2
44117,44117,44118,7,8,1
44118,44118,44119,8,6,-2
44119,44119,44120,6,1,-5
44120,44120,44121,1,0,-1
44121,44121,44122,0,8,8
44122,44122,44123,8,8,0
44123,44123,44124,8,4,-4
44124,44124,44125,4,1,-3
44125,44125,44126,1,1,0
44126,44126,44127,1,0,-1
44127,44127,44128,0,6,6
44128,44128,44129,6,9,3
44129,44129,44130,9,0,-9
44130,44130,44131,0,1,1
44131,44131,44132,1,6,5
44132,44132,44133,6,2,-4
44133,44133,44134,2,3,1
44134,44134,44135,3,5,2
44135,44135,44136,5,1,-4
44136,44136,44137,1,4,3
44137,44137,44138,4,3,-1
44138,44138,44139,3,7,4
44139,44139,44140,7,2,-5
44140,44140,44141,2,7,5
44141,44141,44142,7,3,-4
44142,44142,44143,3,2,-1
44143,44143,44144,2,8,6
44144,44144,44145,8,7,-1
44145,44145,44146,7,3,-4
44146,44146,44147,3,5,2
44147,44147,44148,5,5,0
44148,44148,44149,5,2,-3
44149,44149,44150,2,7,5
44150,44150,44151,7,1,-6
44151,44151,44152,1,5,4
44152,44152,44153,5,4,-1
44153,44153,44154,4,9,5
44154,44154,44155,9,4,-5
44155,44155,44156,4,7,3
44156,44156,44157,7,3,-4
44157,44157,44158,3,1,-2
44158,44158,44159,1,0,-1
44159,44159,44160,0,7,7
44160,44160,44161,7,0,-7
44161,44161,44162,0,3,3
44162,44162,44163,3,8,5
44163,44163,44164,8,5,-3
44164,44164,44165,5,5,0
44165,44165,44166,5,2,-3
44166,44166,44167,2,4,2
44167,44167,44168,4,6,2
44168,44168,44169,6,7,1
44169,44169,44170,7,7,0
44170,44170,44171,7,8,1
44171,44171,44172,8,8,0
44172,44172,44173,8,8,0
44173,44173,44174,8,3,-5
44174,44174,44175,3,7,4
44175,44175,44176,7,8,1
44176,44176,44177,8,9,1
44177,44177,44178,9,7,-2
44178,44178,44179,7,6,-1
44179,44179,44180,6,8,2
44180,44180,44181,8,3,-5
44181,44181,44182,3,9,6
44182,44182,44183,9,1,-8
44183,44183,44184,1,0,-1
44184,44184,44185,0,7,7
44185,44185,44186,7,2,-5
44186,44186,44187,2,9,7
44187,44187,44188,9,3,-6
44188,44188,44189,3,6,3
44189,44189,44190,6,4,-2
44190,44190,44191,4,3,-1
44191,44191,44192,3,3,0
44192,44192,44193,3,3,0
44193,44193,44194,3,7,4
44194,44194,44195,7,2,-5
44195,44195,44196,2,8,6
44196,44196,44197,8,6,-2
44197,44197,44198,6,1,-5
44198,44198,44199,1,0,-1
44199,44199,44200,0,8,8
44200,44200,44201,8,6,-2
44201,44201,44202,6,8,2
44202,44202,44203,8,8,0
44203,44203,44204,8,6,-2
44204,44204,44205,6,0,-6
44205,44205,44206,0,8,8
44206,44206,44207,8,1,-7
44207,44207,44208,1,0,-1
44208,44208,44209,0,2,2
44209,44209,44210,2,1,-1
44210,44210,44211,1,3,2
44211,44211,44212,3,7,4
44212,44212,44213,7,4,-3
44213,44213,44214,4,9,5
44214,44214,44215,9,5,-4
44215,44215,44216,5,3,-2
44216,44216,44217,3,6,3
44217,44217,44218,6,6,0
44218,44218,44219,6,7,1
44219,44219,44220,7,1,-6
44220,44220,44221,1,8,7
44221,44221,44222,8,1,-7
44222,44222,44223,1,9,8
44223,44223,44224,9,4,-5
44224,44224,44225,4,0,-4
44225,44225,44226,0,2,2
44226,44226,44227,2,1,-1
44227,44227,44228,1,9,8
44228,44228,44229,9,2,-7
44229,44229,44230,2,9,7
44230,44230,44231,9,3,-6
44231,44231,44232,3,4,1
44232,44232,44233,4,4,0
44233,44233,44234,4,9,5
44234,44234,44235,9,5,-4
44235,44235,44236,5,9,4
44236,44236,44237,9,6,-3
44237,44237,44238,6,6,0
44238,44238,44239,6,7,1
44239,44239,44240,7,3,-4
44240,44240,44241,3,8,5
44241,44241,44242,8,1,-7
44242,44242,44243,1,0,-1
44243,44243,44244,0,9,9
44244,44244,44245,9,1,-8
44245,44245,44246,1,7,6
44246,44246,44247,7,2,-5
44247,44247,44248,2,2,0
44248,44248,44249,2,3,1
44249,44249,44250,3,6,3
44250,44250,44251,6,4,-2
44251,44251,44252,4,7,3
44252,44252,44253,7,5,-2
44253,44253,44254,5,7,2
44254,44254,44255,7,6,-1
44255,44255,44256,6,4,-2
44256,44256,44257,4,7,3
44257,44257,44258,7,6,-1
44258,44258,44259,6,8,2
44259,44259,44260,8,2,-6
44260,44260,44261,2,9,7
44261,44261,44262,9,5,-4
44262,44262,44263,5,5,0
44263,44263,44264,5,4,-1
44264,44264,44265,4,2,-2
44265,44265,44266,2,0,-2
44266,44266,44267,0,8,8
44267,44267,44268,8,0,-8
44268,44268,44269,0,1,1
44269,44269,44270,1,8,7
44270,44270,44271,8,7,-1
44271,44271,44272,7,8,1
44272,44272,44273,8,2,-6
44273,44273,44274,2,2,0
44274,44274,44275,2,4,2
44275,44275,44276,4,0,-4
44276,44276,44277,0,1,1
44277,44277,44278,1,0,-1
44278,44278,44279,0,4,4
44279,44279,44280,4,3,-1
44280,44280,44281,3,1,-2
44281,44281,44282,1,3,2
44282,44282,44283,3,4,1
44283,44283,44284,4,4,0
44284,44284,44285,4,9,5
44285,44285,44286,9,8,-1
44286,44286,44287,8,6,-2
44287,44287,44288,6,1,-5
44288,44288,44289,1,8,7
44289,44289,44290,8,1,-7
44290,44290,44291,1,4,3
44291,44291,44292,4,5,1
44292,44292,44293,5,5,0
44293,44293,44294,5,4,-1
44294,44294,44295,4,3,-1
44295,44295,44296,3,1,-2
44296,44296,44297,1,7,6
44297,44297,44298,7,2,-5
44298,44298,44299,2,8,6
44299,44299,44300,8,6,-2
44300,44300,44301,6,4,-2
44301,44301,44302,4,2,-2
44302,44302,44303,2,3,1
44303,44303,44304,3,2,-1
44304,44304,44305,2,3,1
44305,44305,44306,3,1,-2
44306,44306,44307,1,5,4
44307,44307,44308,5,8,3
44308,44308,44309,8,6,-2
44309,44309,44310,6,8,2
44310,44310,44311,8,7,-1
44311,44311,44312,7,3,-4
44312,44312,44313,3,0,-3
44313,44313,44314,0,0,0
44314,44314,44315,0,6,6
44315,44315,44316,6,2,-4
44316,44316,44317,2,1,-1
44317,44317,44318,1,6,5
44318,44318,44319,6,6,0
44319,44319,44320,6,8,2
44320,44320,44321,8,8,0
44321,44321,44322,8,7,-1
44322,44322,44323,7,7,0
44323,44323,44324,7,1,-6
44324,44324,44325,1,0,-1
44325,44325,44326,0,0,0
44326,44326,44327,0,1,1
44327,44327,44328,1,9,8
44328,44328,44329,9,5,-4
44329,44329,44330,5,6,1
44330,44330,44331,6,6,0
44331,44331,44332,6,4,-2
44332,44332,44333,4,0,-4
44333,44333,44334,0,2,2
44334,44334,44335,2,0,-2
44335,44335,44336,0,6,6
44336,44336,44337,6,6,0
44337,44337,44338,6,3,-3
44338,44338,44339,3,1,-2
44339,44339,44340,1,9,8
44340,44340,44341,9,5,-4
44341,44341,44342,5,4,-1
44342,44342,44343,4,8,4
44343,44343,44344,8,0,-8
44344,44344,44345,0,4,4
44345,44345,44346,4,6,2
44346,44346,44347,6,2,-4
44347,44347,44348,2,9,7
44348,44348,44349,9,3,-6
44349,44349,44350,3,3,0
44350,44350,44351,3,9,6
44351,44351,44352,9,4,-5
44352,44352,44353,4,7,3
44353,44353,44354,7,6,-1
44354,44354,44355,6,6,0
44355,44355,44356,6,4,-2
44356,44356,44357,4,9,5
44357,44357,44358,9,6,-3
44358,44358,44359,6,1,-5
44359,44359,44360,1,8,7
44360,44360,44361,8,9,1
44361,44361,44362,9,2,-7
44362,44362,44363,2,0,-2
44363,44363,44364,0,2,2
44364,44364,44365,2,6,4
44365,44365,44366,6,1,-5
44366,44366,44367,1,7,6
44367,44367,44368,7,1,-6
44368,44368,44369,1,1,0
44369,44369,44370,1,1,0
44370,44370,44371,1,2,1
44371,44371,44372,2,0,-2
44372,44372,44373,0,3,3
44373,44373,44374,3,2,-1
44374,44374,44375,2,9,7
44375,44375,44376,9,9,0
44376,44376,44377,9,2,-7
44377,44377,44378,2,7,5
44378,44378,44379,7,4,-3
44379,44379,44380,4,3,-1
44380,44380,44381,3,5,2
44381,44381,44382,5,6,1
44382,44382,44383,6,5,-1
44383,44383,44384,5,9,4
44384,44384,44385,9,3,-6
44385,44385,44386,3,4,1
44386,44386,44387,4,7,3
44387,44387,44388,7,3,-4
44388,44388,44389,3,1,-2
44389,44389,44390,1,5,4
44390,44390,44391,5,8,3
44391,44391,44392,8,7,-1
44392,44392,44393,7,2,-5
44393,44393,44394,2,6,4
44394,44394,44395,6,2,-4
44395,44395,44396,2,9,7
44396,44396,44397,9,3,-6
44397,44397,44398,3,7,4
44398,44398,44399,7,0,-7
44399,44399,44400,0,9,9
44400,44400,44401,9,2,-7
44401,44401,44402,2,9,7
44402,44402,44403,9,9,0
44403,44403,44404,9,5,-4
44404,44404,44405,5,4,-1
44405,44405,44406,4,5,1
44406,44406,44407,5,9,4
44407,44407,44408,9,3,-6
44408,44408,44409,3,7,4
44409,44409,44410,7,6,-1
44410,44410,44411,6,0,-6
44411,44411,44412,0,2,2
44412,44412,44413,2,0,-2
44413,44413,44414,0,2,2
44414,44414,44415,2,2,0
44415,44415,44416,2,3,1
44416,44416,44417,3,7,4
44417,44417,44418,7,1,-6
44418,44418,44419,1,4,3
44419,44419,44420,4,6,2
44420,44420,44421,6,9,3
44421,44421,44422,9,1,-8
44422,44422,44423,1,9,8
44423,44423,44424,9,2,-7
44424,44424,44425,2,2,0
44425,44425,44426,2,3,1
44426,44426,44427,3,8,5
44427,44427,44428,8,6,-2
44428,44428,44429,6,9,3
44429,44429,44430,9,9,0
44430,44430,44431,9,1,-8
44431,44431,44432,1,1,0
44432,44432,44433,1,8,7
44433,44433,44434,8,7,-1
44434,44434,44435,7,3,-4
44435,44435,44436,3,8,5
44436,44436,44437,8,8,0
44437,44437,44438,8,9,1
44438,44438,44439,9,3,-6
44439,44439,44440,3,3,0
44440,44440,44441,3,6,3
44441,44441,44442,6,8,2
44442,44442,44443,8,7,-1
44443,44443,44444,7,6,-1
44444,44444,44445,6,0,-6
44445,44445,44446,0,1,1
44446,44446,44447,1,4,3
44447,44447,44448,4,0,-4
44448,44448,44449,0,0,0
44449,44449,44450,0,9,9
44450,44450,44451,9,0,-9
44451,44451,44452,0,6,6
44452,44452,44453,6,1,-5
44453,44453,44454,1,1,0
44454,44454,44455,1,2,1
44455,44455,44456,2,3,1
44456,44456,44457,3,3,0
44457,44457,44458,3,8,5
44458,44458,44459,8,4,-4
44459,44459,44460,4,6,2
44460,44460,44461,6,5,-1
44461,44461,44462,5,3,-2
44462,44462,44463,3,6,3
44463,44463,44464,6,4,-2
44464,44464,44465,4,7,3
44465,44465,44466,7,4,-3
44466,44466,44467,4,8,4
44467,44467,44468,8,3,-5
44468,44468,44469,3,9,6
44469,44469,44470,9,7,-2
44470,44470,44471,7,0,-7
44471,44471,44472,0,7,7
44472,44472,44473,7,1,-6
44473,44473,44474,1,0,-1
44474,44474,44475,0,2,2
44475,44475,44476,2,5,3
44476,44476,44477,5,3,-2
44477,44477,44478,3,3,0
44478,44478,44479,3,4,1
44479,44479,44480,4,5,1
44480,44480,44481,5,5,0
44481,44481,44482,5,1,-4
44482,44482,44483,1,6,5
44483,44483,44484,6,8,2
44484,44484,44485,8,7,-1
44485,44485,44486,7,9,2
44486,44486,44487,9,8,-1
44487,44487,44488,8,5,-3
44488,44488,44489,5,9,4
44489,44489,44490,9,2,-7
44490,44490,44491,2,0,-2
44491,44491,44492,0,2,2
44492,44492,44493,2,1,-1
44493,44493,44494,1,5,4
44494,44494,44495,5,2,-3
44495,44495,44496,2,4,2
44496,44496,44497,4,3,-1
44497,44497,44498,3,6,3
44498,44498,44499,6,4,-2
44499,44499,44500,4,7,3
44500,44500,44501,7,5,-2
44501,44501,44502,5,2,-3
44502,44502,44503,2,6,4
44503,44503,44504,6,3,-3
44504,44504,44505,3,7,4
44505,44505,44506,7,5,-2
44506,44506,44507,5,8,3
44507,44507,44508,8,5,-3
44508,44508,44509,5,9,4
44509,44509,44510,9,3,-6
44510,44510,44511,3,1,-2
44511,44511,44512,1,7,6
44512,44512,44513,7,0,-7
44513,44513,44514,0,8,8
44514,44514,44515,8,4,-4
44515,44515,44516,4,7,3
44516,44516,44517,7,6,-1
44517,44517,44518,6,0,-6
44518,44518,44519,0,3,3
44519,44519,44520,3,2,-1
44520,44520,44521,2,4,2
44521,44521,44522,4,3,-1
44522,44522,44523,3,4,1
44523,44523,44524,4,1,-3
44524,44524,44525,1,2,1
44525,44525,44526,2,7,5
44526,44526,44527,7,8,1
44527,44527,44528,8,4,-4
44528,44528,44529,4,1,-3
44529,44529,44530,1,4,3
44530,44530,44531,4,0,-4
44531,44531,44532,0,8,8
44532,44532,44533,8,6,-2
44533,44533,44534,6,9,3
44534,44534,44535,9,4,-5
44535,44535,44536,4,7,3
44536,44536,44537,7,9,2
44537,44537,44538,9,7,-2
44538,44538,44539,7,7,0
44539,44539,44540,7,3,-4
44540,44540,44541,3,2,-1
44541,44541,44542,2,1,-1
44542,44542,44543,1,3,2
44543,44543,44544,3,4,1
44544,44544,44545,4,3,-1
44545,44545,44546,3,3,0
44546,44546,44547,3,9,6
44547,44547,44548,9,1,-8
44548,44548,44549,1,2,1
44549,44549,44550,2,9,7
44550,44550,44551,9,0,-9
44551,44551,44552,0,7,7
44552,44552,44553,7,9,2
44553,44553,44554,9,5,-4
44554,44554,44555,5,3,-2
44555,44555,44556,3,1,-2
44556,44556,44557,1,3,2
44557,44557,44558,3,0,-3
44558,44558,44559,0,9,9
44559,44559,44560,9,0,-9
44560,44560,44561,0,1,1
44561,44561,44562,1,7,6
44562,44562,44563,7,5,-2
44563,44563,44564,5,5,0
44564,44564,44565,5,2,-3
44565,44565,44566,2,7,5
44566,44566,44567,7,3,-4
44567,44567,44568,3,8,5
44568,44568,44569,8,1,-7
44569,44569,44570,1,7,6
44570,44570,44571,7,6,-1
44571,44571,44572,6,7,1
44572,44572,44573,7,7,0
44573,44573,44574,7,7,0
44574,44574,44575,7,3,-4
44575,44575,44576,3,8,5
44576,44576,44577,8,7,-1
44577,44577,44578,7,0,-7
44578,44578,44579,0,8,8
44579,44579,44580,8,3,-5
44580,44580,44581,3,4,1
44581,44581,44582,4,1,-3
44582,44582,44583,1,0,-1
44583,44583,44584,0,4,4
44584,44584,44585,4,2,-2
44585,44585,44586,2,9,7
44586,44586,44587,9,4,-5
44587,44587,44588,4,7,3
44588,44588,44589,7,0,-7
44589,44589,44590,0,7,7
44590,44590,44591,7,2,-5
44591,44591,44592,2,9,7
44592,44592,44593,9,4,-5
44593,44593,44594,4,4,0
44594,44594,44595,4,7,3
44595,44595,44596,7,3,-4
44596,44596,44597,3,8,5
44597,44597,44598,8,0,-8
44598,44598,44599,0,0,0
44599,44599,44600,0,9,9
44600,44600,44601,9,7,-2
44601,44601,44602,7,6,-1
44602,44602,44603,6,0,-6
44603,44603,44604,0,8,8
44604,44604,44605,8,6,-2
44605,44605,44606,6,0,-6
44606,44606,44607,0,9,9
44607,44607,44608,9,3,-6
44608,44608,44609,3,3,0
44609,44609,44610,3,7,4
44610,44610,44611,7,2,-5
44611,44611,44612,2,2,0
44612,44612,44613,2,4,2
44613,44613,44614,4,0,-4
44614,44614,44615,0,8,8
44615,44615,44616,8,8,0
44616,44616,44617,8,6,-2
44617,44617,44618,6,9,3
44618,44618,44619,9,0,-9
44619,44619,44620,0,4,4
44620,44620,44621,4,5,1
44621,44621,44622,5,1,-4
44622,44622,44623,1,7,6
44623,44623,44624,7,8,1
44624,44624,44625,8,5,-3
44625,44625,44626,5,7,2
44626,44626,44627,7,1,-6
44627,44627,44628,1,1,0
44628,44628,44629,1,0,-1
44629,44629,44630,0,3,3
44630,44630,44631,3,8,5
44631,44631,44632,8,4,-4
44632,44632,44633,4,1,-3
44633,44633,44634,1,5,4
44634,44634,44635,5,6,1
44635,44635,44636,6,4,-2
44636,44636,44637,4,7,3
44637,44637,44638,7,8,1
44638,44638,44639,8,2,-6
44639,44639,44640,2,7,5
44640,44640,44641,7,9,2
44641,44641,44642,9,5,-4
44642,44642,44643,5,7,2
44643,44643,44644,7,6,-1
44644,44644,44645,6,9,3
44645,44645,44646,9,4,-5
44646,44646,44647,4,5,1
44647,44647,44648,5,1,-4
44648,44648,44649,1,6,5
44649,44649,44650,6,1,-5
44650,44650,44651,1,5,4
44651,44651,44652,5,8,3
44652,44652,44653,8,2,-6
44653,44653,44654,2,8,6
44654,44654,44655,8,6,-2
44655,44655,44656,6,0,-6
44656,44656,44657,0,2,2
44657,44657,44658,2,7,5
44658,44658,44659,7,8,1
44659,44659,44660,8,0,-8
44660,44660,44661,0,1,1
44661,44661,44662,1,5,4
44662,44662,44663,5,7,2
44663,44663,44664,7,5,-2
44664,44664,44665,5,5,0
44665,44665,44666,5,6,1
44666,44666,44667,6,5,-1
44667,44667,44668,5,4,-1
44668,44668,44669,4,7,3
44669,44669,44670,7,9,2
44670,44670,44671,9,3,-6
44671,44671,44672,3,2,-1
44672,44672,44673,2,5,3
44673,44673,44674,5,5,0
44674,44674,44675,5,0,-5
44675,44675,44676,0,8,8
44676,44676,44677,8,1,-7
44677,44677,44678,1,9,8
44678,44678,44679,9,1,-8
44679,44679,44680,1,1,0
44680,44680,44681,1,3,2
44681,44681,44682,3,1,-2
44682,44682,44683,1,8,7
44683,44683,44684,8,3,-5
44684,44684,44685,3,4,1
44685,44685,44686,4,8,4
44686,44686,44687,8,9,1
44687,44687,44688,9,4,-5
44688,44688,44689,4,4,0
44689,44689,44690,4,6,2
44690,44690,44691,6,5,-1
44691,44691,44692,5,0,-5
44692,44692,44693,0,1,1
44693,44693,44694,1,4,3
44694,44694,44695,4,8,4
44695,44695,44696,8,0,-8
44696,44696,44697,0,6,6
44697,44697,44698,6,1,-5
44698,44698,44699,1,8,7
44699,44699,44700,8,0,-8
44700,44700,44701,0,9,9
44701,44701,44702,9,8,-1
44702,44702,44703,8,0,-8
44703,44703,44704,0,0,0
44704,44704,44705,0,1,1
44705,44705,44706,1,5,4
44706,44706,44707,5,2,-3
44707,44707,44708,2,7,5
44708,44708,44709,7,3,-4
44709,44709,44710,3,2,-1
44710,44710,44711,2,4,2
44711,44711,44712,4,4,0
44712,44712,44713,4,5,1
44713,44713,44714,5,8,3
44714,44714,44715,8,6,-2
44715,44715,44716,6,3,-3
44716,44716,44717,3,7,4
44717,44717,44718,7,2,-5
44718,44718,44719,2,8,6
44719,44719,44720,8,0,-8
44720,44720,44721,0,9,9
44721,44721,44722,9,6,-3
44722,44722,44723,6,0,-6
44723,44723,44724,0,1,1
44724,44724,44725,1,1,0
44725,44725,44726,1,7,6
44726,44726,44727,7,2,-5
44727,44727,44728,2,6,4
44728,44728,44729,6,3,-3
44729,44729,44730,3,0,-3
44730,44730,44731,0,4,4
44731,44731,44732,4,6,2
44732,44732,44733,6,5,-1
44733,44733,44734,5,7,2
44734,44734,44735,7,6,-1
44735,44735,44736,6,5,-1
44736,44736,44737,5,7,2
44737,44737,44738,7,5,-2
44738,44738,44739,5,8,3
44739,44739,44740,8,2,-6
44740,44740,44741,2,9,7
44741,44741,44742,9,6,-3
44742,44742,44743,6,0,-6
44743,44743,44744,0,0,0
44744,44744,44745,0,1,1
44745,44745,44746,1,9,8
44746,44746,44747,9,2,-7
44747,44747,44748,2,8,6
44748,44748,44749,8,3,-5
44749,44749,44750,3,0,-3
44750,44750,44751,0,4,4
44751,44751,44752,4,5,1
44752,44752,44753,5,5,0
44753,44753,44754,5,6,1
44754,44754,44755,6,6,0
44755,44755,44756,6,7,1
44756,44756,44757,7,7,0
44757,44757,44758,7,2,-5
44758,44758,44759,2,8,6
44759,44759,44760,8,5,-3
44760,44760,44761,5,4,-1
44761,44761,44762,4,9,5
44762,44762,44763,9,9,0
44763,44763,44764,9,3,-6
44764,44764,44765,3,4,1
44765,44765,44766,4,0,-4
44766,44766,44767,0,2,2
44767,44767,44768,2,0,-2
44768,44768,44769,0,9,9
44769,44769,44770,9,1,-8
44770,44770,44771,1,4,3
44771,44771,44772,4,7,3
44772,44772,44773,7,5,-2
44773,44773,44774,5,7,2
44774,44774,44775,7,8,1
44775,44775,44776,8,9,1
44776,44776,44777,9,0,-9
44777,44777,44778,0,9,9
44778,44778,44779,9,3,-6
44779,44779,44780,3,9,6
44780,44780,44781,9,5,-4
44781,44781,44782,5,3,-2
44782,44782,44783,3,5,2
44783,44783,44784,5,2,-3
44784,44784,44785,2,1,-1
44785,44785,44786,1,1,0
44786,44786,44787,1,7,6
44787,44787,44788,7,0,-7
44788,44788,44789,0,8,8
44789,44789,44790,8,6,-2
44790,44790,44791,6,4,-2
44791,44791,44792,4,1,-3
44792,44792,44793,1,5,4
44793,44793,44794,5,2,-3
44794,44794,44795,2,7,5
44795,44795,44796,7,0,-7
44796,44796,44797,0,2,2
44797,44797,44798,2,4,2
44798,44798,44799,4,3,-1
44799,44799,44800,3,1,-2
44800,44800,44801,1,6,5
44801,44801,44802,6,5,-1
44802,44802,44803,5,7,2
44803,44803,44804,7,5,-2
44804,44804,44805,5,7,2
44805,44805,44806,7,8,1
44806,44806,44807,8,7,-1
44807,44807,44808,7,6,-1
44808,44808,44809,6,6,0
44809,44809,44810,6,5,-1
44810,44810,44811,5,0,-5
44811,44811,44812,0,8,8
44812,44812,44813,8,1,-7
44813,44813,44814,1,6,5
44814,44814,44815,6,0,-6
44815,44815,44816,0,5,5
44816,44816,44817,5,6,1
44817,44817,44818,6,7,1
44818,44818,44819,7,5,-2
44819,44819,44820,5,5,0
44820,44820,44821,5,5,0
44821,44821,44822,5,9,4
44822,44822,44823,9,2,-7
44823,44823,44824,2,9,7
44824,44824,44825,9,9,0
44825,44825,44826,9,0,-9
44826,44826,44827,0,3,3
44827,44827,44828,3,2,-1
44828,44828,44829,2,1,-1
44829,44829,44830,1,5,4
44830,44830,44831,5,4,-1
44831,44831,44832,4,7,3
44832,44832,44833,7,8,1
44833,44833,44834,8,8,0
44834,44834,44835,8,7,-1
44835,44835,44836,7,7,0
44836,44836,44837,7,3,-4
44837,44837,44838,3,0,-3
44838,44838,44839,0,8,8
44839,44839,44840,8,7,-1
44840,44840,44841,7,2,-5
44841,44841,44842,2,4,2
44842,44842,44843,4,6,2
44843,44843,44844,6,0,-6
44844,44844,44845,0,5,5
44845,44845,44846,5,0,-5
44846,44846,44847,0,2,2
44847,44847,44848,2,3,1
44848,44848,44849,3,7,4
44849,44849,44850,7,4,-3
44850,44850,44851,4,9,5
44851,44851,44852,9,5,-4
44852,44852,44853,5,7,2
44853,44853,44854,7,9,2
44854,44854,44855,9,9,0
44855,44855,44856,9,1,-8
44856,44856,44857,1,1,0
44857,44857,44858,1,5,4
44858,44858,44859,5,0,-5
44859,44859,44860,0,4,4
44860,44860,44861,4,8,4
44861,44861,44862,8,0,-8
44862,44862,44863,0,9,9
44863,44863,44864,9,1,-8
44864,44864,44865,1,7,6
44865,44865,44866,7,8,1
44866,44866,44867,8,0,-8
44867,44867,44868,0,7,7
44868,44868,44869,7,5,-2
44869,44869,44870,5,6,1
44870,44870,44871,6,0,-6
44871,44871,44872,0,0,0
44872,44872,44873,0,3,3
44873,44873,44874,3,8,5
44874,44874,44875,8,8,0
44875,44875,44876,8,1,-7
44876,44876,44877,1,4,3
44877,44877,44878,4,9,5
44878,44878,44879,9,6,-3
44879,44879,44880,6,8,2
44880,44880,44881,8,2,-6
44881,44881,44882,2,9,7
44882,44882,44883,9,0,-9
44883,44883,44884,0,9,9
44884,44884,44885,9,4,-5
44885,44885,44886,4,1,-3
44886,44886,44887,1,1,0
44887,44887,44888,1,3,2
44888,44888,44889,3,3,0
44889,44889,44890,3,9,6
44890,44890,44891,9,1,-8
44891,44891,44892,1,9,8
44892,44892,44893,9,0,-9
44893,44893,44894,0,4,4
44894,44894,44895,4,9,5
44895,44895,44896,9,7,-2
44896,44896,44897,7,0,-7
44897,44897,44898,0,2,2
44898,44898,44899,2,1,-1
44899,44899,44900,1,0,-1
44900,44900,44901,0,2,2
44901,44901,44902,2,2,0
44902,44902,44903,2,3,1
44903,44903,44904,3,4,1
44904,44904,44905,4,4,0
44905,44905,44906,4,3,-1
44906,44906,44907,3,5,2
44907,44907,44908,5,7,2
44908,44908,44909,7,6,-1
44909,44909,44910,6,5,-1
44910,44910,44911,5,7,2
44911,44911,44912,7,7,0
44912,44912,44913,7,8,1
44913,44913,44914,8,7,-1
44914,44914,44915,7,9,2
44915,44915,44916,9,5,-4
44916,44916,44917,5,0,-5
44917,44917,44918,0,8,8
44918,44918,44919,8,1,-7
44919,44919,44920,1,7,6
44920,44920,44921,7,4,-3
44921,44921,44922,4,4,0
44922,44922,44923,4,5,1
44923,44923,44924,5,5,0
44924,44924,44925,5,6,1
44925,44925,44926,6,9,3
44926,44926,44927,9,7,-2
44927,44927,44928,7,5,-2
44928,44928,44929,5,8,3
44929,44929,44930,8,5,-3
44930,44930,44931,5,9,4
44931,44931,44932,9,6,-3
44932,44932,44933,6,0,-6
44933,44933,44934,0,2,2
44934,44934,44935,2,1,-1
44935,44935,44936,1,9,8
44936,44936,44937,9,4,-5
44937,44937,44938,4,5,1
44938,44938,44939,5,5,0
44939,44939,44940,5,7,2
44940,44940,44941,7,6,-1
44941,44941,44942,6,4,-2
44942,44942,44943,4,7,3
44943,44943,44944,7,8,1
44944,44944,44945,8,8,0
44945,44945,44946,8,9,1
44946,44946,44947,9,9,0
44947,44947,44948,9,9,0
44948,44948,44949,9,7,-2
44949,44949,44950,7,2,-5
44950,44950,44951,2,0,-2
44951,44951,44952,0,6,6
44952,44952,44953,6,6,0
44953,44953,44954,6,7,1
44954,44954,44955,7,0,-7
44955,44955,44956,0,4,4
44956,44956,44957,4,7,3
44957,44957,44958,7,0,-7
44958,44958,44959,0,3,3
44959,44959,44960,3,4,1
44960,44960,44961,4,8,4
44961,44961,44962,8,9,1
44962,44962,44963,9,6,-3
44963,44963,44964,6,5,-1
44964,44964,44965,5,7,2
44965,44965,44966,7,1,-6
44966,44966,44967,1,1,0
44967,44967,44968,1,8,7
44968,44968,44969,8,3,-5
44969,44969,44970,3,5,2
44970,44970,44971,5,7,2
44971,44971,44972,7,7,0
44972,44972,44973,7,9,2
44973,44973,44974,9,8,-1
44974,44974,44975,8,7,-1
44975,44975,44976,7,5,-2
44976,44976,44977,5,4,-1
44977,44977,44978,4,2,-2
44978,44978,44979,2,0,-2
44979,44979,44980,0,8,8
44980,44980,44981,8,6,-2
44981,44981,44982,6,9,3
44982,44982,44983,9,4,-5
44983,44983,44984,4,6,2
44984,44984,44985,6,9,3
44985,44985,44986,9,1,-8
44986,44986,44987,1,5,4
44987,44987,44988,5,1,-4
44988,44988,44989,1,6,5
44989,44989,44990,6,4,-2
44990,44990,44991,4,5,1
44991,44991,44992,5,9,4
44992,44992,44993,9,2,-7
44993,44993,44994,2,1,-1
44994,44994,44995,1,9,8
44995,44995,44996,9,1,-8
44996,44996,44997,1,8,7
44997,44997,44998,8,4,-4
44998,44998,44999,4,5,1
44999,44999,45000,5,3,-2
45000,45000,45001,3,1,-2
45001,45001,45002,1,1,0
45002,45002,45003,1,5,4
45003,45003,45004,5,7,2
45004,45004,45005,7,3,-4
45005,45005,45006,3,1,-2
45006,45006,45007,1,9,8
45007,45007,45008,9,3,-6
45008,45008,45009,3,4,1
45009,45009,45010,4,6,2
45010,45010,45011,6,5,-1
45011,45011,45012,5,5,0
45012,45012,45013,5,6,1
45013,45013,45014,6,7,1
45014,45014,45015,7,3,-4
45015,45015,45016,3,8,5
45016,45016,45017,8,4,-4
45017,45017,45018,4,5,1
45018,45018,45019,5,8,3
45019,45019,45020,8,7,-1
45020,45020,45021,7,0,-7
45021,45021,45022,0,2,2
45022,45022,45023,2,6,4
45023,45023,45024,6,5,-1
45024,45024,45025,5,4,-1
45025,45025,45026,4,8,4
45026,45026,45027,8,8,0
45027,45027,45028,8,2,-6
45028,45028,45029,2,1,-1
45029,45029,45030,1,6,5
45030,45030,45031,6,3,-3
45031,45031,45032,3,1,-2
45032,45032,45033,1,4,3
45033,45033,45034,4,9,5
45034,45034,45035,9,0,-9
45035,45035,45036,0,5,5
45036,45036,45037,5,1,-4
45037,45037,45038,1,4,3
45038,45038,45039,4,9,5
45039,45039,45040,9,7,-2
45040,45040,45041,7,2,-5
45041,45041,45042,2,0,-2
45042,45042,45043,0,3,3
45043,45043,45044,3,9,6
45044,45044,45045,9,7,-2
45045,45045,45046,7,3,-4
45046,45046,45047,3,2,-1
45047,45047,45048,2,4,2
45048,45048,45049,4,5,1
45049,45049,45050,5,8,3
45050,45050,45051,8,1,-7
45051,45051,45052,1,5,4
45052,45052,45053,5,7,2
45053,45053,45054,7,7,0
45054,45054,45055,7,2,-5
45055,45055,45056,2,8,6
45056,45056,45057,8,8,0
45057,45057,45058,8,0,-8
45058,45058,45059,0,7,7
45059,45059,45060,7,7,0
45060,45060,45061,7,0,-7
45061,45061,45062,0,9,9
45062,45062,45063,9,1,-8
45063,45063,45064,1,4,3
45064,45064,45065,4,9,5
45065,45065,45066,9,0,-9
45066,45066,45067,0,6,6
45067,45067,45068,6,7,1
45068,45068,45069,7,4,-3
45069,45069,45070,4,5,1
45070,45070,45071,5,9,4
45071,45071,45072,9,5,-4
45072,45072,45073,5,2,-3
45073,45073,45074,2,9,7
45074,45074,45075,9,1,-8
45075,45075,45076,1,1,0
45076,45076,45077,1,2,1
45077,45077,45078,2,1,-1
45078,45078,45079,1,3,2
45079,45079,45080,3,6,3
45080,45080,45081,6,7,1
45081,45081,45082,7,8,1
45082,45082,45083,8,0,-8
45083,45083,45084,0,9,9
45084,45084,45085,9,2,-7
45085,45085,45086,2,9,7
45086,45086,45087,9,1,-8
45087,45087,45088,1,3,2
45088,45088,45089,3,3,0
45089,45089,45090,3,6,3
45090,45090,45091,6,5,-1
45091,45091,45092,5,1,-4
45092,45092,45093,1,3,2
45093,45093,45094,3,2,-1
45094,45094,45095,2,4,2
45095,45095,45096,4,2,-2
45096,45096,45097,2,7,5
45097,45097,45098,7,8,1
45098,45098,45099,8,2,-6
45099,45099,45100,2,4,2
45100,45100,45101,4,5,1
45101,45101,45102,5,7,2
45102,45102,45103,7,8,1
45103,45103,45104,8,6,-2
45104,45104,45105,6,1,-5
45105,45105,45106,1,8,7
45106,45106,45107,8,6,-2
45107,45107,45108,6,3,-3
45108,45108,45109,3,8,5
45109,45109,45110,8,8,0
45110,45110,45111,8,5,-3
45111,45111,45112,5,0,-5
45112,45112,45113,0,6,6
45113,45113,45114,6,7,1
45114,45114,45115,7,0,-7
45115,45115,45116,0,8,8
45116,45116,45117,8,8,0
45117,45117,45118,8,5,-3
45118,45118,45119,5,9,4
45119,45119,45120,9,9,0
45120,45120,45121,9,4,-5
45121,45121,45122,4,8,4
45122,45122,45123,8,9,1
45123,45123,45124,9,5,-4
45124,45124,45125,5,2,-3
45125,45125,45126,2,0,-2
45126,45126,45127,0,6,6
45127,45127,45128,6,0,-6
45128,45128,45129,0,0,0
45129,45129,45130,0,2,2
45130,45130,45131,2,1,-1
45131,45131,45132,1,5,4
45132,45132,45133,5,2,-3
45133,45133,45134,2,5,3
45134,45134,45135,5,3,-2
45135,45135,45136,3,2,-1
45136,45136,45137,2,4,2
45137,45137,45138,4,6,2
45138,45138,45139,6,5,-1
45139,45139,45140,5,1,-4
45140,45140,45141,1,6,5
45141,45141,45142,6,9,3
45142,45142,45143,9,7,-2
45143,45143,45144,7,9,2
45144,45144,45145,9,0,-9
45145,45145,45146,0,0,0
45146,45146,45147,0,1,1
45147,45147,45148,1,4,3
45148,45148,45149,4,2,-2
45149,45149,45150,2,3,1
45150,45150,45151,3,3,0
45151,45151,45152,3,0,-3
45152,45152,45153,0,4,4
45153,45153,45154,4,6,2
45154,45154,45155,6,5,-1
45155,45155,45156,5,8,3
45156,45156,45157,8,6,-2
45157,45157,45158,6,2,-4
45158,45158,45159,2,7,5
45159,45159,45160,7,5,-2
45160,45160,45161,5,8,3
45161,45161,45162,8,0,-8
45162,45162,45163,0,9,9
45163,45163,45164,9,3,-6
45164,45164,45165,3,0,-3
45165,45165,45166,0,5,5
45166,45166,45167,5,1,-4
45167,45167,45168,1,8,7
45168,45168,45169,8,2,-6
45169,45169,45170,2,7,5
45170,45170,45171,7,3,-4
45171,45171,45172,3,4,1
45172,45172,45173,4,4,0
45173,45173,45174,4,9,5
45174,45174,45175,9,5,-4
45175,45175,45176,5,9,4
45176,45176,45177,9,6,-3
45177,45177,45178,6,9,3
45178,45178,45179,9,7,-2
45179,45179,45180,7,7,0
45180,45180,45181,7,8,1
45181,45181,45182,8,1,-7
45182,45182,45183,1,9,8
45183,45183,45184,9,4,-5
45184,45184,45185,4,7,3
45185,45185,45186,7,1,-6
45186,45186,45187,1,7,6
45187,45187,45188,7,7,0
45188,45188,45189,7,0,-7
45189,45189,45190,0,0,0
45190,45190,45191,0,4,4
45191,45191,45192,4,7,3
45192,45192,45193,7,0,-7
45193,45193,45194,0,8,8
45194,45194,45195,8,3,-5
45195,45195,45196,3,3,0
45196,45196,45197,3,1,-2
45197,45197,45198,1,4,3
45198,45198,45199,4,8,4
45199,45199,45200,8,7,-1
45200,45200,45201,7,9,2
45201,45201,45202,9,8,-1
45202,45202,45203,8,2,-6
45203,45203,45204,2,1,-1
45204,45204,45205,1,1,0
45205,45205,45206,1,2,1
45206,45206,45207,2,8,6
45207,45207,45208,8,8,0
45208,45208,45209,8,6,-2
45209,45209,45210,6,4,-2
45210,45210,45211,4,5,1
45211,45211,45212,5,5,0
45212,45212,45213,5,4,-1
45213,45213,45214,4,4,0
45214,45214,45215,4,7,3
45215,45215,45216,7,2,-5
45216,45216,45217,2,3,1
45217,45217,45218,3,0,-3
45218,45218,45219,0,4,4
45219,45219,45220,4,1,-3
45220,45220,45221,1,1,0
45221,45221,45222,1,5,4
45222,45222,45223,5,8,3
45223,45223,45224,8,6,-2
45224,45224,45225,6,6,0
45225,45225,45226,6,5,-1
45226,45226,45227,5,9,4
45227,45227,45228,9,6,-3
45228,45228,45229,6,1,-5
45229,45229,45230,1,0,-1
45230,45230,45231,0,4,4
45231,45231,45232,4,9,5
45232,45232,45233,9,5,-4
45233,45233,45234,5,4,-1
45234,45234,45235,4,0,-4
45235,45235,45236,0,9,9
45236,45236,45237,9,1,-8
45237,45237,45238,1,4,3
45238,45238,45239,4,3,-1
45239,45239,45240,3,1,-2
45240,45240,45241,1,6,5
45241,45241,45242,6,9,3
45242,45242,45243,9,4,-5
45243,45243,45244,4,9,5
45244,45244,45245,9,8,-1
45245,45245,45246,8,3,-5
45246,45246,45247,3,9,6
45247,45247,45248,9,6,-3
45248,45248,45249,6,8,2
45249,45249,45250,8,5,-3
45250,45250,45251,5,2,-3
45251,45251,45252,2,4,2
45252,45252,45253,4,1,-3
45253,45253,45254,1,1,0
45254,45254,45255,1,0,-1
45255,45255,45256,0,5,5
45256,45256,45257,5,7,2
45257,45257,45258,7,7,0
45258,45258,45259,7,2,-5
45259,45259,45260,2,3,1
45260,45260,45261,3,5,2
45261,45261,45262,5,6,1
45262,45262,45263,6,5,-1
45263,45263,45264,5,3,-2
45264,45264,45265,3,6,3
45265,45265,45266,6,3,-3
45266,45266,45267,3,6,3
45267,45267,45268,6,2,-4
45268,45268,45269,2,6,4
45269,45269,45270,6,8,2
45270,45270,45271,8,3,-5
45271,45271,45272,3,3,0
45272,45272,45273,3,3,0
45273,45273,45274,3,6,3
45274,45274,45275,6,3,-3
45275,45275,45276,3,0,-3
45276,45276,45277,0,1,1
45277,45277,45278,1,4,3
45278,45278,45279,4,7,3
45279,45279,45280,7,4,-3
45280,45280,45281,4,2,-2
45281,45281,45282,2,5,3
45282,45282,45283,5,2,-3
45283,45283,45284,2,1,-1
45284,45284,45285,1,7,6
45285,45285,45286,7,8,1
45286,45286,45287,8,2,-6
45287,45287,45288,2,0,-2
45288,45288,45289,0,3,3
45289,45289,45290,3,1,-2
45290,45290,45291,1,6,5
45291,45291,45292,6,5,-1
45292,45292,45293,5,8,3
45293,45293,45294,8,6,-2
45294,45294,45295,6,5,-1
45295,45295,45296,5,4,-1
45296,45296,45297,4,1,-3
45297,45297,45298,1,8,7
45298,45298,45299,8,4,-4
45299,45299,45300,4,6,2
45300,45300,45301,6,9,3
45301,45301,45302,9,1,-8
45302,45302,45303,1,0,-1
45303,45303,45304,0,9,9
45304,45304,45305,9,5,-4
45305,45305,45306,5,2,-3
45306,45306,45307,2,0,-2
45307,45307,45308,0,9,9
45308,45308,45309,9,6,-3
45309,45309,45310,6,7,1
45310,45310,45311,7,8,1
45311,45311,45312,8,3,-5
45312,45312,45313,3,8,5
45313,45313,45314,8,7,-1
45314,45314,45315,7,0,-7
45315,45315,45316,0,4,4
45316,45316,45317,4,8,4
45317,45317,45318,8,4,-4
45318,45318,45319,4,2,-2
45319,45319,45320,2,1,-1
45320,45320,45321,1,3,2
45321,45321,45322,3,9,6
45322,45322,45323,9,9,0
45323,45323,45324,9,6,-3
45324,45324,45325,6,4,-2
45325,45325,45326,4,8,4
45326,45326,45327,8,3,-5
45327,45327,45328,3,3,0
45328,45328,45329,3,7,4
45329,45329,45330,7,4,-3
45330,45330,45331,4,1,-3
45331,45331,45332,1,2,1
45332,45332,45333,2,7,5
45333,45333,45334,7,5,-2
45334,45334,45335,5,6,1
45335,45335,45336,6,3,-3
45336,45336,45337,3,9,6
45337,45337,45338,9,6,-3
45338,45338,45339,6,4,-2
45339,45339,45340,4,3,-1
45340,45340,45341,3,2,-1
45341,45341,45342,2,2,0
45342,45342,45343,2,9,7
45343,45343,45344,9,5,-4
45344,45344,45345,5,9,4
45345,45345,45346,9,2,-7
45346,45346,45347,2,2,0
45347,45347,45348,2,2,0
45348,45348,45349,2,0,-2
45349,45349,45350,0,2,2
45350,45350,45351,2,8,6
45351,45351,45352,8,9,1
45352,45352,45353,9,4,-5
45353,45353,45354,4,0,-4
45354,45354,45355,0,9,9
45355,45355,45356,9,8,-1
45356,45356,45357,8,4,-4
45357,45357,45358,4,2,-2
45358,45358,45359,2,0,-2
45359,45359,45360,0,5,5
45360,45360,45361,5,7,2
45361,45361,45362,7,2,-5
45362,45362,45363,2,1,-1
45363,45363,45364,1,3,2
45364,45364,45365,3,3,0
45365,45365,45366,3,1,-2
45366,45366,45367,1,2,1
45367,45367,45368,2,6,4
45368,45368,45369,6,9,3
45369,45369,45370,9,9,0
45370,45370,45371,9,0,-9
45371,45371,45372,0,1,1
45372,45372,45373,1,1,0
45373,45373,45374,1,7,6
45374,45374,45375,7,2,-5
45375,45375,45376,2,6,4
45376,45376,45377,6,3,-3
45377,45377,45378,3,2,-1
45378,45378,45379,2,8,6
45379,45379,45380,8,9,1
45380,45380,45381,9,9,0
45381,45381,45382,9,7,-2
45382,45382,45383,7,0,-7
45383,45383,45384,0,0,0
45384,45384,45385,0,1,1
45385,45385,45386,1,0,-1
45386,45386,45387,0,2,2
45387,45387,45388,2,9,7
45388,45388,45389,9,3,-6
45389,45389,45390,3,5,2
45390,45390,45391,5,4,-1
45391,45391,45392,4,7,3
45392,45392,45393,7,5,-2
45393,45393,45394,5,4,-1
45394,45394,45395,4,6,2
45395,45395,45396,6,3,-3
45396,45396,45397,3,7,4
45397,45397,45398,7,3,-4
45398,45398,45399,3,8,5
45399,45399,45400,8,3,-5
45400,45400,45401,3,0,-3
45401,45401,45402,0,0,0
45402,45402,45403,0,1,1
45403,45403,45404,1,4,3
45404,45404,45405,4,2,-2
45405,45405,45406,2,2,0
45406,45406,45407,2,3,1
45407,45407,45408,3,3,0
45408,45408,45409,3,6,3
45409,45409,45410,6,6,0
45410,45410,45411,6,7,1
45411,45411,45412,7,2,-5
45412,45412,45413,2,8,6
45413,45413,45414,8,2,-6
45414,45414,45415,2,9,7
45415,45415,45416,9,8,-1
45416,45416,45417,8,0,-8
45417,45417,45418,0,0,0
45418,45418,45419,0,3,3
45419,45419,45420,3,2,-1
45420,45420,45421,2,9,7
45421,45421,45422,9,0,-9
45422,45422,45423,0,5,5
45423,45423,45424,5,4,-1
45424,45424,45425,4,6,2
45425,45425,45426,6,0,-6
45426,45426,45427,0,8,8
45427,45427,45428,8,7,-1
45428,45428,45429,7,4,-3
45429,45429,45430,4,2,-2
45430,45430,45431,2,9,7
45431,45431,45432,9,5,-4
45432,45432,45433,5,1,-4
45433,45433,45434,1,0,-1
45434,45434,45435,0,7,7
45435,45435,45436,7,3,-4
45436,45436,45437,3,1,-2
45437,45437,45438,1,1,0
45438,45438,45439,1,2,1
45439,45439,45440,2,9,7
45440,45440,45441,9,3,-6
45441,45441,45442,3,0,-3
45442,45442,45443,0,5,5
45443,45443,45444,5,1,-4
45444,45444,45445,1,9,8
45445,45445,45446,9,7,-2
45446,45446,45447,7,6,-1
45447,45447,45448,6,6,0
45448,45448,45449,6,9,3
45449,45449,45450,9,9,0
45450,45450,45451,9,1,-8
45451,45451,45452,1,5,4
45452,45452,45453,5,2,-3
45453,45453,45454,2,8,6
45454,45454,45455,8,0,-8
45455,45455,45456,0,7,7
45456,45456,45457,7,7,0
45457,45457,45458,7,8,1
45458,45458,45459,8,2,-6
45459,45459,45460,2,6,4
45460,45460,45461,6,9,3
45461,45461,45462,9,2,-7
45462,45462,45463,2,8,6
45463,45463,45464,8,2,-6
45464,45464,45465,2,9,7
45465,45465,45466,9,7,-2
45466,45466,45467,7,0,-7
45467,45467,45468,0,3,3
45468,45468,45469,3,7,4
45469,45469,45470,7,5,-2
45470,45470,45471,5,1,-4
45471,45471,45472,1,4,3
45472,45472,45473,4,3,-1
45473,45473,45474,3,3,0
45474,45474,45475,3,0,-3
45475,45475,45476,0,0,0
45476,45476,45477,0,3,3
45477,45477,45478,3,6,3
45478,45478,45479,6,6,0
45479,45479,45480,6,3,-3
45480,45480,45481,3,8,5
45481,45481,45482,8,5,-3
45482,45482,45483,5,7,2
45483,45483,45484,7,2,-5
45484,45484,45485,2,4,2
45485,45485,45486,4,2,-2
45486,45486,45487,2,9,7
45487,45487,45488,9,2,-7
45488,45488,45489,2,7,5
45489,45489,45490,7,5,-2
45490,45490,45491,5,5,0
45491,45491,45492,5,7,2
45492,45492,45493,7,8,1
45493,45493,45494,8,0,-8
45494,45494,45495,0,1,1
45495,45495,45496,1,7,6
45496,45496,45497,7,5,-2
45497,45497,45498,5,2,-3
45498,45498,45499,2,1,-1
45499,45499,45500,1,2,1
45500,45500,45501,2,2,0
45501,45501,45502,2,1,-1
45502,45502,45503,1,0,-1
45503,45503,45504,0,0,0
45504,45504,45505,0,2,2
45505,45505,45506,2,6,4
45506,45506,45507,6,4,-2
45507,45507,45508,4,3,-1
45508,45508,45509,3,3,0
45509,45509,45510,3,6,3
45510,45510,45511,6,0,-6
45511,45511,45512,0,5,5
45512,45512,45513,5,0,-5
45513,45513,45514,0,6,6
45514,45514,45515,6,0,-6
45515,45515,45516,0,1,1
45516,45516,45517,1,3,2
45517,45517,45518,3,7,4
45518,45518,45519,7,5,-2
45519,45519,45520,5,8,3
45520,45520,45521,8,7,-1
45521,45521,45522,7,0,-7
45522,45522,45523,0,6,6
45523,45523,45524,6,7,1
45524,45524,45525,7,9,2
45525,45525,45526,9,5,-4
45526,45526,45527,5,9,4
45527,45527,45528,9,9,0
45528,45528,45529,9,8,-1
45529,45529,45530,8,7,-1
45530,45530,45531,7,2,-5
45531,45531,45532,2,1,-1
45532,45532,45533,1,7,6
45533,45533,45534,7,5,-2
45534,45534,45535,5,7,2
45535,45535,45536,7,5,-2
45536,45536,45537,5,1,-4
45537,45537,45538,1,4,3
45538,45538,45539,4,0,-4
45539,45539,45540,0,0,0
45540,45540,45541,0,1,1
45541,45541,45542,1,6,5
45542,45542,45543,6,2,-4
45543,45543,45544,2,0,-2
45544,45544,45545,0,3,3
45545,45545,45546,3,1,-2
45546,45546,45547,1,5,4
45547,45547,45548,5,7,2
45548,45548,45549,7,6,-1
45549,45549,45550,6,4,-2
45550,45550,45551,4,7,3
45551,45551,45552,7,6,-1
45552,45552,45553,6,8,2
45553,45553,45554,8,3,-5
45554,45554,45555,3,9,6
45555,45555,45556,9,1,-8
45556,45556,45557,1,0,-1
45557,45557,45558,0,6,6
45558,45558,45559,6,1,-5
45559,45559,45560,1,4,3
45560,45560,45561,4,2,-2
45561,45561,45562,2,5,3
45562,45562,45563,5,3,-2
45563,45563,45564,3,4,1
45564,45564,45565,4,4,0
45565,45565,45566,4,6,2
45566,45566,45567,6,5,-1
45567,45567,45568,5,2,-3
45568,45568,45569,2,6,4
45569,45569,45570,6,7,1
45570,45570,45571,7,7,0
45571,45571,45572,7,1,-6
45572,45572,45573,1,8,7
45573,45573,45574,8,4,-4
45574,45574,45575,4,9,5
45575,45575,45576,9,8,-1
45576,45576,45577,8,0,-8
45577,45577,45578,0,4,4
45578,45578,45579,4,1,-3
45579,45579,45580,1,6,5
45580,45580,45581,6,6,0
45581,45581,45582,6,5,-1
45582,45582,45583,5,7,2
45583,45583,45584,7,2,-5
45584,45584,45585,2,8,6
45585,45585,45586,8,3,-5
45586,45586,45587,3,9,6
45587,45587,45588,9,1,-8
45588,45588,45589,1,0,-1
45589,45589,45590,0,4,4
45590,45590,45591,4,5,1
45591,45591,45592,5,7,2
45592,45592,45593,7,6,-1
45593,45593,45594,6,7,1
45594,45594,45595,7,8,1
45595,45595,45596,8,0,-8
45596,45596,45597,0,3,3
45597,45597,45598,3,1,-2
45598,45598,45599,1,3,2
45599,45599,45600,3,7,4
45600,45600,45601,7,3,-4
45601,45601,45602,3,5,2
45602,45602,45603,5,9,4
45603,45603,45604,9,5,-4
45604,45604,45605,5,9,4
45605,45605,45606,9,7,-2
45606,45606,45607,7,5,-2
45607,45607,45608,5,0,-5
45608,45608,45609,0,6,6
45609,45609,45610,6,3,-3
45610,45610,45611,3,4,1
45611,45611,45612,4,3,-1
45612,45612,45613,3,4,1
45613,45613,45614,4,6,2
45614,45614,45615,6,7,1
45615,45615,45616,7,5,-2
45616,45616,45617,5,0,-5
45617,45617,45618,0,7,7
45618,45618,45619,7,3,-4
45619,45619,45620,3,2,-1
45620,45620,45621,2,9,7
45621,45621,45622,9,6,-3
45622,45622,45623,6,6,0
45623,45623,45624,6,5,-1
45624,45624,45625,5,9,4
45625,45625,45626,9,7,-2
45626,45626,45627,7,1,-6
45627,45627,45628,1,3,2
45628,45628,45629,3,5,2
45629,45629,45630,5,6,1
45630,45630,45631,6,2,-4
45631,45631,45632,2,9,7
45632,45632,45633,9,6,-3
45633,45633,45634,6,6,0
45634,45634,45635,6,6,0
45635,45635,45636,6,3,-3
45636,45636,45637,3,7,4
45637,45637,45638,7,2,-5
45638,45638,45639,2,8,6
45639,45639,45640,8,6,-2
45640,45640,45641,6,1,-5
45641,45641,45642,1,3,2
45642,45642,45643,3,6,3
45643,45643,45644,6,3,-3
45644,45644,45645,3,7,4
45645,45645,45646,7,8,1
45646,45646,45647,8,8,0
45647,45647,45648,8,2,-6
45648,45648,45649,2,8,6
45649,45649,45650,8,1,-7
45650,45650,45651,1,1,0
45651,45651,45652,1,7,6
45652,45652,45653,7,8,1
45653,45653,45654,8,9,1
45654,45654,45655,9,3,-6
45655,45655,45656,3,3,0
45656,45656,45657,3,7,4
45657,45657,45658,7,3,-4
45658,45658,45659,3,1,-2
45659,45659,45660,1,8,7
45660,45660,45661,8,2,-6
45661,45661,45662,2,2,0
45662,45662,45663,2,7,5
45663,45663,45664,7,6,-1
45664,45664,45665,6,1,-5
45665,45665,45666,1,1,0
45666,45666,45667,1,5,4
45667,45667,45668,5,6,1
45668,45668,45669,6,0,-6
45669,45669,45670,0,4,4
45670,45670,45671,4,9,5
45671,45671,45672,9,2,-7
45672,45672,45673,2,8,6
45673,45673,45674,8,4,-4
45674,45674,45675,4,3,-1
45675,45675,45676,3,0,-3
45676,45676,45677,0,1,1
45677,45677,45678,1,8,7
45678,45678,45679,8,8,0
45679,45679,45680,8,7,-1
45680,45680,45681,7,4,-3
45681,45681,45682,4,0,-4
45682,45682,45683,0,1,1
45683,45683,45684,1,8,7
45684,45684,45685,8,4,-4
45685,45685,45686,4,6,2
45686,45686,45687,6,3,-3
45687,45687,45688,3,9,6
45688,45688,45689,9,9,0
45689,45689,45690,9,1,-8
45690,45690,45691,1,7,6
45691,45691,45692,7,8,1
45692,45692,45693,8,1,-7
45693,45693,45694,1,9,8
45694,45694,45695,9,0,-9
45695,45695,45696,0,3,3
45696,45696,45697,3,7,4
45697,45697,45698,7,2,-5
45698,45698,45699,2,3,1
45699,45699,45700,3,9,6
45700,45700,45701,9,0,-9
45701,45701,45702,0,6,6
45702,45702,45703,6,1,-5
45703,45703,45704,1,3,2
45704,45704,45705,3,2,-1
45705,45705,45706,2,8,6
45706,45706,45707,8,3,-5
45707,45707,45708,3,9,6
45708,45708,45709,9,4,-5
45709,45709,45710,4,8,4
45710,45710,45711,8,5,-3
45711,45711,45712,5,3,-2
45712,45712,45713,3,6,3
45713,45713,45714,6,2,-4
45714,45714,45715,2,7,5
45715,45715,45716,7,5,-2
45716,45716,45717,5,8,3
45717,45717,45718,8,4,-4
45718,45718,45719,4,9,5
45719,45719,45720,9,7,-2
45720,45720,45721,7,0,-7
45721,45721,45722,0,0,0
45722,45722,45723,0,1,1
45723,45723,45724,1,4,3
45724,45724,45725,4,2,-2
45725,45725,45726,2,5,3
45726,45726,45727,5,3,-2
45727,45727,45728,3,0,-3
45728,45728,45729,0,4,4
45729,45729,45730,4,1,-3
45730,45730,45731,1,5,4
45731,45731,45732,5,3,-2
45732,45732,45733,3,6,3
45733,45733,45734,6,3,-3
45734,45734,45735,3,7,4
45735,45735,45736,7,3,-4
45736,45736,45737,3,8,5
45737,45737,45738,8,8,0
45738,45738,45739,8,9,1
45739,45739,45740,9,4,-5
45740,45740,45741,4,0,-4
45741,45741,45742,0,6,6
45742,45742,45743,6,1,-5
45743,45743,45744,1,7,6
45744,45744,45745,7,2,-5
45745,45745,45746,2,8,6
45746,45746,45747,8,3,-5
45747,45747,45748,3,0,-3
45748,45748,45749,0,4,4
45749,45749,45750,4,6,2
45750,45750,45751,6,4,-2
45751,45751,45752,4,4,0
45752,45752,45753,4,5,1
45753,45753,45754,5,1,-4
45754,45754,45755,1,6,5
45755,45755,45756,6,9,3
45756,45756,45757,9,6,-3
45757,45757,45758,6,3,-3
45758,45758,45759,3,3,0
45759,45759,45760,3,0,-3
45760,45760,45761,0,4,4
45761,45761,45762,4,9,5
45762,45762,45763,9,2,-7
45763,45763,45764,2,3,1
45764,45764,45765,3,8,5
45765,45765,45766,8,0,-8
45766,45766,45767,0,1,1
45767,45767,45768,1,1,0
45768,45768,45769,1,0,-1
45769,45769,45770,0,5,5
45770,45770,45771,5,6,1
45771,45771,45772,6,8,2
45772,45772,45773,8,4,-4
45773,45773,45774,4,3,-1
45774,45774,45775,3,9,6
45775,45775,45776,9,7,-2
45776,45776,45777,7,7,0
45777,45777,45778,7,4,-3
45778,45778,45779,4,2,-2
45779,45779,45780,2,5,3
45780,45780,45781,5,3,-2
45781,45781,45782,3,1,-2
45782,45782,45783,1,3,2
45783,45783,45784,3,9,6
45784,45784,45785,9,9,0
45785,45785,45786,9,3,-6
45786,45786,45787,3,9,6
45787,45787,45788,9,4,-5
45788,45788,45789,4,3,-1
45789,45789,45790,3,1,-2
45790,45790,45791,1,3,2
45791,45791,45792,3,2,-1
45792,45792,45793,2,9,7
45793,45793,45794,9,4,-5
45794,45794,45795,4,1,-3
45795,45795,45796,1,3,2
45796,45796,45797,3,5,2
45797,45797,45798,5,8,3
45798,45798,45799,8,2,-6
45799,45799,45800,2,9,7
45800,45800,45801,9,3,-6
45801,45801,45802,3,8,5
45802,45802,45803,8,1,-7
45803,45803,45804,1,7,6
45804,45804,45805,7,6,-1
45805,45805,45806,6,7,1
45806,45806,45807,7,7,0
45807,45807,45808,7,5,-2
45808,45808,45809,5,3,-2
45809,45809,45810,3,9,6
45810,45810,45811,9,7,-2
45811,45811,45812,7,0,-7
45812,45812,45813,0,8,8
45813,45813,45814,8,3,-5
45814,45814,45815,3,4,1
45815,45815,45816,4,1,-3
45816,45816,45817,1,0,-1
45817,45817,45818,0,2,2
45818,45818,45819,2,2,0
45819,45819,45820,2,1,-1
45820,45820,45821,1,4,3
45821,45821,45822,4,3,-1
45822,45822,45823,3,0,-3
45823,45823,45824,0,9,9
45824,45824,45825,9,2,-7
45825,45825,45826,2,5,3
45826,45826,45827,5,4,-1
45827,45827,45828,4,9,5
45828,45828,45829,9,7,-2
45829,45829,45830,7,0,-7
45830,45830,45831,0,8,8
45831,45831,45832,8,2,-6
45832,45832,45833,2,0,-2
45833,45833,45834,0,4,4
45834,45834,45835,4,7,3
45835,45835,45836,7,3,-4
45836,45836,45837,3,0,-3
45837,45837,45838,0,2,2
45838,45838,45839,2,6,4
45839,45839,45840,6,0,-6
45840,45840,45841,0,9,9
45841,45841,45842,9,8,-1
45842,45842,45843,8,3,-5
45843,45843,45844,3,7,4
45844,45844,45845,7,2,-5
45845,45845,45846,2,6,4
45846,45846,45847,6,4,-2
45847,45847,45848,4,3,-1
45848,45848,45849,3,8,5
45849,45849,45850,8,3,-5
45850,45850,45851,3,6,3
45851,45851,45852,6,2,-4
45852,45852,45853,2,0,-2
45853,45853,45854,0,3,3
45854,45854,45855,3,1,-2
45855,45855,45856,1,6,5
45856,45856,45857,6,0,-6
45857,45857,45858,0,1,1
45858,45858,45859,1,8,7
45859,45859,45860,8,4,-4
45860,45860,45861,4,1,-3
45861,45861,45862,1,3,2
45862,45862,45863,3,6,3
45863,45863,45864,6,9,3
45864,45864,45865,9,7,-2
45865,45865,45866,7,8,1
45866,45866,45867,8,2,-6
45867,45867,45868,2,2,0
45868,45868,45869,2,9,7
45869,45869,45870,9,5,-4
45870,45870,45871,5,7,2
45871,45871,45872,7,5,-2
45872,45872,45873,5,9,4
45873,45873,45874,9,8,-1
45874,45874,45875,8,5,-3
45875,45875,45876,5,4,-1
45876,45876,45877,4,8,4
45877,45877,45878,8,3,-5
45878,45878,45879,3,9,6
45879,45879,45880,9,2,-7
45880,45880,45881,2,6,4
45881,45881,45882,6,8,2
45882,45882,45883,8,5,-3
45883,45883,45884,5,8,3
45884,45884,45885,8,2,-6
45885,45885,45886,2,5,3
45886,45886,45887,5,6,1
45887,45887,45888,6,9,3
45888,45888,45889,9,2,-7
45889,45889,45890,2,5,3
45890,45890,45891,5,8,3
45891,45891,45892,8,9,1
45892,45892,45893,9,1,-8
45893,45893,45894,1,5,4
45894,45894,45895,5,7,2
45895,45895,45896,7,8,1
45896,45896,45897,8,5,-3
45897,45897,45898,5,8,3
45898,45898,45899,8,5,-3
45899,45899,45900,5,1,-4
45900,45900,45901,1,7,6
45901,45901,45902,7,3,-4
45902,45902,45903,3,3,0
45903,45903,45904,3,2,-1
45904,45904,45905,2,0,-2
45905,45905,45906,0,2,2
45906,45906,45907,2,1,-1
45907,45907,45908,1,0,-1
45908,45908,45909,0,1,1
45909,45909,45910,1,6,5
45910,45910,45911,6,3,-3
45911,45911,45912,3,4,1
45912,45912,45913,4,8,4
45913,45913,45914,8,6,-2
45914,45914,45915,6,4,-2
45915,45915,45916,4,4,0
45916,45916,45917,4,9,5
45917,45917,45918,9,8,-1
45918,45918,45919,8,5,-3
45919,45919,45920,5,2,-3
45920,45920,45921,2,1,-1
45921,45921,45922,1,9,8
45922,45922,45923,9,8,-1
45923,45923,45924,8,5,-3
45924,45924,45925,5,9,4
45925,45925,45926,9,1,-8
45926,45926,45927,1,1,0
45927,45927,45928,1,4,3
45928,45928,45929,4,2,-2
45929,45929,45930,2,7,5
45930,45930,45931,7,1,-6
45931,45931,45932,1,2,1
45932,45932,45933,2,5,3
45933,45933,45934,5,6,1
45934,45934,45935,6,6,0
45935,45935,45936,6,4,-2
45936,45936,45937,4,7,3
45937,45937,45938,7,8,1
45938,45938,45939,8,0,-8
45939,45939,45940,0,3,3
45940,45940,45941,3,1,-2
45941,45941,45942,1,0,-1
45942,45942,45943,0,2,2
45943,45943,45944,2,9,7
45944,45944,45945,9,3,-6
45945,45945,45946,3,3,0
45946,45946,45947,3,5,2
45947,45947,45948,5,8,3
45948,45948,45949,8,6,-2
45949,45949,45950,6,4,-2
45950,45950,45951,4,7,3
45951,45951,45952,7,0,-7
45952,45952,45953,0,0,0
45953,45953,45954,0,8,8
45954,45954,45955,8,1,-7
45955,45955,45956,1,8,7
45956,45956,45957,8,2,-6
45957,45957,45958,2,2,0
45958,45958,45959,2,3,1
45959,45959,45960,3,0,-3
45960,45960,45961,0,1,1
45961,45961,45962,1,1,0
45962,45962,45963,1,5,4
45963,45963,45964,5,2,-3
45964,45964,45965,2,6,4
45965,45965,45966,6,0,-6
45966,45966,45967,0,7,7
45967,45967,45968,7,8,1
45968,45968,45969,8,9,1
45969,45969,45970,9,3,-6
45970,45970,45971,3,8,5
45971,45971,45972,8,2,-6
45972,45972,45973,2,7,5
45973,45973,45974,7,1,-6
45974,45974,45975,1,0,-1
45975,45975,45976,0,8,8
45976,45976,45977,8,2,-6
45977,45977,45978,2,7,5
45978,45978,45979,7,3,-4
45979,45979,45980,3,9,6
45980,45980,45981,9,4,-5
45981,45981,45982,4,4,0
45982,45982,45983,4,3,-1
45983,45983,45984,3,6,3
45984,45984,45985,6,8,2
45985,45985,45986,8,6,-2
45986,45986,45987,6,5,-1
45987,45987,45988,5,8,3
45988,45988,45989,8,1,-7
45989,45989,45990,1,3,2
45990,45990,45991,3,5,2
45991,45991,45992,5,7,2
45992,45992,45993,7,2,-5
45993,45993,45994,2,1,-1
45994,45994,45995,1,3,2
45995,45995,45996,3,1,-2
45996,45996,45997,1,0,-1
45997,45997,45998,0,2,2
45998,45998,45999,2,1,-1
45999,45999,46000,1,9,8
46000,46000,46001,9,2,-7
46001,46001,46002,2,2,0
46002,46002,46003,2,6,4
46003,46003,46004,6,4,-2
46004,46004,46005,4,3,-1
46005,46005,46006,3,1,-2
46006,46006,46007,1,0,-1
46007,46007,46008,0,9,9
46008,46008,46009,9,7,-2
46009,46009,46010,7,0,-7
46010,46010,46011,0,2,2
46011,46011,46012,2,1,-1
46012,46012,46013,1,6,5
46013,46013,46014,6,0,-6
46014,46014,46015,0,1,1
46015,46015,46016,1,7,6
46016,46016,46017,7,0,-7
46017,46017,46018,0,8,8
46018,46018,46019,8,5,-3
46019,46019,46020,5,9,4
46020,46020,46021,9,9,0
46021,46021,46022,9,4,-5
46022,46022,46023,4,9,5
46023,46023,46024,9,6,-3
46024,46024,46025,6,8,2
46025,46025,46026,8,1,-7
46026,46026,46027,1,3,2
46027,46027,46028,3,2,-1
46028,46028,46029,2,1,-1
46029,46029,46030,1,9,8
46030,46030,46031,9,7,-2
46031,46031,46032,7,9,2
46032,46032,46033,9,4,-5
46033,46033,46034,4,8,4
46034,46034,46035,8,7,-1
46035,46035,46036,7,2,-5
46036,46036,46037,2,4,2
46037,46037,46038,4,4,0
46038,46038,46039,4,0,-4
46039,46039,46040,0,1,1
46040,46040,46041,1,0,-1
46041,46041,46042,0,7,7
46042,46042,46043,7,6,-1
46043,46043,46044,6,2,-4
46044,46044,46045,2,6,4
46045,46045,46046,6,1,-5
46046,46046,46047,1,2,1
46047,46047,46048,2,7,5
46048,46048,46049,7,6,-1
46049,46049,46050,6,2,-4
46050,46050,46051,2,3,1
46051,46051,46052,3,4,1
46052,46052,46053,4,7,3
46053,46053,46054,7,0,-7
46054,46054,46055,0,7,7
46055,46055,46056,7,2,-5
46056,46056,46057,2,4,2
46057,46057,46058,4,1,-3
46058,46058,46059,1,4,3
46059,46059,46060,4,5,1
46060,46060,46061,5,3,-2
46061,46061,46062,3,3,0
46062,46062,46063,3,8,5
46063,46063,46064,8,9,1
46064,46064,46065,9,9,0
46065,46065,46066,9,9,0
46066,46066,46067,9,6,-3
46067,46067,46068,6,3,-3
46068,46068,46069,3,0,-3
46069,46069,46070,0,3,3
46070,46070,46071,3,9,6
46071,46071,46072,9,3,-6
46072,46072,46073,3,5,2
46073,46073,46074,5,6,1
46074,46074,46075,6,3,-3
46075,46075,46076,3,7,4
46076,46076,46077,7,1,-6
46077,46077,46078,1,7,6
46078,46078,46079,7,3,-4
46079,46079,46080,3,8,5
46080,46080,46081,8,7,-1
46081,46081,46082,7,2,-5
46082,46082,46083,2,2,0
46083,46083,46084,2,7,5
46084,46084,46085,7,1,-6
46085,46085,46086,1,5,4
46086,46086,46087,5,9,4
46087,46087,46088,9,6,-3
46088,46088,46089,6,1,-5
46089,46089,46090,1,0,-1
46090,46090,46091,0,5,5
46091,46091,46092,5,2,-3
46092,46092,46093,2,1,-1
46093,46093,46094,1,2,1
46094,46094,46095,2,7,5
46095,46095,46096,7,6,-1
46096,46096,46097,6,4,-2
46097,46097,46098,4,3,-1
46098,46098,46099,3,8,5
46099,46099,46100,8,9,1
46100,46100,46101,9,6,-3
46101,46101,46102,6,5,-1
46102,46102,46103,5,1,-4
46103,46103,46104,1,4,3
46104,46104,46105,4,2,-2
46105,46105,46106,2,7,5
46106,46106,46107,7,1,-6
46107,46107,46108,1,5,4
46108,46108,46109,5,6,1
46109,46109,46110,6,8,2
46110,46110,46111,8,0,-8
46111,46111,46112,0,4,4
46112,46112,46113,4,1,-3
46113,46113,46114,1,0,-1
46114,46114,46115,0,2,2
46115,46115,46116,2,2,0
46116,46116,46117,2,3,1
46117,46117,46118,3,8,5
46118,46118,46119,8,7,-1
46119,46119,46120,7,6,-1
46120,46120,46121,6,8,2
46121,46121,46122,8,2,-6
46122,46122,46123,2,9,7
46123,46123,46124,9,4,-5
46124,46124,46125,4,0,-4
46125,46125,46126,0,3,3
46126,46126,46127,3,1,-2
46127,46127,46128,1,4,3
46128,46128,46129,4,2,-2
46129,46129,46130,2,3,1
46130,46130,46131,3,6,3
46131,46131,46132,6,7,1
46132,46132,46133,7,7,0
46133,46133,46134,7,3,-4
46134,46134,46135,3,8,5
46135,46135,46136,8,3,-5
46136,46136,46137,3,9,6
46137,46137,46138,9,3,-6
46138,46138,46139,3,0,-3
46139,46139,46140,0,4,4
46140,46140,46141,4,1,-3
46141,46141,46142,1,1,0
46142,46142,46143,1,2,1
46143,46143,46144,2,0,-2
46144,46144,46145,0,3,3
46145,46145,46146,3,9,6
46146,46146,46147,9,7,-2
46147,46147,46148,7,9,2
46148,46148,46149,9,5,-4
46149,46149,46150,5,4,-1
46150,46150,46151,4,7,3
46151,46151,46152,7,5,-2
46152,46152,46153,5,7,2
46153,46153,46154,7,8,1
46154,46154,46155,8,7,-1
46155,46155,46156,7,7,0
46156,46156,46157,7,3,-4
46157,46157,46158,3,1,-2
46158,46158,46159,1,1,0
46159,46159,46160,1,7,6
46160,46160,46161,7,9,2
46161,46161,46162,9,2,-7
46162,46162,46163,2,2,0
46163,46163,46164,2,4,2
46164,46164,46165,4,1,-3
46165,46165,46166,1,0,-1
46166,46166,46167,0,6,6
46167,46167,46168,6,9,3
46168,46168,46169,9,5,-4
46169,46169,46170,5,6,1
46170,46170,46171,6,7,1
46171,46171,46172,7,4,-3
46172,46172,46173,4,1,-3
46173,46173,46174,1,7,6
46174,46174,46175,7,8,1
46175,46175,46176,8,9,1
46176,46176,46177,9,6,-3
46177,46177,46178,6,1,-5
46178,46178,46179,1,9,8
46179,46179,46180,9,5,-4
46180,46180,46181,5,1,-4
46181,46181,46182,1,3,2
46182,46182,46183,3,0,-3
46183,46183,46184,0,3,3
46184,46184,46185,3,1,-2
46185,46185,46186,1,6,5
46186,46186,46187,6,3,-3
46187,46187,46188,3,5,2
46188,46188,46189,5,6,1
46189,46189,46190,6,7,1
46190,46190,46191,7,8,1
46191,46191,46192,8,0,-8
46192,46192,46193,0,9,9
46193,46193,46194,9,4,-5
46194,46194,46195,4,5,1
46195,46195,46196,5,1,-4
46196,46196,46197,1,2,1
46197,46197,46198,2,6,4
46198,46198,46199,6,1,-5
46199,46199,46200,1,8,7
46200,46200,46201,8,7,-1
46201,46201,46202,7,7,0
46202,46202,46203,7,5,-2
46203,46203,46204,5,1,-4
46204,46204,46205,1,6,5
46205,46205,46206,6,9,3
46206,46206,46207,9,6,-3
46207,46207,46208,6,3,-3
46208,46208,46209,3,6,3
46209,46209,46210,6,1,-5
46210,46210,46211,1,3,2
46211,46211,46212,3,2,-1
46212,46212,46213,2,1,-1
46213,46213,46214,1,2,1
46214,46214,46215,2,7,5
46215,46215,46216,7,8,1
46216,46216,46217,8,2,-6
46217,46217,46218,2,6,4
46218,46218,46219,6,2,-4
46219,46219,46220,2,4,2
46220,46220,46221,4,3,-1
46221,46221,46222,3,8,5
46222,46222,46223,8,8,0
46223,46223,46224,8,2,-6
46224,46224,46225,2,1,-1
46225,46225,46226,1,8,7
46226,46226,46227,8,0,-8
46227,46227,46228,0,3,3
46228,46228,46229,3,6,3
46229,46229,46230,6,4,-2
46230,46230,46231,4,8,4
46231,46231,46232,8,4,-4
46232,46232,46233,4,8,4
46233,46233,46234,8,4,-4
46234,46234,46235,4,0,-4
46235,46235,46236,0,1,1
46236,46236,46237,1,8,7
46237,46237,46238,8,9,1
46238,46238,46239,9,2,-7
46239,46239,46240,2,1,-1
46240,46240,46241,1,3,2
46241,46241,46242,3,3,0
46242,46242,46243,3,9,6
46243,46243,46244,9,5,-4
46244,46244,46245,5,4,-1
46245,46245,46246,4,3,-1
46246,46246,46247,3,3,0
46247,46247,46248,3,7,4
46248,46248,46249,7,7,0
46249,46249,46250,7,2,-5
46250,46250,46251,2,1,-1
46251,46251,46252,1,8,7
46252,46252,46253,8,7,-1
46253,46253,46254,7,1,-6
46254,46254,46255,1,9,8
46255,46255,46256,9,1,-8
46256,46256,46257,1,4,3
46257,46257,46258,4,8,4
46258,46258,46259,8,2,-6
46259,46259,46260,2,7,5
46260,46260,46261,7,9,2
46261,46261,46262,9,2,-7
46262,46262,46263,2,9,7
46263,46263,46264,9,7,-2
46264,46264,46265,7,7,0
46265,46265,46266,7,2,-5
46266,46266,46267,2,1,-1
46267,46267,46268,1,1,0
46268,46268,46269,1,3,2
46269,46269,46270,3,8,5
46270,46270,46271,8,9,1
46271,46271,46272,9,6,-3
46272,46272,46273,6,0,-6
46273,46273,46274,0,7,7
46274,46274,46275,7,1,-6
46275,46275,46276,1,1,0
46276,46276,46277,1,2,1
46277,46277,46278,2,7,5
46278,46278,46279,7,3,-4
46279,46279,46280,3,3,0
46280,46280,46281,3,4,1
46281,46281,46282,4,9,5
46282,46282,46283,9,7,-2
46283,46283,46284,7,9,2
46284,46284,46285,9,8,-1
46285,46285,46286,8,2,-6
46286,46286,46287,2,9,7
46287,46287,46288,9,2,-7
46288,46288,46289,2,0,-2
46289,46289,46290,0,5,5
46290,46290,46291,5,1,-4
46291,46291,46292,1,0,-1
46292,46292,46293,0,2,2
46293,46293,46294,2,0,-2
46294,46294,46295,0,3,3
46295,46295,46296,3,3,0
46296,46296,46297,3,7,4
46297,46297,46298,7,9,2
46298,46298,46299,9,8,-1
46299,46299,46300,8,5,-3
46300,46300,46301,5,9,4
46301,46301,46302,9,1,-8
46302,46302,46303,1,0,-1
46303,46303,46304,0,1,1
46304,46304,46305,1,4,3
46305,46305,46306,4,3,-1
46306,46306,46307,3,5,2
46307,46307,46308,5,9,4
46308,46308,46309,9,6,-3
46309,46309,46310,6,6,0
46310,46310,46311,6,7,1
46311,46311,46312,7,5,-2
46312,46312,46313,5,8,3
46313,46313,46314,8,4,-4
46314,46314,46315,4,9,5
46315,46315,46316,9,9,0
46316,46316,46317,9,2,-7
46317,46317,46318,2,9,7
46318,46318,46319,9,2,-7
46319,46319,46320,2,8,6
46320,46320,46321,8,7,-1
46321,46321,46322,7,5,-2
46322,46322,46323,5,6,1
46323,46323,46324,6,4,-2
46324,46324,46325,4,4,0
46325,46325,46326,4,1,-3
46326,46326,46327,1,7,6
46327,46327,46328,7,0,-7
46328,46328,46329,0,3,3
46329,46329,46330,3,8,5
46330,46330,46331,8,5,-3
46331,46331,46332,5,0,-5
46332,46332,46333,0,4,4
46333,46333,46334,4,1,-3
46334,46334,46335,1,1,0
46335,46335,46336,1,9,8
46336,46336,46337,9,8,-1
46337,46337,46338,8,8,0
46338,46338,46339,8,0,-8
46339,46339,46340,0,7,7
46340,46340,46341,7,7,0
46341,46341,46342,7,1,-6
46342,46342,46343,1,2,1
46343,46343,46344,2,0,-2
46344,46344,46345,0,2,2
46345,46345,46346,2,8,6
46346,46346,46347,8,1,-7
46347,46347,46348,1,8,7
46348,46348,46349,8,7,-1
46349,46349,46350,7,3,-4
46350,46350,46351,3,7,4
46351,46351,46352,7,4,-3
46352,46352,46353,4,9,5
46353,46353,46354,9,3,-6
46354,46354,46355,3,9,6
46355,46355,46356,9,7,-2
46356,46356,46357,7,4,-3
46357,46357,46358,4,5,1
46358,46358,46359,5,6,1
46359,46359,46360,6,1,-5
46360,46360,46361,1,7,6
46361,46361,46362,7,9,2
46362,46362,46363,9,7,-2
46363,46363,46364,7,2,-5
46364,46364,46365,2,5,3
46365,46365,46366,5,5,0
46366,46366,46367,5,4,-1
46367,46367,46368,4,8,4
46368,46368,46369,8,5,-3
46369,46369,46370,5,3,-2
46370,46370,46371,3,0,-3
46371,46371,46372,0,1,1
46372,46372,46373,1,9,8
46373,46373,46374,9,4,-5
46374,46374,46375,4,0,-4
46375,46375,46376,0,7,7
46376,46376,46377,7,2,-5
46377,46377,46378,2,5,3
46378,46378,46379,5,3,-2
46379,46379,46380,3,8,5
46380,46380,46381,8,5,-3
46381,46381,46382,5,6,1
46382,46382,46383,6,6,0
46383,46383,46384,6,4,-2
46384,46384,46385,4,1,-3
46385,46385,46386,1,2,1
46386,46386,46387,2,8,6
46387,46387,46388,8,4,-4
46388,46388,46389,4,6,2
46389,46389,46390,6,6,0
46390,46390,46391,6,0,-6
46391,46391,46392,0,6,6
46392,46392,46393,6,6,0
46393,46393,46394,6,2,-4
46394,46394,46395,2,8,6
46395,46395,46396,8,8,0
46396,46396,46397,8,8,0
46397,46397,46398,8,0,-8
46398,46398,46399,0,8,8
46399,46399,46400,8,2,-6
46400,46400,46401,2,4,2
46401,46401,46402,4,4,0
46402,46402,46403,4,3,-1
46403,46403,46404,3,7,4
46404,46404,46405,7,8,1
46405,46405,46406,8,3,-5
46406,46406,46407,3,1,-2
46407,46407,46408,1,2,1
46408,46408,46409,2,3,1
46409,46409,46410,3,0,-3
46410,46410,46411,0,6,6
46411,46411,46412,6,0,-6
46412,46412,46413,0,9,9
46413,46413,46414,9,2,-7
46414,46414,46415,2,4,2
46415,46415,46416,4,1,-3
46416,46416,46417,1,1,0
46417,46417,46418,1,5,4
46418,46418,46419,5,7,2
46419,46419,46420,7,6,-1
46420,46420,46421,6,6,0
46421,46421,46422,6,7,1
46422,46422,46423,7,9,2
46423,46423,46424,9,3,-6
46424,46424,46425,3,3,0
46425,46425,46426,3,7,4
46426,46426,46427,7,3,-4
46427,46427,46428,3,8,5
46428,46428,46429,8,7,-1
46429,46429,46430,7,0,-7
46430,46430,46431,0,4,4
46431,46431,46432,4,6,2
46432,46432,46433,6,1,-5
46433,46433,46434,1,1,0
46434,46434,46435,1,9,8
46435,46435,46436,9,0,-9
46436,46436,46437,0,1,1
46437,46437,46438,1,0,-1
46438,46438,46439,0,0,0
46439,46439,46440,0,6,6
46440,46440,46441,6,6,0
46441,46441,46442,6,3,-3
46442,46442,46443,3,0,-3
46443,46443,46444,0,9,9
46444,46444,46445,9,1,-8
46445,46445,46446,1,0,-1
46446,46446,46447,0,2,2
46447,46447,46448,2,5,3
46448,46448,46449,5,3,-2
46449,46449,46450,3,8,5
46450,46450,46451,8,4,-4
46451,46451,46452,4,1,-3
46452,46452,46453,1,5,4
46453,46453,46454,5,3,-2
46454,46454,46455,3,6,3
46455,46455,46456,6,4,-2
46456,46456,46457,4,7,3
46457,46457,46458,7,5,-2
46458,46458,46459,5,0,-5
46459,46459,46460,0,4,4
46460,46460,46461,4,1,-3
46461,46461,46462,1,7,6
46462,46462,46463,7,2,-5
46463,46463,46464,2,2,0
46464,46464,46465,2,3,1
46465,46465,46466,3,7,4
46466,46466,46467,7,4,-3
46467,46467,46468,4,1,-3
46468,46468,46469,1,5,4
46469,46469,46470,5,1,-4
46470,46470,46471,1,6,5
46471,46471,46472,6,4,-2
46472,46472,46473,4,7,3
46473,46473,46474,7,9,2
46474,46474,46475,9,8,-1
46475,46475,46476,8,5,-3
46476,46476,46477,5,9,4
46477,46477,46478,9,8,-1
46478,46478,46479,8,0,-8
46479,46479,46480,0,3,3
46480,46480,46481,3,1,-2
46481,46481,46482,1,6,5
46482,46482,46483,6,2,-4
46483,46483,46484,2,0,-2
46484,46484,46485,0,3,3
46485,46485,46486,3,2,-1
46486,46486,46487,2,4,2
46487,46487,46488,4,0,-4
46488,46488,46489,0,5,5
46489,46489,46490,5,9,4
46490,46490,46491,9,6,-3
46491,46491,46492,6,9,3
46492,46492,46493,9,7,-2
46493,46493,46494,7,0,-7
46494,46494,46495,0,8,8
46495,46495,46496,8,1,-7
46496,46496,46497,1,9,8
46497,46497,46498,9,4,-5
46498,46498,46499,4,1,-3
46499,46499,46500,1,3,2
46500,46500,46501,3,7,4
46501,46501,46502,7,8,1
46502,46502,46503,8,4,-4
46503,46503,46504,4,8,4
46504,46504,46505,8,8,0
46505,46505,46506,8,3,-5
46506,46506,46507,3,1,-2
46507,46507,46508,1,8,7
46508,46508,46509,8,5,-3
46509,46509,46510,5,2,-3
46510,46510,46511,2,6,4
46511,46511,46512,6,1,-5
46512,46512,46513,1,5,4
46513,46513,46514,5,7,2
46514,46514,46515,7,7,0
46515,46515,46516,7,0,-7
46516,46516,46517,0,2,2
46517,46517,46518,2,1,-1
46518,46518,46519,1,8,7
46519,46519,46520,8,1,-7
46520,46520,46521,1,6,5
46521,46521,46522,6,5,-1
46522,46522,46523,5,3,-2
46523,46523,46524,3,6,3
46524,46524,46525,6,3,-3
46525,46525,46526,3,6,3
46526,46526,46527,6,8,2
46527,46527,46528,8,8,0
46528,46528,46529,8,6,-2
46529,46529,46530,6,4,-2
46530,46530,46531,4,5,1
46531,46531,46532,5,3,-2
46532,46532,46533,3,4,1
46533,46533,46534,4,3,-1
46534,46534,46535,3,0,-3
46535,46535,46536,0,6,6
46536,46536,46537,6,9,3
46537,46537,46538,9,6,-3
46538,46538,46539,6,1,-5
46539,46539,46540,1,2,1
46540,46540,46541,2,7,5
46541,46541,46542,7,1,-6
46542,46542,46543,1,2,1
46543,46543,46544,2,5,3
46544,46544,46545,5,9,4
46545,46545,46546,9,2,-7
46546,46546,46547,2,1,-1
46547,46547,46548,1,3,2
46548,46548,46549,3,3,0
46549,46549,46550,3,4,1
46550,46550,46551,4,2,-2
46551,46551,46552,2,1,-1
46552,46552,46553,1,2,1
46553,46553,46554,2,5,3
46554,46554,46555,5,3,-2
46555,46555,46556,3,2,-1
46556,46556,46557,2,0,-2
46557,46557,46558,0,6,6
46558,46558,46559,6,6,0
46559,46559,46560,6,0,-6
46560,46560,46561,0,4,4
46561,46561,46562,4,0,-4
46562,46562,46563,0,3,3
46563,46563,46564,3,4,1
46564,46564,46565,4,7,3
46565,46565,46566,7,3,-4
46566,46566,46567,3,6,3
46567,46567,46568,6,4,-2
46568,46568,46569,4,9,5
46569,46569,46570,9,3,-6
46570,46570,46571,3,0,-3
46571,46571,46572,0,9,9
46572,46572,46573,9,8,-1
46573,46573,46574,8,2,-6
46574,46574,46575,2,1,-1
46575,46575,46576,1,5,4
46576,46576,46577,5,4,-1
46577,46577,46578,4,9,5
46578,46578,46579,9,0,-9
46579,46579,46580,0,6,6
46580,46580,46581,6,6,0
46581,46581,46582,6,0,-6
46582,46582,46583,0,1,1
46583,46583,46584,1,8,7
46584,46584,46585,8,2,-6
46585,46585,46586,2,2,0
46586,46586,46587,2,6,4
46587,46587,46588,6,3,-3
46588,46588,46589,3,9,6
46589,46589,46590,9,6,-3
46590,46590,46591,6,2,-4
46591,46591,46592,2,3,1
46592,46592,46593,3,2,-1
46593,46593,46594,2,6,4
46594,46594,46595,6,3,-3
46595,46595,46596,3,0,-3
46596,46596,46597,0,5,5
46597,46597,46598,5,1,-4
46598,46598,46599,1,5,4
46599,46599,46600,5,3,-2
46600,46600,46601,3,1,-2
46601,46601,46602,1,9,8
46602,46602,46603,9,0,-9
46603,46603,46604,0,0,0
46604,46604,46605,0,7,7
46605,46605,46606,7,2,-5
46606,46606,46607,2,7,5
46607,46607,46608,7,5,-2
46608,46608,46609,5,9,4
46609,46609,46610,9,5,-4
46610,46610,46611,5,6,1
46611,46611,46612,6,5,-1
46612,46612,46613,5,4,-1
46613,46613,46614,4,8,4
46614,46614,46615,8,7,-1
46615,46615,46616,7,8,1
46616,46616,46617,8,0,-8
46617,46617,46618,0,7,7
46618,46618,46619,7,2,-5
46619,46619,46620,2,2,0
46620,46620,46621,2,3,1
46621,46621,46622,3,4,1
46622,46622,46623,4,4,0
46623,46623,46624,4,4,0
46624,46624,46625,4,0,-4
46625,46625,46626,0,6,6
46626,46626,46627,6,0,-6
46627,46627,46628,0,0,0
46628,46628,46629,0,8,8
46629,46629,46630,8,7,-1
46630,46630,46631,7,8,1
46631,46631,46632,8,6,-2
46632,46632,46633,6,8,2
46633,46633,46634,8,3,-5
46634,46634,46635,3,5,2
46635,46635,46636,5,7,2
46636,46636,46637,7,1,-6
46637,46637,46638,1,7,6
46638,46638,46639,7,3,-4
46639,46639,46640,3,5,2
46640,46640,46641,5,7,2
46641,46641,46642,7,7,0
46642,46642,46643,7,4,-3
46643,46643,46644,4,4,0
46644,46644,46645,4,9,5
46645,46645,46646,9,6,-3
46646,46646,46647,6,8,2
46647,46647,46648,8,7,-1
46648,46648,46649,7,8,1
46649,46649,46650,8,8,0
46650,46650,46651,8,9,1
46651,46651,46652,9,3,-6
46652,46652,46653,3,0,-3
46653,46653,46654,0,0,0
46654,46654,46655,0,9,9
46655,46655,46656,9,2,-7
46656,46656,46657,2,8,6
46657,46657,46658,8,8,0
46658,46658,46659,8,9,1
46659,46659,46660,9,9,0
46660,46660,46661,9,0,-9
46661,46661,46662,0,9,9
46662,46662,46663,9,2,-7
46663,46663,46664,2,1,-1
46664,46664,46665,1,6,5
46665,46665,46666,6,3,-3
46666,46666,46667,3,5,2
46667,46667,46668,5,4,-1
46668,46668,46669,4,6,2
46669,46669,46670,6,6,0
46670,46670,46671,6,7,1
46671,46671,46672,7,7,0
46672,46672,46673,7,7,0
46673,46673,46674,7,3,-4
46674,46674,46675,3,5,2
46675,46675,46676,5,6,1
46676,46676,46677,6,4,-2
46677,46677,46678,4,2,-2
46678,46678,46679,2,1,-1
46679,46679,46680,1,0,-1
46680,46680,46681,0,3,3
46681,46681,46682,3,6,3
46682,46682,46683,6,0,-6
46683,46683,46684,0,6,6
46684,46684,46685,6,1,-5
46685,46685,46686,1,7,6
46686,46686,46687,7,2,-5
46687,46687,46688,2,7,5
46688,46688,46689,7,3,-4
46689,46689,46690,3,2,-1
46690,46690,46691,2,4,2
46691,46691,46692,4,3,-1
46692,46692,46693,3,5,2
46693,46693,46694,5,2,-3
46694,46694,46695,2,6,4
46695,46695,46696,6,1,-5
46696,46696,46697,1,7,6
46697,46697,46698,7,9,2
46698,46698,46699,9,8,-1
46699,46699,46700,8,5,-3
46700,46700,46701,5,9,4
46701,46701,46702,9,3,-6
46702,46702,46703,3,0,-3
46703,46703,46704,0,6,6
46704,46704,46705,6,1,-5
46705,46705,46706,1,9,8
46706,46706,46707,9,2,-7
46707,46707,46708,2,2,0
46708,46708,46709,2,3,1
46709,46709,46710,3,2,-1
46710,46710,46711,2,4,2
46711,46711,46712,4,4,0
46712,46712,46713,4,5,1
46713,46713,46714,5,9,4
46714,46714,46715,9,6,-3
46715,46715,46716,6,4,-2
46716,46716,46717,4,7,3
46717,46717,46718,7,1,-6
46718,46718,46719,1,8,7
46719,46719,46720,8,5,-3
46720,46720,46721,5,9,4
46721,46721,46722,9,1,-8
46722,46722,46723,1,0,-1
46723,46723,46724,0,7,7
46724,46724,46725,7,1,-6
46725,46725,46726,1,0,-1
46726,46726,46727,0,2,2
46727,46727,46728,2,4,2
46728,46728,46729,4,3,-1
46729,46729,46730,3,8,5
46730,46730,46731,8,4,-4
46731,46731,46732,4,6,2
46732,46732,46733,6,5,-1
46733,46733,46734,5,4,-1
46734,46734,46735,4,6,2
46735,46735,46736,6,3,-3
46736,46736,46737,3,7,4
46737,46737,46738,7,8,1
46738,46738,46739,8,8,0
46739,46739,46740,8,0,-8
46740,46740,46741,0,9,9
46741,46741,46742,9,9,0
46742,46742,46743,9,3,-6
46743,46743,46744,3,7,4
46744,46744,46745,7,4,-3
46745,46745,46746,4,0,-4
46746,46746,46747,0,1,1
46747,46747,46748,1,0,-1
46748,46748,46749,0,4,4
46749,46749,46750,4,6,2
46750,46750,46751,6,0,-6
46751,46751,46752,0,7,7
46752,46752,46753,7,8,1
46753,46753,46754,8,4,-4
46754,46754,46755,4,6,2
46755,46755,46756,6,8,2
46756,46756,46757,8,4,-4
46757,46757,46758,4,8,4
46758,46758,46759,8,5,-3
46759,46759,46760,5,2,-3
46760,46760,46761,2,4,2
46761,46761,46762,4,9,5
46762,46762,46763,9,0,-9
46763,46763,46764,0,8,8
46764,46764,46765,8,7,-1
46765,46765,46766,7,4,-3
46766,46766,46767,4,8,4
46767,46767,46768,8,5,-3
46768,46768,46769,5,7,2
46769,46769,46770,7,7,0
46770,46770,46771,7,7,0
46771,46771,46772,7,0,-7
46772,46772,46773,0,9,9
46773,46773,46774,9,5,-4
46774,46774,46775,5,0,-5
46775,46775,46776,0,8,8
46776,46776,46777,8,4,-4
46777,46777,46778,4,9,5
46778,46778,46779,9,7,-2
46779,46779,46780,7,1,-6
46780,46780,46781,1,4,3
46781,46781,46782,4,1,-3
46782,46782,46783,1,2,1
46783,46783,46784,2,9,7
46784,46784,46785,9,0,-9
46785,46785,46786,0,4,4
46786,46786,46787,4,5,1
46787,46787,46788,5,6,1
46788,46788,46789,6,8,2
46789,46789,46790,8,4,-4
46790,46790,46791,4,8,4
46791,46791,46792,8,1,-7
46792,46792,46793,1,8,7
46793,46793,46794,8,8,0
46794,46794,46795,8,4,-4
46795,46795,46796,4,0,-4
46796,46796,46797,0,0,0
46797,46797,46798,0,4,4
46798,46798,46799,4,7,3
46799,46799,46800,7,9,2
46800,46800,46801,9,1,-8
46801,46801,46802,1,9,8
46802,46802,46803,9,3,-6
46803,46803,46804,3,6,3
46804,46804,46805,6,5,-1
46805,46805,46806,5,4,-1
46806,46806,46807,4,3,-1
46807,46807,46808,3,5,2
46808,46808,46809,5,1,-4
46809,46809,46810,1,0,-1
46810,46810,46811,0,6,6
46811,46811,46812,6,0,-6
46812,46812,46813,0,5,5
46813,46813,46814,5,9,4
46814,46814,46815,9,3,-6
46815,46815,46816,3,8,5
46816,46816,46817,8,8,0
46817,46817,46818,8,0,-8
46818,46818,46819,0,7,7
46819,46819,46820,7,7,0
46820,46820,46821,7,3,-4
46821,46821,46822,3,0,-3
46822,46822,46823,0,1,1
46823,46823,46824,1,5,4
46824,46824,46825,5,6,1
46825,46825,46826,6,0,-6
46826,46826,46827,0,8,8
46827,46827,46828,8,9,1
46828,46828,46829,9,5,-4
46829,46829,46830,5,2,-3
46830,46830,46831,2,9,7
46831,46831,46832,9,7,-2
46832,46832,46833,7,2,-5
46833,46833,46834,2,3,1
46834,46834,46835,3,2,-1
46835,46835,46836,2,7,5
46836,46836,46837,7,0,-7
46837,46837,46838,0,3,3
46838,46838,46839,3,9,6
46839,46839,46840,9,1,-8
46840,46840,46841,1,2,1
46841,46841,46842,2,1,-1
46842,46842,46843,1,4,3
46843,46843,46844,4,6,2
46844,46844,46845,6,6,0
46845,46845,46846,6,4,-2
46846,46846,46847,4,5,1
46847,46847,46848,5,3,-2
46848,46848,46849,3,2,-1
46849,46849,46850,2,1,-1
46850,46850,46851,1,7,6
46851,46851,46852,7,4,-3
46852,46852,46853,4,3,-1
46853,46853,46854,3,3,0
46854,46854,46855,3,1,-2
46855,46855,46856,1,3,2
46856,46856,46857,3,3,0
46857,46857,46858,3,7,4
46858,46858,46859,7,6,-1
46859,46859,46860,6,0,-6
46860,46860,46861,0,6,6
46861,46861,46862,6,5,-1
46862,46862,46863,5,2,-3
46863,46863,46864,2,8,6
46864,46864,46865,8,1,-7
46865,46865,46866,1,9,8
46866,46866,46867,9,2,-7
46867,46867,46868,2,0,-2
46868,46868,46869,0,6,6
46869,46869,46870,6,9,3
46870,46870,46871,9,0,-9
46871,46871,46872,0,8,8
46872,46872,46873,8,7,-1
46873,46873,46874,7,7,0
46874,46874,46875,7,7,0
46875,46875,46876,7,8,1
46876,46876,46877,8,4,-4
46877,46877,46878,4,5,1
46878,46878,46879,5,7,2
46879,46879,46880,7,1,-6
46880,46880,46881,1,4,3
46881,46881,46882,4,3,-1
46882,46882,46883,3,8,5
46883,46883,46884,8,4,-4
46884,46884,46885,4,9,5
46885,46885,46886,9,4,-5
46886,46886,46887,4,2,-2
46887,46887,46888,2,7,5
46888,46888,46889,7,9,2
46889,46889,46890,9,5,-4
46890,46890,46891,5,5,0
46891,46891,46892,5,0,-5
46892,46892,46893,0,1,1
46893,46893,46894,1,4,3
46894,46894,46895,4,5,1
46895,46895,46896,5,0,-5
46896,46896,46897,0,8,8
46897,46897,46898,8,6,-2
46898,46898,46899,6,3,-3
46899,46899,46900,3,3,0
46900,46900,46901,3,5,2
46901,46901,46902,5,3,-2
46902,46902,46903,3,6,3
46903,46903,46904,6,8,2
46904,46904,46905,8,0,-8
46905,46905,46906,0,7,7
46906,46906,46907,7,9,2
46907,46907,46908,9,3,-6
46908,46908,46909,3,9,6
46909,46909,46910,9,2,-7
46910,46910,46911,2,3,1
46911,46911,46912,3,2,-1
46912,46912,46913,2,1,-1
46913,46913,46914,1,5,4
46914,46914,46915,5,1,-4
46915,46915,46916,1,1,0
46916,46916,46917,1,0,-1
46917,46917,46918,0,3,3
46918,46918,46919,3,1,-2
46919,46919,46920,1,4,3
46920,46920,46921,4,2,-2
46921,46921,46922,2,4,2
46922,46922,46923,4,3,-1
46923,46923,46924,3,5,2
46924,46924,46925,5,4,-1
46925,46925,46926,4,0,-4
46926,46926,46927,0,8,8
46927,46927,46928,8,7,-1
46928,46928,46929,7,9,2
46929,46929,46930,9,1,-8
46930,46930,46931,1,0,-1
46931,46931,46932,0,3,3
46932,46932,46933,3,1,-2
46933,46933,46934,1,1,0
46934,46934,46935,1,2,1
46935,46935,46936,2,1,-1
46936,46936,46937,1,3,2
46937,46937,46938,3,7,4
46938,46938,46939,7,4,-3
46939,46939,46940,4,2,-2
46940,46940,46941,2,5,3
46941,46941,46942,5,8,3
46942,46942,46943,8,6,-2
46943,46943,46944,6,0,-6
46944,46944,46945,0,7,7
46945,46945,46946,7,9,2
46946,46946,46947,9,0,-9
46947,46947,46948,0,5,5
46948,46948,46949,5,1,-4
46949,46949,46950,1,7,6
46950,46950,46951,7,2,-5
46951,46951,46952,2,0,-2
46952,46952,46953,0,3,3
46953,46953,46954,3,1,-2
46954,46954,46955,1,4,3
46955,46955,46956,4,2,-2
46956,46956,46957,2,7,5
46957,46957,46958,7,9,2
46958,46958,46959,9,8,-1
46959,46959,46960,8,4,-4
46960,46960,46961,4,9,5
46961,46961,46962,9,0,-9
46962,46962,46963,0,0,0
46963,46963,46964,0,7,7
46964,46964,46965,7,5,-2
46965,46965,46966,5,2,-3
46966,46966,46967,2,6,4
46967,46967,46968,6,5,-1
46968,46968,46969,5,8,3
46969,46969,46970,8,9,1
46970,46970,46971,9,3,-6
46971,46971,46972,3,9,6
46972,46972,46973,9,9,0
46973,46973,46974,9,2,-7
46974,46974,46975,2,0,-2
46975,46975,46976,0,4,4
46976,46976,46977,4,2,-2
46977,46977,46978,2,2,0
46978,46978,46979,2,3,1
46979,46979,46980,3,0,-3
46980,46980,46981,0,3,3
46981,46981,46982,3,8,5
46982,46982,46983,8,3,-5
46983,46983,46984,3,1,-2
46984,46984,46985,1,9,8
46985,46985,46986,9,3,-6
46986,46986,46987,3,9,6
46987,46987,46988,9,8,-1
46988,46988,46989,8,5,-3
46989,46989,46990,5,5,0
46990,46990,46991,5,6,1
46991,46991,46992,6,0,-6
46992,46992,46993,0,4,4
46993,46993,46994,4,6,2
46994,46994,46995,6,4,-2
46995,46995,46996,4,5,1
46996,46996,46997,5,2,-3
46997,46997,46998,2,8,6
46998,46998,46999,8,5,-3
46999,46999,47000,5,0,-5
47000,47000,47001,0,4,4
47001,47001,47002,4,4,0
47002,47002,47003,4,7,3
47003,47003,47004,7,1,-6
47004,47004,47005,1,0,-1
47005,47005,47006,0,6,6
47006,47006,47007,6,3,-3
47007,47007,47008,3,8,5
47008,47008,47009,8,9,1
47009,47009,47010,9,9,0
47010,47010,47011,9,6,-3
47011,47011,47012,6,2,-4
47012,47012,47013,2,8,6
47013,47013,47014,8,6,-2
47014,47014,47015,6,7,1
47015,47015,47016,7,5,-2
47016,47016,47017,5,9,4
47017,47017,47018,9,6,-3
47018,47018,47019,6,1,-5
47019,47019,47020,1,5,4
47020,47020,47021,5,5,0
47021,47021,47022,5,1,-4
47022,47022,47023,1,2,1
47023,47023,47024,2,2,0
47024,47024,47025,2,6,4
47025,47025,47026,6,6,0
47026,47026,47027,6,3,-3
47027,47027,47028,3,4,1
47028,47028,47029,4,4,0
47029,47029,47030,4,8,4
47030,47030,47031,8,0,-8
47031,47031,47032,0,6,6
47032,47032,47033,6,4,-2
47033,47033,47034,4,8,4
47034,47034,47035,8,1,-7
47035,47035,47036,1,2,1
47036,47036,47037,2,6,4
47037,47037,47038,6,8,2
47038,47038,47039,8,5,-3
47039,47039,47040,5,9,4
47040,47040,47041,9,1,-8
47041,47041,47042,1,0,-1
47042,47042,47043,0,2,2
47043,47043,47044,2,4,2
47044,47044,47045,4,6,2
47045,47045,47046,6,0,-6
47046,47046,47047,0,6,6
47047,47047,47048,6,9,3
47048,47048,47049,9,7,-2
47049,47049,47050,7,1,-6
47050,47050,47051,1,8,7
47051,47051,47052,8,8,0
47052,47052,47053,8,8,0
47053,47053,47054,8,1,-7
47054,47054,47055,1,1,0
47055,47055,47056,1,9,8
47056,47056,47057,9,8,-1
47057,47057,47058,8,4,-4
47058,47058,47059,4,3,-1
47059,47059,47060,3,5,2
47060,47060,47061,5,7,2
47061,47061,47062,7,7,0
47062,47062,47063,7,1,-6
47063,47063,47064,1,6,5
47064,47064,47065,6,2,-4
47065,47065,47066,2,8,6
47066,47066,47067,8,7,-1
47067,47067,47068,7,4,-3
47068,47068,47069,4,0,-4
47069,47069,47070,0,4,4
47070,47070,47071,4,7,3
47071,47071,47072,7,0,-7
47072,47072,47073,0,0,0
47073,47073,47074,0,8,8
47074,47074,47075,8,1,-7
47075,47075,47076,1,8,7
47076,47076,47077,8,5,-3
47077,47077,47078,5,0,-5
47078,47078,47079,0,0,0
47079,47079,47080,0,8,8
47080,47080,47081,8,5,-3
47081,47081,47082,5,9,4
47082,47082,47083,9,2,-7
47083,47083,47084,2,6,4
47084,47084,47085,6,8,2
47085,47085,47086,8,4,-4
47086,47086,47087,4,0,-4
47087,47087,47088,0,2,2
47088,47088,47089,2,4,2
47089,47089,47090,4,3,-1
47090,47090,47091,3,9,6
47091,47091,47092,9,4,-5
47092,47092,47093,4,8,4
47093,47093,47094,8,4,-4
47094,47094,47095,4,3,-1
47095,47095,47096,3,0,-3
47096,47096,47097,0,1,1
47097,47097,47098,1,5,4
47098,47098,47099,5,8,3
47099,47099,47100,8,8,0
47100,47100,47101,8,2,-6
47101,47101,47102,2,2,0
47102,47102,47103,2,9,7
47103,47103,47104,9,5,-4
47104,47104,47105,5,9,4
47105,47105,47106,9,6,-3
47106,47106,47107,6,5,-1
47107,47107,47108,5,1,-4
47108,47108,47109,1,4,3
47109,47109,47110,4,7,3
47110,47110,47111,7,8,1
47111,47111,47112,8,6,-2
47112,47112,47113,6,2,-4
47113,47113,47114,2,2,0
47114,47114,47115,2,5,3
47115,47115,47116,5,8,3
47116,47116,47117,8,7,-1
47117,47117,47118,7,1,-6
47118,47118,47119,1,1,0
47119,47119,47120,1,9,8
47120,47120,47121,9,4,-5
47121,47121,47122,4,8,4
47122,47122,47123,8,3,-5
47123,47123,47124,3,0,-3
47124,47124,47125,0,9,9
47125,47125,47126,9,9,0
47126,47126,47127,9,7,-2
47127,47127,47128,7,4,-3
47128,47128,47129,4,1,-3
47129,47129,47130,1,5,4
47130,47130,47131,5,2,-3
47131,47131,47132,2,2,0
47132,47132,47133,2,6,4
47133,47133,47134,6,9,3
47134,47134,47135,9,0,-9
47135,47135,47136,0,8,8
47136,47136,47137,8,7,-1
47137,47137,47138,7,5,-2
47138,47138,47139,5,0,-5
47139,47139,47140,0,3,3
47140,47140,47141,3,1,-2
47141,47141,47142,1,2,1
47142,47142,47143,2,2,0
47143,47143,47144,2,8,6
47144,47144,47145,8,3,-5
47145,47145,47146,3,5,2
47146,47146,47147,5,6,1
47147,47147,47148,6,9,3
47148,47148,47149,9,7,-2
47149,47149,47150,7,0,-7
47150,47150,47151,0,8,8
47151,47151,47152,8,8,0
47152,47152,47153,8,1,-7
47153,47153,47154,1,8,7
47154,47154,47155,8,2,-6
47155,47155,47156,2,0,-2
47156,47156,47157,0,3,3
47157,47157,47158,3,1,-2
47158,47158,47159,1,4,3
47159,47159,47160,4,7,3
47160,47160,47161,7,7,0
47161,47161,47162,7,6,-1
47162,47162,47163,6,8,2
47163,47163,47164,8,2,-6
47164,47164,47165,2,9,7
47165,47165,47166,9,0,-9
47166,47166,47167,0,0,0
47167,47167,47168,0,7,7
47168,47168,47169,7,1,-6
47169,47169,47170,1,7,6
47170,47170,47171,7,2,-5
47171,47171,47172,2,0,-2
47172,47172,47173,0,3,3
47173,47173,47174,3,0,-3
47174,47174,47175,0,4,4
47175,47175,47176,4,8,4
47176,47176,47177,8,5,-3
47177,47177,47178,5,9,4
47178,47178,47179,9,6,-3
47179,47179,47180,6,7,1
47180,47180,47181,7,7,0
47181,47181,47182,7,7,0
47182,47182,47183,7,8,1
47183,47183,47184,8,7,-1
47184,47184,47185,7,9,2
47185,47185,47186,9,0,-9
47186,47186,47187,0,1,1
47187,47187,47188,1,8,7
47188,47188,47189,8,2,-6
47189,47189,47190,2,0,-2
47190,47190,47191,0,6,6
47191,47191,47192,6,3,-3
47192,47192,47193,3,5,2
47193,47193,47194,5,1,-4
47194,47194,47195,1,3,2
47195,47195,47196,3,9,6
47196,47196,47197,9,0,-9
47197,47197,47198,0,4,4
47198,47198,47199,4,2,-2
47199,47199,47200,2,1,-1
47200,47200,47201,1,8,7
47201,47201,47202,8,0,-8
47202,47202,47203,0,7,7
47203,47203,47204,7,5,-2
47204,47204,47205,5,0,-5
47205,47205,47206,0,7,7
47206,47206,47207,7,3,-4
47207,47207,47208,3,5,2
47208,47208,47209,5,6,1
47209,47209,47210,6,4,-2
47210,47210,47211,4,4,0
47211,47211,47212,4,8,4
47212,47212,47213,8,1,-7
47213,47213,47214,1,6,5
47214,47214,47215,6,4,-2
47215,47215,47216,4,1,-3
47216,47216,47217,1,3,2
47217,47217,47218,3,8,5
47218,47218,47219,8,6,-2
47219,47219,47220,6,6,0
47220,47220,47221,6,7,1
47221,47221,47222,7,1,-6
47222,47222,47223,1,2,1
47223,47223,47224,2,1,-1
47224,47224,47225,1,3,2
47225,47225,47226,3,2,-1
47226,47226,47227,2,9,7
47227,47227,47228,9,2,-7
47228,47228,47229,2,1,-1
47229,47229,47230,1,2,1
47230,47230,47231,2,2,0
47231,47231,47232,2,7,5
47232,47232,47233,7,1,-6
47233,47233,47234,1,1,0
47234,47234,47235,1,2,1
47235,47235,47236,2,1,-1
47236,47236,47237,1,9,8
47237,47237,47238,9,2,-7
47238,47238,47239,2,6,4
47239,47239,47240,6,4,-2
47240,47240,47241,4,0,-4
47241,47241,47242,0,7,7
47242,47242,47243,7,1,-6
47243,47243,47244,1,9,8
47244,47244,47245,9,3,-6
47245,47245,47246,3,2,-1
47246,47246,47247,2,0,-2
47247,47247,47248,0,7,7
47248,47248,47249,7,2,-5
47249,47249,47250,2,5,3
47250,47250,47251,5,5,0
47251,47251,47252,5,4,-1
47252,47252,47253,4,7,3
47253,47253,47254,7,2,-5
47254,47254,47255,2,2,0
47255,47255,47256,2,5,3
47256,47256,47257,5,9,4
47257,47257,47258,9,2,-7
47258,47258,47259,2,1,-1
47259,47259,47260,1,6,5
47260,47260,47261,6,9,3
47261,47261,47262,9,7,-2
47262,47262,47263,7,0,-7
47263,47263,47264,0,9,9
47264,47264,47265,9,6,-3
47265,47265,47266,6,7,1
47266,47266,47267,7,0,-7
47267,47267,47268,0,1,1
47268,47268,47269,1,6,5
47269,47269,47270,6,2,-4
47270,47270,47271,2,0,-2
47271,47271,47272,0,1,1
47272,47272,47273,1,2,1
47273,47273,47274,2,8,6
47274,47274,47275,8,0,-8
47275,47275,47276,0,4,4
47276,47276,47277,4,6,2
47277,47277,47278,6,5,-1
47278,47278,47279,5,1,-4
47279,47279,47280,1,3,2
47280,47280,47281,3,5,2
47281,47281,47282,5,4,-1
47282,47282,47283,4,8,4
47283,47283,47284,8,5,-3
47284,47284,47285,5,4,-1
47285,47285,47286,4,7,3
47286,47286,47287,7,3,-4
47287,47287,47288,3,6,3
47288,47288,47289,6,0,-6
47289,47289,47290,0,2,2
47290,47290,47291,2,1,-1
47291,47291,47292,1,9,8
47292,47292,47293,9,4,-5
47293,47293,47294,4,0,-4
47294,47294,47295,0,8,8
47295,47295,47296,8,5,-3
47296,47296,47297,5,8,3
47297,47297,47298,8,8,0
47298,47298,47299,8,4,-4
47299,47299,47300,4,6,2
47300,47300,47301,6,5,-1
47301,47301,47302,5,2,-3
47302,47302,47303,2,7,5
47303,47303,47304,7,8,1
47304,47304,47305,8,5,-3
47305,47305,47306,5,2,-3
47306,47306,47307,2,7,5
47307,47307,47308,7,4,-3
47308,47308,47309,4,8,4
47309,47309,47310,8,1,-7
47310,47310,47311,1,3,2
47311,47311,47312,3,8,5
47312,47312,47313,8,4,-4
47313,47313,47314,4,5,1
47314,47314,47315,5,8,3
47315,47315,47316,8,0,-8
47316,47316,47317,0,8,8
47317,47317,47318,8,4,-4
47318,47318,47319,4,5,1
47319,47319,47320,5,5,0
47320,47320,47321,5,2,-3
47321,47321,47322,2,8,6
47322,47322,47323,8,9,1
47323,47323,47324,9,0,-9
47324,47324,47325,0,7,7
47325,47325,47326,7,4,-3
47326,47326,47327,4,1,-3
47327,47327,47328,1,8,7
47328,47328,47329,8,3,-5
47329,47329,47330,3,4,1
47330,47330,47331,4,8,4
47331,47331,47332,8,9,1
47332,47332,47333,9,1,-8
47333,47333,47334,1,4,3
47334,47334,47335,4,0,-4
47335,47335,47336,0,4,4
47336,47336,47337,4,7,3
47337,47337,47338,7,1,-6
47338,47338,47339,1,5,4
47339,47339,47340,5,1,-4
47340,47340,47341,1,9,8
47341,47341,47342,9,2,-7
47342,47342,47343,2,6,4
47343,47343,47344,6,0,-6
47344,47344,47345,0,9,9
47345,47345,47346,9,0,-9
47346,47346,47347,0,4,4
47347,47347,47348,4,5,1
47348,47348,47349,5,7,2
47349,47349,47350,7,1,-6
47350,47350,47351,1,7,6
47351,47351,47352,7,3,-4
47352,47352,47353,3,9,6
47353,47353,47354,9,2,-7
47354,47354,47355,2,9,7
47355,47355,47356,9,3,-6
47356,47356,47357,3,5,2
47357,47357,47358,5,6,1
47358,47358,47359,6,8,2
47359,47359,47360,8,1,-7
47360,47360,47361,1,3,2
47361,47361,47362,3,7,4
47362,47362,47363,7,4,-3
47363,47363,47364,4,7,3
47364,47364,47365,7,4,-3
47365,47365,47366,4,5,1
47366,47366,47367,5,3,-2
47367,47367,47368,3,4,1
47368,47368,47369,4,2,-2
47369,47369,47370,2,0,-2
47370,47370,47371,0,0,0
47371,47371,47372,0,0,0
47372,47372,47373,0,1,1
47373,47373,47374,1,7,6
47374,47374,47375,7,2,-5
47375,47375,47376,2,6,4
47376,47376,47377,6,3,-3
47377,47377,47378,3,2,-1
47378,47378,47379,2,4,2
47379,47379,47380,4,3,-1
47380,47380,47381,3,5,2
47381,47381,47382,5,1,-4
47382,47382,47383,1,6,5
47383,47383,47384,6,1,-5
47384,47384,47385,1,7,6
47385,47385,47386,7,0,-7
47386,47386,47387,0,8,8
47387,47387,47388,8,1,-7
47388,47388,47389,1,0,-1
47389,47389,47390,0,9,9
47390,47390,47391,9,1,-8
47391,47391,47392,1,8,7
47392,47392,47393,8,2,-6
47393,47393,47394,2,1,-1
47394,47394,47395,1,3,2
47395,47395,47396,3,0,-3
47396,47396,47397,0,4,4
47397,47397,47398,4,9,5
47398,47398,47399,9,7,-2
47399,47399,47400,7,1,-6
47400,47400,47401,1,8,7
47401,47401,47402,8,7,-1
47402,47402,47403,7,9,2
47403,47403,47404,9,6,-3
47404,47404,47405,6,0,-6
47405,47405,47406,0,0,0
47406,47406,47407,0,1,1
47407,47407,47408,1,2,1
47408,47408,47409,2,2,0
47409,47409,47410,2,4,2
47410,47410,47411,4,3,-1
47411,47411,47412,3,5,2
47412,47412,47413,5,4,-1
47413,47413,47414,4,5,1
47414,47414,47415,5,6,1
47415,47415,47416,6,7,1
47416,47416,47417,7,7,0
47417,47417,47418,7,6,-1
47418,47418,47419,6,0,-6
47419,47419,47420,0,8,8
47420,47420,47421,8,8,0
47421,47421,47422,8,0,-8
47422,47422,47423,0,7,7
47423,47423,47424,7,3,-4
47424,47424,47425,3,8,5
47425,47425,47426,8,3,-5
47426,47426,47427,3,9,6
47427,47427,47428,9,5,-4
47428,47428,47429,5,1,-4
47429,47429,47430,1,6,5
47430,47430,47431,6,4,-2
47431,47431,47432,4,6,2
47432,47432,47433,6,5,-1
47433,47433,47434,5,1,-4
47434,47434,47435,1,1,0
47435,47435,47436,1,6,5
47436,47436,47437,6,6,0
47437,47437,47438,6,8,2
47438,47438,47439,8,7,-1
47439,47439,47440,7,1,-6
47440,47440,47441,1,3,2
47441,47441,47442,3,1,-2
47442,47442,47443,1,2,1
47443,47443,47444,2,5,3
47444,47444,47445,5,9,4
47445,47445,47446,9,1,-8
47446,47446,47447,1,0,-1
47447,47447,47448,0,2,2
47448,47448,47449,2,5,3
47449,47449,47450,5,6,1
47450,47450,47451,6,6,0
47451,47451,47452,6,0,-6
47452,47452,47453,0,7,7
47453,47453,47454,7,6,-1
47454,47454,47455,6,3,-3
47455,47455,47456,3,9,6
47456,47456,47457,9,9,0
47457,47457,47458,9,6,-3
47458,47458,47459,6,9,3
47459,47459,47460,9,2,-7
47460,47460,47461,2,3,1
47461,47461,47462,3,8,5
47462,47462,47463,8,8,0
47463,47463,47464,8,7,-1
47464,47464,47465,7,1,-6
47465,47465,47466,1,0,-1
47466,47466,47467,0,2,2
47467,47467,47468,2,5,3
47468,47468,47469,5,3,-2
47469,47469,47470,3,0,-3
47470,47470,47471,0,5,5
47471,47471,47472,5,6,1
47472,47472,47473,6,0,-6
47473,47473,47474,0,6,6
47474,47474,47475,6,5,-1
47475,47475,47476,5,0,-5
47476,47476,47477,0,4,4
47477,47477,47478,4,8,4
47478,47478,47479,8,0,-8
47479,47479,47480,0,0,0
47480,47480,47481,0,3,3
47481,47481,47482,3,0,-3
47482,47482,47483,0,4,4
47483,47483,47484,4,8,4
47484,47484,47485,8,7,-1
47485,47485,47486,7,6,-1
47486,47486,47487,6,7,1
47487,47487,47488,7,0,-7
47488,47488,47489,0,9,9
47489,47489,47490,9,1,-8
47490,47490,47491,1,4,3
47491,47491,47492,4,6,2
47492,47492,47493,6,3,-3
47493,47493,47494,3,5,2
47494,47494,47495,5,7,2
47495,47495,47496,7,3,-4
47496,47496,47497,3,6,3
47497,47497,47498,6,8,2
47498,47498,47499,8,2,-6
47499,47499,47500,2,4,2
47500,47500,47501,4,1,-3
47501,47501,47502,1,1,0
47502,47502,47503,1,5,4
47503,47503,47504,5,7,2
47504,47504,47505,7,8,1
47505,47505,47506,8,8,0
47506,47506,47507,8,4,-4
47507,47507,47508,4,2,-2
47508,47508,47509,2,6,4
47509,47509,47510,6,3,-3
47510,47510,47511,3,7,4
47511,47511,47512,7,8,1
47512,47512,47513,8,0,-8
47513,47513,47514,0,3,3
47514,47514,47515,3,2,-1
47515,47515,47516,2,1,-1
47516,47516,47517,1,9,8
47517,47517,47518,9,4,-5
47518,47518,47519,4,3,-1
47519,47519,47520,3,3,0
47520,47520,47521,3,4,1
47521,47521,47522,4,2,-2
47522,47522,47523,2,4,2
47523,47523,47524,4,6,2
47524,47524,47525,6,8,2
47525,47525,47526,8,5,-3
47526,47526,47527,5,1,-4
47527,47527,47528,1,5,4
47528,47528,47529,5,2,-3
47529,47529,47530,2,2,0
47530,47530,47531,2,2,0
47531,47531,47532,2,4,2
47532,47532,47533,4,3,-1
47533,47533,47534,3,2,-1
47534,47534,47535,2,1,-1
47535,47535,47536,1,7,6
47536,47536,47537,7,7,0
47537,47537,47538,7,8,1
47538,47538,47539,8,3,-5
47539,47539,47540,3,9,6
47540,47540,47541,9,4,-5
47541,47541,47542,4,1,-3
47542,47542,47543,1,5,4
47543,47543,47544,5,7,2
47544,47544,47545,7,1,-6
47545,47545,47546,1,8,7
47546,47546,47547,8,9,1
47547,47547,47548,9,8,-1
47548,47548,47549,8,8,0
47549,47549,47550,8,8,0
47550,47550,47551,8,1,-7
47551,47551,47552,1,0,-1
47552,47552,47553,0,1,1
47553,47553,47554,1,5,4
47554,47554,47555,5,0,-5
47555,47555,47556,0,9,9
47556,47556,47557,9,2,-7
47557,47557,47558,2,4,2
47558,47558,47559,4,7,3
47559,47559,47560,7,7,0
47560,47560,47561,7,6,-1
47561,47561,47562,6,6,0
47562,47562,47563,6,8,2
47563,47563,47564,8,6,-2
47564,47564,47565,6,2,-4
47565,47565,47566,2,4,2
47566,47566,47567,4,8,4
47567,47567,47568,8,7,-1
47568,47568,47569,7,4,-3
47569,47569,47570,4,7,3
47570,47570,47571,7,4,-3
47571,47571,47572,4,0,-4
47572,47572,47573,0,2,2
47573,47573,47574,2,6,4
47574,47574,47575,6,2,-4
47575,47575,47576,2,1,-1
47576,47576,47577,1,8,7
47577,47577,47578,8,2,-6
47578,47578,47579,2,0,-2
47579,47579,47580,0,1,1
47580,47580,47581,1,0,-1
47581,47581,47582,0,8,8
47582,47582,47583,8,1,-7
47583,47583,47584,1,6,5
47584,47584,47585,6,2,-4
47585,47585,47586,2,5,3
47586,47586,47587,5,3,-2
47587,47587,47588,3,9,6
47588,47588,47589,9,4,-5
47589,47589,47590,4,2,-2
47590,47590,47591,2,5,3
47591,47591,47592,5,3,-2
47592,47592,47593,3,6,3
47593,47593,47594,6,3,-3
47594,47594,47595,3,7,4
47595,47595,47596,7,7,0
47596,47596,47597,7,8,1
47597,47597,47598,8,2,-6
47598,47598,47599,2,0,-2
47599,47599,47600,0,7,7
47600,47600,47601,7,1,-6
47601,47601,47602,1,3,2
47602,47602,47603,3,2,-1
47603,47603,47604,2,7,5
47604,47604,47605,7,3,-4
47605,47605,47606,3,4,1
47606,47606,47607,4,4,0
47607,47607,47608,4,4,0
47608,47608,47609,4,5,1
47609,47609,47610,5,2,-3
47610,47610,47611,2,6,4
47611,47611,47612,6,2,-4
47612,47612,47613,2,7,5
47613,47613,47614,7,2,-5
47614,47614,47615,2,8,6
47615,47615,47616,8,0,-8
47616,47616,47617,0,9,9
47617,47617,47618,9,3,-6
47618,47618,47619,3,0,-3
47619,47619,47620,0,3,3
47620,47620,47621,3,1,-2
47621,47621,47622,1,5,4
47622,47622,47623,5,2,-3
47623,47623,47624,2,5,3
47624,47624,47625,5,3,-2
47625,47625,47626,3,0,-3
47626,47626,47627,0,4,4
47627,47627,47628,4,3,-1
47628,47628,47629,3,5,2
47629,47629,47630,5,5,0
47630,47630,47631,5,6,1
47631,47631,47632,6,8,2
47632,47632,47633,8,7,-1
47633,47633,47634,7,8,1
47634,47634,47635,8,8,0
47635,47635,47636,8,6,-2
47636,47636,47637,6,9,3
47637,47637,47638,9,1,-8
47638,47638,47639,1,0,-1
47639,47639,47640,0,7,7
47640,47640,47641,7,5,-2
47641,47641,47642,5,1,-4
47642,47642,47643,1,3,2
47643,47643,47644,3,1,-2
47644,47644,47645,1,9,8
47645,47645,47646,9,5,-4
47646,47646,47647,5,0,-5
47647,47647,47648,0,8,8
47648,47648,47649,8,2,-6
47649,47649,47650,2,2,0
47650,47650,47651,2,3,1
47651,47651,47652,3,2,-1
47652,47652,47653,2,3,1
47653,47653,47654,3,3,0
47654,47654,47655,3,3,0
47655,47655,47656,3,8,5
47656,47656,47657,8,9,1
47657,47657,47658,9,2,-7
47658,47658,47659,2,9,7
47659,47659,47660,9,8,-1
47660,47660,47661,8,5,-3
47661,47661,47662,5,9,4
47662,47662,47663,9,6,-3
47663,47663,47664,6,9,3
47664,47664,47665,9,4,-5
47665,47665,47666,4,7,3
47666,47666,47667,7,2,-5
47667,47667,47668,2,1,-1
47668,47668,47669,1,3,2
47669,47669,47670,3,1,-2
47670,47670,47671,1,9,8
47671,47671,47672,9,1,-8
47672,47672,47673,1,6,5
47673,47673,47674,6,4,-2
47674,47674,47675,4,8,4
47675,47675,47676,8,3,-5
47676,47676,47677,3,7,4
47677,47677,47678,7,3,-4
47678,47678,47679,3,9,6
47679,47679,47680,9,4,-5
47680,47680,47681,4,1,-3
47681,47681,47682,1,7,6
47682,47682,47683,7,5,-2
47683,47683,47684,5,3,-2
47684,47684,47685,3,2,-1
47685,47685,47686,2,2,0
47686,47686,47687,2,6,4
47687,47687,47688,6,2,-4
47688,47688,47689,2,3,1
47689,47689,47690,3,0,-3
47690,47690,47691,0,4,4
47691,47691,47692,4,1,-3
47692,47692,47693,1,0,-1
47693,47693,47694,0,6,6
47694,47694,47695,6,4,-2
47695,47695,47696,4,0,-4
47696,47696,47697,0,1,1
47697,47697,47698,1,7,6
47698,47698,47699,7,6,-1
47699,47699,47700,6,7,1
47700,47700,47701,7,4,-3
47701,47701,47702,4,1,-3
47702,47702,47703,1,9,8
47703,47703,47704,9,0,-9
47704,47704,47705,0,6,6
47705,47705,47706,6,2,-4
47706,47706,47707,2,5,3
47707,47707,47708,5,4,-1
47708,47708,47709,4,1,-3
47709,47709,47710,1,2,1
47710,47710,47711,2,2,0
47711,47711,47712,2,9,7
47712,47712,47713,9,6,-3
47713,47713,47714,6,0,-6
47714,47714,47715,0,6,6
47715,47715,47716,6,0,-6
47716,47716,47717,0,7,7
47717,47717,47718,7,5,-2
47718,47718,47719,5,8,3
47719,47719,47720,8,3,-5
47720,47720,47721,3,1,-2
47721,47721,47722,1,0,-1
47722,47722,47723,0,8,8
47723,47723,47724,8,3,-5
47724,47724,47725,3,3,0
47725,47725,47726,3,8,5
47726,47726,47727,8,7,-1
47727,47727,47728,7,8,1
47728,47728,47729,8,1,-7
47729,47729,47730,1,8,7
47730,47730,47731,8,2,-6
47731,47731,47732,2,4,2
47732,47732,47733,4,7,3
47733,47733,47734,7,1,-6
47734,47734,47735,1,1,0
47735,47735,47736,1,0,-1
47736,47736,47737,0,5,5
47737,47737,47738,5,6,1
47738,47738,47739,6,0,-6
47739,47739,47740,0,0,0
47740,47740,47741,0,5,5
47741,47741,47742,5,3,-2
47742,47742,47743,3,2,-1
47743,47743,47744,2,4,2
47744,47744,47745,4,9,5
47745,47745,47746,9,3,-6
47746,47746,47747,3,8,5
47747,47747,47748,8,8,0
47748,47748,47749,8,3,-5
47749,47749,47750,3,4,1
47750,47750,47751,4,1,-3
47751,47751,47752,1,0,-1
47752,47752,47753,0,8,8
47753,47753,47754,8,2,-6
47754,47754,47755,2,9,7
47755,47755,47756,9,0,-9
47756,47756,47757,0,5,5
47757,47757,47758,5,1,-4
47758,47758,47759,1,2,1
47759,47759,47760,2,3,1
47760,47760,47761,3,6,3
47761,47761,47762,6,9,3
47762,47762,47763,9,4,-5
47763,47763,47764,4,4,0
47764,47764,47765,4,8,4
47765,47765,47766,8,9,1
47766,47766,47767,9,2,-7
47767,47767,47768,2,5,3
47768,47768,47769,5,5,0
47769,47769,47770,5,1,-4
47770,47770,47771,1,4,3
47771,47771,47772,4,6,2
47772,47772,47773,6,1,-5
47773,47773,47774,1,6,5
47774,47774,47775,6,7,1
47775,47775,47776,7,1,-6
47776,47776,47777,1,1,0
47777,47777,47778,1,6,5
47778,47778,47779,6,4,-2
47779,47779,47780,4,2,-2
47780,47780,47781,2,3,1
47781,47781,47782,3,2,-1
47782,47782,47783,2,9,7
47783,47783,47784,9,1,-8
47784,47784,47785,1,1,0
47785,47785,47786,1,0,-1
47786,47786,47787,0,2,2
47787,47787,47788,2,9,7
47788,47788,47789,9,6,-3
47789,47789,47790,6,1,-5
47790,47790,47791,1,0,-1
47791,47791,47792,0,6,6
47792,47792,47793,6,7,1
47793,47793,47794,7,6,-1
47794,47794,47795,6,3,-3
47795,47795,47796,3,1,-2
47796,47796,47797,1,0,-1
47797,47797,47798,0,6,6
47798,47798,47799,6,1,-5
47799,47799,47800,1,7,6
47800,47800,47801,7,2,-5
47801,47801,47802,2,3,1
47802,47802,47803,3,3,0
47803,47803,47804,3,2,-1
47804,47804,47805,2,4,2
47805,47805,47806,4,7,3
47806,47806,47807,7,6,-1
47807,47807,47808,6,6,0
47808,47808,47809,6,7,1
47809,47809,47810,7,6,-1
47810,47810,47811,6,8,2
47811,47811,47812,8,0,-8
47812,47812,47813,0,9,9
47813,47813,47814,9,4,-5
47814,47814,47815,4,0,-4
47815,47815,47816,0,0,0
47816,47816,47817,0,1,1
47817,47817,47818,1,3,2
47818,47818,47819,3,2,-1
47819,47819,47820,2,0,-2
47820,47820,47821,0,3,3
47821,47821,47822,3,0,-3
47822,47822,47823,0,4,4
47823,47823,47824,4,6,2
47824,47824,47825,6,5,-1
47825,47825,47826,5,4,-1
47826,47826,47827,4,6,2
47827,47827,47828,6,5,-1
47828,47828,47829,5,7,2
47829,47829,47830,7,1,-6
47830,47830,47831,1,8,7
47831,47831,47832,8,5,-3
47832,47832,47833,5,9,4
47833,47833,47834,9,3,-6
47834,47834,47835,3,0,-3
47835,47835,47836,0,9,9
47836,47836,47837,9,1,-8
47837,47837,47838,1,3,2
47838,47838,47839,3,2,-1
47839,47839,47840,2,6,4
47840,47840,47841,6,3,-3
47841,47841,47842,3,2,-1
47842,47842,47843,2,4,2
47843,47843,47844,4,7,3
47844,47844,47845,7,5,-2
47845,47845,47846,5,5,0
47846,47846,47847,5,6,1
47847,47847,47848,6,5,-1
47848,47848,47849,5,7,2
47849,47849,47850,7,1,-6
47850,47850,47851,1,8,7
47851,47851,47852,8,7,-1
47852,47852,47853,7,9,2
47853,47853,47854,9,5,-4
47854,47854,47855,5,0,-5
47855,47855,47856,0,5,5
47856,47856,47857,5,8,3
47857,47857,47858,8,5,-3
47858,47858,47859,5,7,2
47859,47859,47860,7,0,-7
47860,47860,47861,0,8,8
47861,47861,47862,8,2,-6
47862,47862,47863,2,9,7
47863,47863,47864,9,6,-3
47864,47864,47865,6,9,3
47865,47865,47866,9,5,-4
47866,47866,47867,5,0,-5
47867,47867,47868,0,1,1
47868,47868,47869,1,1,0
47869,47869,47870,1,9,8
47870,47870,47871,9,4,-5
47871,47871,47872,4,3,-1
47872,47872,47873,3,5,2
47873,47873,47874,5,9,4
47874,47874,47875,9,1,-8
47875,47875,47876,1,3,2
47876,47876,47877,3,6,3
47877,47877,47878,6,9,3
47878,47878,47879,9,7,-2
47879,47879,47880,7,1,-6
47880,47880,47881,1,3,2
47881,47881,47882,3,8,5
47882,47882,47883,8,2,-6
47883,47883,47884,2,4,2
47884,47884,47885,4,9,5
47885,47885,47886,9,8,-1
47886,47886,47887,8,0,-8
47887,47887,47888,0,8,8
47888,47888,47889,8,5,-3
47889,47889,47890,5,2,-3
47890,47890,47891,2,6,4
47891,47891,47892,6,8,2
47892,47892,47893,8,7,-1
47893,47893,47894,7,9,2
47894,47894,47895,9,3,-6
47895,47895,47896,3,8,5
47896,47896,47897,8,9,1
47897,47897,47898,9,7,-2
47898,47898,47899,7,9,2
47899,47899,47900,9,2,-7
47900,47900,47901,2,3,1
47901,47901,47902,3,0,-3
47902,47902,47903,0,8,8
47903,47903,47904,8,1,-7
47904,47904,47905,1,1,0
47905,47905,47906,1,7,6
47906,47906,47907,7,2,-5
47907,47907,47908,2,1,-1
47908,47908,47909,1,9,8
47909,47909,47910,9,1,-8
47910,47910,47911,1,6,5
47911,47911,47912,6,2,-4
47912,47912,47913,2,3,1
47913,47913,47914,3,0,-3
47914,47914,47915,0,5,5
47915,47915,47916,5,6,1
47916,47916,47917,6,0,-6
47917,47917,47918,0,9,9
47918,47918,47919,9,5,-4
47919,47919,47920,5,5,0
47920,47920,47921,5,4,-1
47921,47921,47922,4,2,-2
47922,47922,47923,2,0,-2
47923,47923,47924,0,2,2
47924,47924,47925,2,3,1
47925,47925,47926,3,8,5
47926,47926,47927,8,4,-4
47927,47927,47928,4,1,-3
47928,47928,47929,1,7,6
47929,47929,47930,7,3,-4
47930,47930,47931,3,7,4
47931,47931,47932,7,6,-1
47932,47932,47933,6,9,3
47933,47933,47934,9,5,-4
47934,47934,47935,5,1,-4
47935,47935,47936,1,8,7
47936,47936,47937,8,4,-4
47937,47937,47938,4,5,1
47938,47938,47939,5,3,-2
47939,47939,47940,3,5,2
47940,47940,47941,5,7,2
47941,47941,47942,7,8,1
47942,47942,47943,8,6,-2
47943,47943,47944,6,5,-1
47944,47944,47945,5,2,-3
47945,47945,47946,2,3,1
47946,47946,47947,3,1,-2
47947,47947,47948,1,8,7
47948,47948,47949,8,5,-3
47949,47949,47950,5,3,-2
47950,47950,47951,3,5,2
47951,47951,47952,5,5,0
47952,47952,47953,5,0,-5
47953,47953,47954,0,6,6
47954,47954,47955,6,5,-1
47955,47955,47956,5,2,-3
47956,47956,47957,2,0,-2
47957,47957,47958,0,9,9
47958,47958,47959,9,8,-1
47959,47959,47960,8,1,-7
47960,47960,47961,1,4,3
47961,47961,47962,4,6,2
47962,47962,47963,6,6,0
47963,47963,47964,6,8,2
47964,47964,47965,8,2,-6
47965,47965,47966,2,2,0
47966,47966,47967,2,8,6
47967,47967,47968,8,5,-3
47968,47968,47969,5,1,-4
47969,47969,47970,1,3,2
47970,47970,47971,3,2,-1
47971,47971,47972,2,5,3
47972,47972,47973,5,2,-3
47973,47973,47974,2,9,7
47974,47974,47975,9,3,-6
47975,47975,47976,3,0,-3
47976,47976,47977,0,1,1
47977,47977,47978,1,7,6
47978,47978,47979,7,3,-4
47979,47979,47980,3,6,3
47980,47980,47981,6,4,-2
47981,47981,47982,4,1,-3
47982,47982,47983,1,5,4
47983,47983,47984,5,2,-3
47984,47984,47985,2,1,-1
47985,47985,47986,1,1,0
47986,47986,47987,1,9,8
47987,47987,47988,9,7,-2
47988,47988,47989,7,8,1
47989,47989,47990,8,2,-6
47990,47990,47991,2,1,-1
47991,47991,47992,1,3,2
47992,47992,47993,3,1,-2
47993,47993,47994,1,1,0
47994,47994,47995,1,5,4
47995,47995,47996,5,4,-1
47996,47996,47997,4,0,-4
47997,47997,47998,0,1,1
47998,47998,47999,1,2,1
47999,47999,48000,2,4,2
48000,48000,48001,4,7,3
48001,48001,48002,7,8,1
48002,48002,48003,8,8,0
48003,48003,48004,8,5,-3
48004,48004,48005,5,6,1
48005,48005,48006,6,6,0
48006,48006,48007,6,8,2
48007,48007,48008,8,2,-6
48008,48008,48009,2,2,0
48009,48009,48010,2,7,5
48010,48010,48011,7,8,1
48011,48011,48012,8,0,-8
48012,48012,48013,0,4,4
48013,48013,48014,4,3,-1
48014,48014,48015,3,4,1
48015,48015,48016,4,5,1
48016,48016,48017,5,2,-3
48017,48017,48018,2,4,2
48018,48018,48019,4,2,-2
48019,48019,48020,2,4,2
48020,48020,48021,4,8,4
48021,48021,48022,8,1,-7
48022,48022,48023,1,0,-1
48023,48023,48024,0,1,1
48024,48024,48025,1,0,-1
48025,48025,48026,0,0,0
48026,48026,48027,0,1,1
48027,48027,48028,1,8,7
48028,48028,48029,8,2,-6
48029,48029,48030,2,9,7
48030,48030,48031,9,3,-6
48031,48031,48032,3,6,3
48032,48032,48033,6,6,0
48033,48033,48034,6,2,-4
48034,48034,48035,2,7,5
48035,48035,48036,7,9,2
48036,48036,48037,9,8,-1
48037,48037,48038,8,3,-5
48038,48038,48039,3,0,-3
48039,48039,48040,0,1,1
48040,48040,48041,1,1,0
48041,48041,48042,1,9,8
48042,48042,48043,9,2,-7
48043,48043,48044,2,1,-1
48044,48044,48045,1,3,2
48045,48045,48046,3,5,2
48046,48046,48047,5,4,-1
48047,48047,48048,4,4,0
48048,48048,48049,4,5,1
48049,48049,48050,5,7,2
48050,48050,48051,7,6,-1
48051,48051,48052,6,6,0
48052,48052,48053,6,7,1
48053,48053,48054,7,6,-1
48054,48054,48055,6,8,2
48055,48055,48056,8,4,-4
48056,48056,48057,4,9,5
48057,48057,48058,9,5,-4
48058,48058,48059,5,0,-5
48059,48059,48060,0,8,8
48060,48060,48061,8,1,-7
48061,48061,48062,1,8,7
48062,48062,48063,8,2,-6
48063,48063,48064,2,3,1
48064,48064,48065,3,3,0
48065,48065,48066,3,6,3
48066,48066,48067,6,4,-2
48067,48067,48068,4,4,0
48068,48068,48069,4,5,1
48069,48069,48070,5,2,-3
48070,48070,48071,2,6,4
48071,48071,48072,6,9,3
48072,48072,48073,9,7,-2
48073,48073,48074,7,1,-6
48074,48074,48075,1,8,7
48075,48075,48076,8,3,-5
48076,48076,48077,3,9,6
48077,48077,48078,9,5,-4
48078,48078,48079,5,1,-4
48079,48079,48080,1,7,6
48080,48080,48081,7,8,1
48081,48081,48082,8,6,-2
48082,48082,48083,6,6,0
48083,48083,48084,6,4,-2
48084,48084,48085,4,1,-3
48085,48085,48086,1,6,5
48086,48086,48087,6,4,-2
48087,48087,48088,4,3,-1
48088,48088,48089,3,9,6
48089,48089,48090,9,6,-3
48090,48090,48091,6,3,-3
48091,48091,48092,3,8,5
48092,48092,48093,8,7,-1
48093,48093,48094,7,5,-2
48094,48094,48095,5,7,2
48095,48095,48096,7,7,0
48096,48096,48097,7,9,2
48097,48097,48098,9,7,-2
48098,48098,48099,7,1,-6
48099,48099,48100,1,7,6
48100,48100,48101,7,8,1
48101,48101,48102,8,7,-1
48102,48102,48103,7,4,-3
48103,48103,48104,4,8,4
48104,48104,48105,8,7,-1
48105,48105,48106,7,8,1
48106,48106,48107,8,2,-6
48107,48107,48108,2,7,5
48108,48108,48109,7,2,-5
48109,48109,48110,2,8,6
48110,48110,48111,8,0,-8
48111,48111,48112,0,1,1
48112,48112,48113,1,5,4
48113,48113,48114,5,6,1
48114,48114,48115,6,8,2
48115,48115,48116,8,6,-2
48116,48116,48117,6,6,0
48117,48117,48118,6,2,-4
48118,48118,48119,2,1,-1
48119,48119,48120,1,4,3
48120,48120,48121,4,0,-4
48121,48121,48122,0,7,7
48122,48122,48123,7,4,-3
48123,48123,48124,4,7,3
48124,48124,48125,7,7,0
48125,48125,48126,7,1,-6
48126,48126,48127,1,1,0
48127,48127,48128,1,0,-1
48128,48128,48129,0,2,2
48129,48129,48130,2,9,7
48130,48130,48131,9,1,-8
48131,48131,48132,1,5,4
48132,48132,48133,5,6,1
48133,48133,48134,6,5,-1
48134,48134,48135,5,7,2
48135,48135,48136,7,0,-7
48136,48136,48137,0,3,3
48137,48137,48138,3,8,5
48138,48138,48139,8,3,-5
48139,48139,48140,3,8,5
48140,48140,48141,8,6,-2
48141,48141,48142,6,0,-6
48142,48142,48143,0,5,5
48143,48143,48144,5,7,2
48144,48144,48145,7,6,-1
48145,48145,48146,6,7,1
48146,48146,48147,7,2,-5
48147,48147,48148,2,9,7
48148,48148,48149,9,8,-1
48149,48149,48150,8,8,0
48150,48150,48151,8,7,-1
48151,48151,48152,7,6,-1
48152,48152,48153,6,6,0
48153,48153,48154,6,9,3
48154,48154,48155,9,8,-1
48155,48155,48156,8,6,-2
48156,48156,48157,6,9,3
48157,48157,48158,9,2,-7
48158,48158,48159,2,9,7
48159,48159,48160,9,8,-1
48160,48160,48161,8,5,-3
48161,48161,48162,5,8,3
48162,48162,48163,8,3,-5
48163,48163,48164,3,3,0
48164,48164,48165,3,7,4
48165,48165,48166,7,7,0
48166,48166,48167,7,0,-7
48167,48167,48168,0,0,0
48168,48168,48169,0,6,6
48169,48169,48170,6,7,1
48170,48170,48171,7,9,2
48171,48171,48172,9,4,-5
48172,48172,48173,4,0,-4
48173,48173,48174,0,3,3
48174,48174,48175,3,1,-2
48175,48175,48176,1,0,-1
48176,48176,48177,0,1,1
48177,48177,48178,1,2,1
48178,48178,48179,2,3,1
48179,48179,48180,3,0,-3
48180,48180,48181,0,2,2
48181,48181,48182,2,9,7
48182,48182,48183,9,1,-8
48183,48183,48184,1,1,0
48184,48184,48185,1,0,-1
48185,48185,48186,0,9,9
48186,48186,48187,9,0,-9
48187,48187,48188,0,6,6
48188,48188,48189,6,1,-5
48189,48189,48190,1,7,6
48190,48190,48191,7,2,-5
48191,48191,48192,2,8,6
48192,48192,48193,8,3,-5
48193,48193,48194,3,4,1
48194,48194,48195,4,4,0
48195,48195,48196,4,0,-4
48196,48196,48197,0,5,5
48197,48197,48198,5,4,-1
48198,48198,48199,4,6,2
48199,48199,48200,6,0,-6
48200,48200,48201,0,7,7
48201,48201,48202,7,4,-3
48202,48202,48203,4,8,4
48203,48203,48204,8,8,0
48204,48204,48205,8,9,1
48205,48205,48206,9,8,-1
48206,48206,48207,8,0,-8
48207,48207,48208,0,7,7
48208,48208,48209,7,1,-6
48209,48209,48210,1,0,-1
48210,48210,48211,0,2,2
48211,48211,48212,2,2,0
48212,48212,48213,2,3,1
48213,48213,48214,3,5,2
48214,48214,48215,5,4,-1
48215,48215,48216,4,4,0
48216,48216,48217,4,5,1
48217,48217,48218,5,0,-5
48218,48218,48219,0,6,6
48219,48219,48220,6,2,-4
48220,48220,48221,2,7,5
48221,48221,48222,7,9,2
48222,48222,48223,9,8,-1
48223,48223,48224,8,9,1
48224,48224,48225,9,9,0
48225,48225,48226,9,1,-8
48226,48226,48227,1,0,-1
48227,48227,48228,0,7,7
48228,48228,48229,7,1,-6
48229,48229,48230,1,5,4
48230,48230,48231,5,2,-3
48231,48231,48232,2,1,-1
48232,48232,48233,1,3,2
48233,48233,48234,3,9,6
48234,48234,48235,9,4,-5
48235,48235,48236,4,1,-3
48236,48236,48237,1,5,4
48237,48237,48238,5,2,-3
48238,48238,48239,2,6,4
48239,48239,48240,6,4,-2
48240,48240,48241,4,7,3
48241,48241,48242,7,7,0
48242,48242,48243,7,8,1
48243,48243,48244,8,9,1
48244,48244,48245,9,9,0
48245,48245,48246,9,2,-7
48246,48246,48247,2,7,5
48247,48247,48248,7,2,-5
48248,48248,48249,2,5,3
48249,48249,48250,5,7,2
48250,48250,48251,7,5,-2
48251,48251,48252,5,4,-1
48252,48252,48253,4,1,-3
48253,48253,48254,1,1,0
48254,48254,48255,1,9,8
48255,48255,48256,9,8,-1
48256,48256,48257,8,9,1
48257,48257,48258,9,3,-6
48258,48258,48259,3,7,4
48259,48259,48260,7,5,-2
48260,48260,48261,5,1,-4
48261,48261,48262,1,6,5
48262,48262,48263,6,0,-6
48263,48263,48264,0,3,3
48264,48264,48265,3,9,6
48265,48265,48266,9,1,-8
48266,48266,48267,1,0,-1
48267,48267,48268,0,0,0
48268,48268,48269,0,5,5
48269,48269,48270,5,2,-3
48270,48270,48271,2,7,5
48271,48271,48272,7,9,2
48272,48272,48273,9,1,-8
48273,48273,48274,1,0,-1
48274,48274,48275,0,7,7
48275,48275,48276,7,6,-1
48276,48276,48277,6,2,-4
48277,48277,48278,2,6,4
48278,48278,48279,6,2,-4
48279,48279,48280,2,8,6
48280,48280,48281,8,3,-5
48281,48281,48282,3,4,1
48282,48282,48283,4,6,2
48283,48283,48284,6,0,-6
48284,48284,48285,0,8,8
48285,48285,48286,8,4,-4
48286,48286,48287,4,0,-4
48287,48287,48288,0,4,4
48288,48288,48289,4,8,4
48289,48289,48290,8,9,1
48290,48290,48291,9,3,-6
48291,48291,48292,3,2,-1
48292,48292,48293,2,2,0
48293,48293,48294,2,2,0
48294,48294,48295,2,0,-2
48295,48295,48296,0,8,8
48296,48296,48297,8,9,1
48297,48297,48298,9,7,-2
48298,48298,48299,7,0,-7
48299,48299,48300,0,3,3
48300,48300,48301,3,6,3
48301,48301,48302,6,3,-3
48302,48302,48303,3,1,-2
48303,48303,48304,1,9,8
48304,48304,48305,9,7,-2
48305,48305,48306,7,1,-6
48306,48306,48307,1,5,4
48307,48307,48308,5,7,2
48308,48308,48309,7,8,1
48309,48309,48310,8,4,-4
48310,48310,48311,4,3,-1
48311,48311,48312,3,8,5
48312,48312,48313,8,4,-4
48313,48313,48314,4,4,0
48314,48314,48315,4,7,3
48315,48315,48316,7,4,-3
48316,48316,48317,4,6,2
48317,48317,48318,6,1,-5
48318,48318,48319,1,6,5
48319,48319,48320,6,2,-4
48320,48320,48321,2,3,1
48321,48321,48322,3,0,-3
48322,48322,48323,0,2,2
48323,48323,48324,2,3,1
48324,48324,48325,3,3,0
48325,48325,48326,3,1,-2
48326,48326,48327,1,4,3
48327,48327,48328,4,6,2
48328,48328,48329,6,8,2
48329,48329,48330,8,9,1
48330,48330,48331,9,8,-1
48331,48331,48332,8,2,-6
48332,48332,48333,2,7,5
48333,48333,48334,7,2,-5
48334,48334,48335,2,1,-1
48335,48335,48336,1,3,2
48336,48336,48337,3,0,-3
48337,48337,48338,0,6,6
48338,48338,48339,6,8,2
48339,48339,48340,8,6,-2
48340,48340,48341,6,7,1
48341,48341,48342,7,4,-3
48342,48342,48343,4,7,3
48343,48343,48344,7,9,2
48344,48344,48345,9,5,-4
48345,48345,48346,5,6,1
48346,48346,48347,6,9,3
48347,48347,48348,9,5,-4
48348,48348,48349,5,2,-3
48349,48349,48350,2,0,-2
48350,48350,48351,0,8,8
48351,48351,48352,8,3,-5
48352,48352,48353,3,5,2
48353,48353,48354,5,2,-3
48354,48354,48355,2,3,1
48355,48355,48356,3,2,-1
48356,48356,48357,2,4,2
48357,48357,48358,4,5,1
48358,48358,48359,5,6,1
48359,48359,48360,6,3,-3
48360,48360,48361,3,1,-2
48361,48361,48362,1,6,5
48362,48362,48363,6,1,-5
48363,48363,48364,1,0,-1
48364,48364,48365,0,4,4
48365,48365,48366,4,6,2
48366,48366,48367,6,5,-1
48367,48367,48368,5,1,-4
48368,48368,48369,1,5,4
48369,48369,48370,5,6,1
48370,48370,48371,6,0,-6
48371,48371,48372,0,8,8
48372,48372,48373,8,4,-4
48373,48373,48374,4,5,1
48374,48374,48375,5,8,3
48375,48375,48376,8,4,-4
48376,48376,48377,4,7,3
48377,48377,48378,7,2,-5
48378,48378,48379,2,4,2
48379,48379,48380,4,6,2
48380,48380,48381,6,9,3
48381,48381,48382,9,8,-1
48382,48382,48383,8,2,-6
48383,48383,48384,2,9,7
48384,48384,48385,9,3,-6
48385,48385,48386,3,3,0
48386,48386,48387,3,6,3
48387,48387,48388,6,9,3
48388,48388,48389,9,4,-5
48389,48389,48390,4,1,-3
48390,48390,48391,1,2,1
48391,48391,48392,2,3,1
48392,48392,48393,3,4,1
48393,48393,48394,4,8,4
48394,48394,48395,8,1,-7
48395,48395,48396,1,3,2
48396,48396,48397,3,5,2
48397,48397,48398,5,6,1
48398,48398,48399,6,4,-2
48399,48399,48400,4,5,1
48400,48400,48401,5,2,-3
48401,48401,48402,2,4,2
48402,48402,48403,4,0,-4
48403,48403,48404,0,7,7
48404,48404,48405,7,4,-3
48405,48405,48406,4,8,4
48406,48406,48407,8,8,0
48407,48407,48408,8,5,-3
48408,48408,48409,5,6,1
48409,48409,48410,6,4,-2
48410,48410,48411,4,1,-3
48411,48411,48412,1,0,-1
48412,48412,48413,0,9,9
48413,48413,48414,9,0,-9
48414,48414,48415,0,3,3
48415,48415,48416,3,7,4
48416,48416,48417,7,2,-5
48417,48417,48418,2,4,2
48418,48418,48419,4,0,-4
48419,48419,48420,0,2,2
48420,48420,48421,2,0,-2
48421,48421,48422,0,7,7
48422,48422,48423,7,2,-5
48423,48423,48424,2,5,3
48424,48424,48425,5,5,0
48425,48425,48426,5,3,-2
48426,48426,48427,3,6,3
48427,48427,48428,6,8,2
48428,48428,48429,8,9,1
48429,48429,48430,9,6,-3
48430,48430,48431,6,3,-3
48431,48431,48432,3,7,4
48432,48432,48433,7,6,-1
48433,48433,48434,6,0,-6
48434,48434,48435,0,3,3
48435,48435,48436,3,4,1
48436,48436,48437,4,6,2
48437,48437,48438,6,0,-6
48438,48438,48439,0,0,0
48439,48439,48440,0,5,5
48440,48440,48441,5,1,-4
48441,48441,48442,1,4,3
48442,48442,48443,4,2,-2
48443,48443,48444,2,1,-1
48444,48444,48445,1,3,2
48445,48445,48446,3,2,-1
48446,48446,48447,2,4,2
48447,48447,48448,4,4,0
48448,48448,48449,4,5,1
48449,48449,48450,5,7,2
48450,48450,48451,7,6,-1
48451,48451,48452,6,7,1
48452,48452,48453,7,7,0
48453,48453,48454,7,1,-6
48454,48454,48455,1,8,7
48455,48455,48456,8,1,-7
48456,48456,48457,1,9,8
48457,48457,48458,9,1,-8
48458,48458,48459,1,0,-1
48459,48459,48460,0,2,2
48460,48460,48461,2,1,-1
48461,48461,48462,1,2,1
48462,48462,48463,2,2,0
48463,48463,48464,2,1,-1
48464,48464,48465,1,3,2
48465,48465,48466,3,4,1
48466,48466,48467,4,4,0
48467,48467,48468,4,1,-3
48468,48468,48469,1,5,4
48469,48469,48470,5,4,-1
48470,48470,48471,4,6,2
48471,48471,48472,6,8,2
48472,48472,48473,8,7,-1
48473,48473,48474,7,2,-5
48474,48474,48475,2,8,6
48475,48475,48476,8,2,-6
48476,48476,48477,2,9,7
48477,48477,48478,9,4,-5
48478,48478,48479,4,0,-4
48479,48479,48480,0,3,3
48480,48480,48481,3,1,-2
48481,48481,48482,1,3,2
48482,48482,48483,3,2,-1
48483,48483,48484,2,9,7
48484,48484,48485,9,3,-6
48485,48485,48486,3,4,1
48486,48486,48487,4,4,0
48487,48487,48488,4,0,-4
48488,48488,48489,0,5,5
48489,48489,48490,5,7,2
48490,48490,48491,7,6,-1
48491,48491,48492,6,6,0
48492,48492,48493,6,6,0
48493,48493,48494,6,8,2
48494,48494,48495,8,8,0
48495,48495,48496,8,4,-4
48496,48496,48497,4,2,-2
48497,48497,48498,2,3,1
48498,48498,48499,3,3,0
48499,48499,48500,3,3,0
48500,48500,48501,3,7,4
48501,48501,48502,7,2,-5
48502,48502,48503,2,8,6
48503,48503,48504,8,9,1
48504,48504,48505,9,6,-3
48505,48505,48506,6,2,-4
48506,48506,48507,2,6,4
48507,48507,48508,6,4,-2
48508,48508,48509,4,8,4
48509,48509,48510,8,1,-7
48510,48510,48511,1,0,-1
48511,48511,48512,0,5,5
48512,48512,48513,5,1,-4
48513,48513,48514,1,4,3
48514,48514,48515,4,7,3
48515,48515,48516,7,2,-5
48516,48516,48517,2,1,-1
48517,48517,48518,1,1,0
48518,48518,48519,1,7,6
48519,48519,48520,7,4,-3
48520,48520,48521,4,3,-1
48521,48521,48522,3,4,1
48522,48522,48523,4,0,-4
48523,48523,48524,0,9,9
48524,48524,48525,9,2,-7
48525,48525,48526,2,0,-2
48526,48526,48527,0,2,2
48527,48527,48528,2,8,6
48528,48528,48529,8,0,-8
48529,48529,48530,0,9,9
48530,48530,48531,9,2,-7
48531,48531,48532,2,0,-2
48532,48532,48533,0,5,5
48533,48533,48534,5,1,-4
48534,48534,48535,1,4,3
48535,48535,48536,4,2,-2
48536,48536,48537,2,1,-1
48537,48537,48538,1,6,5
48538,48538,48539,6,6,0
48539,48539,48540,6,8,2
48540,48540,48541,8,5,-3
48541,48541,48542,5,0,-5
48542,48542,48543,0,1,1
48543,48543,48544,1,8,7
48544,48544,48545,8,2,-6
48545,48545,48546,2,4,2
48546,48546,48547,4,0,-4
48547,48547,48548,0,9,9
48548,48548,48549,9,2,-7
48549,48549,48550,2,2,0
48550,48550,48551,2,3,1
48551,48551,48552,3,8,5
48552,48552,48553,8,4,-4
48553,48553,48554,4,0,-4
48554,48554,48555,0,8,8
48555,48555,48556,8,7,-1
48556,48556,48557,7,3,-4
48557,48557,48558,3,4,1
48558,48558,48559,4,8,4
48559,48559,48560,8,8,0
48560,48560,48561,8,5,-3
48561,48561,48562,5,7,2
48562,48562,48563,7,3,-4
48563,48563,48564,3,5,2
48564,48564,48565,5,6,1
48565,48565,48566,6,9,3
48566,48566,48567,9,5,-4
48567,48567,48568,5,6,1
48568,48568,48569,6,9,3
48569,48569,48570,9,6,-3
48570,48570,48571,6,8,2
48571,48571,48572,8,5,-3
48572,48572,48573,5,1,-4
48573,48573,48574,1,0,-1
48574,48574,48575,0,7,7
48575,48575,48576,7,5,-2
48576,48576,48577,5,9,4
48577,48577,48578,9,0,-9
48578,48578,48579,0,3,3
48579,48579,48580,3,9,6
48580,48580,48581,9,4,-5
48581,48581,48582,4,4,0
48582,48582,48583,4,1,-3
48583,48583,48584,1,9,8
48584,48584,48585,9,7,-2
48585,48585,48586,7,5,-2
48586,48586,48587,5,3,-2
48587,48587,48588,3,8,5
48588,48588,48589,8,9,1
48589,48589,48590,9,6,-3
48590,48590,48591,6,6,0
48591,48591,48592,6,1,-5
48592,48592,48593,1,7,6
48593,48593,48594,7,6,-1
48594,48594,48595,6,4,-2
48595,48595,48596,4,4,0
48596,48596,48597,4,9,5
48597,48597,48598,9,2,-7
48598,48598,48599,2,3,1
48599,48599,48600,3,1,-2
48600,48600,48601,1,0,-1
48601,48601,48602,0,0,0
48602,48602,48603,0,9,9
48603,48603,48604,9,0,-9
48604,48604,48605,0,6,6
48605,48605,48606,6,5,-1
48606,48606,48607,5,0,-5
48607,48607,48608,0,4,4
48608,48608,48609,4,6,2
48609,48609,48610,6,7,1
48610,48610,48611,7,1,-6
48611,48611,48612,1,0,-1
48612,48612,48613,0,0,0
48613,48613,48614,0,7,7
48614,48614,48615,7,5,-2
48615,48615,48616,5,9,4
48616,48616,48617,9,8,-1
48617,48617,48618,8,9,1
48618,48618,48619,9,7,-2
48619,48619,48620,7,6,-1
48620,48620,48621,6,2,-4
48621,48621,48622,2,7,5
48622,48622,48623,7,5,-2
48623,48623,48624,5,2,-3
48624,48624,48625,2,1,-1
48625,48625,48626,1,3,2
48626,48626,48627,3,0,-3
48627,48627,48628,0,3,3
48628,48628,48629,3,1,-2
48629,48629,48630,1,6,5
48630,48630,48631,6,0,-6
48631,48631,48632,0,6,6
48632,48632,48633,6,9,3
48633,48633,48634,9,9,0
48634,48634,48635,9,4,-5
48635,48635,48636,4,6,2
48636,48636,48637,6,5,-1
48637,48637,48638,5,0,-5
48638,48638,48639,0,7,7
48639,48639,48640,7,2,-5
48640,48640,48641,2,0,-2
48641,48641,48642,0,3,3
48642,48642,48643,3,2,-1
48643,48643,48644,2,5,3
48644,48644,48645,5,1,-4
48645,48645,48646,1,4,3
48646,48646,48647,4,9,5
48647,48647,48648,9,7,-2
48648,48648,48649,7,6,-1
48649,48649,48650,6,1,-5
48650,48650,48651,1,7,6
48651,48651,48652,7,8,1
48652,48652,48653,8,4,-4
48653,48653,48654,4,9,5
48654,48654,48655,9,8,-1
48655,48655,48656,8,6,-2
48656,48656,48657,6,8,2
48657,48657,48658,8,8,0
48658,48658,48659,8,5,-3
48659,48659,48660,5,4,-1
48660,48660,48661,4,0,-4
48661,48661,48662,0,3,3
48662,48662,48663,3,1,-2
48663,48663,48664,1,1,0
48664,48664,48665,1,2,1
48665,48665,48666,2,3,1
48666,48666,48667,3,3,0
48667,48667,48668,3,8,5
48668,48668,48669,8,4,-4
48669,48669,48670,4,0,-4
48670,48670,48671,0,5,5
48671,48671,48672,5,7,2
48672,48672,48673,7,6,-1
48673,48673,48674,6,2,-4
48674,48674,48675,2,7,5
48675,48675,48676,7,0,-7
48676,48676,48677,0,0,0
48677,48677,48678,0,7,7
48678,48678,48679,7,1,-6
48679,48679,48680,1,5,4
48680,48680,48681,5,2,-3
48681,48681,48682,2,3,1
48682,48682,48683,3,3,0
48683,48683,48684,3,8,5
48684,48684,48685,8,4,-4
48685,48685,48686,4,2,-2
48686,48686,48687,2,5,3
48687,48687,48688,5,8,3
48688,48688,48689,8,6,-2
48689,48689,48690,6,4,-2
48690,48690,48691,4,7,3
48691,48691,48692,7,6,-1
48692,48692,48693,6,8,2
48693,48693,48694,8,7,-1
48694,48694,48695,7,0,-7
48695,48695,48696,0,2,2
48696,48696,48697,2,1,-1
48697,48697,48698,1,2,1
48698,48698,48699,2,2,0
48699,48699,48700,2,3,1
48700,48700,48701,3,3,0
48701,48701,48702,3,3,0
48702,48702,48703,3,4,1
48703,48703,48704,4,8,4
48704,48704,48705,8,5,-3
48705,48705,48706,5,6,1
48706,48706,48707,6,6,0
48707,48707,48708,6,9,3
48708,48708,48709,9,7,-2
48709,48709,48710,7,4,-3
48710,48710,48711,4,8,4
48711,48711,48712,8,7,-1
48712,48712,48713,7,9,2
48713,48713,48714,9,6,-3
48714,48714,48715,6,0,-6
48715,48715,48716,0,0,0
48716,48716,48717,0,7,7
48717,48717,48718,7,9,2
48718,48718,48719,9,0,-9
48719,48719,48720,0,1,1
48720,48720,48721,1,7,6
48721,48721,48722,7,3,-4
48722,48722,48723,3,8,5
48723,48723,48724,8,7,-1
48724,48724,48725,7,3,-4
48725,48725,48726,3,8,5
48726,48726,48727,8,0,-8
48727,48727,48728,0,4,4
48728,48728,48729,4,0,-4
48729,48729,48730,0,4,4
48730,48730,48731,4,5,1
48731,48731,48732,5,3,-2
48732,48732,48733,3,5,2
48733,48733,48734,5,8,3
48734,48734,48735,8,3,-5
48735,48735,48736,3,7,4
48736,48736,48737,7,8,1
48737,48737,48738,8,2,-6
48738,48738,48739,2,8,6
48739,48739,48740,8,6,-2
48740,48740,48741,6,1,-5
48741,48741,48742,1,0,-1
48742,48742,48743,0,8,8
48743,48743,48744,8,6,-2
48744,48744,48745,6,4,-2
48745,48745,48746,4,3,-1
48746,48746,48747,3,9,6
48747,48747,48748,9,2,-7
48748,48748,48749,2,6,4
48749,48749,48750,6,9,3
48750,48750,48751,9,1,-8
48751,48751,48752,1,8,7
48752,48752,48753,8,8,0
48753,48753,48754,8,4,-4
48754,48754,48755,4,0,-4
48755,48755,48756,0,8,8
48756,48756,48757,8,2,-6
48757,48757,48758,2,9,7
48758,48758,48759,9,7,-2
48759,48759,48760,7,6,-1
48760,48760,48761,6,3,-3
48761,48761,48762,3,7,4
48762,48762,48763,7,4,-3
48763,48763,48764,4,4,0
48764,48764,48765,4,1,-3
48765,48765,48766,1,9,8
48766,48766,48767,9,2,-7
48767,48767,48768,2,7,5
48768,48768,48769,7,5,-2
48769,48769,48770,5,3,-2
48770,48770,48771,3,9,6
48771,48771,48772,9,6,-3
48772,48772,48773,6,8,2
48773,48773,48774,8,5,-3
48774,48774,48775,5,9,4
48775,48775,48776,9,6,-3
48776,48776,48777,6,5,-1
48777,48777,48778,5,6,1
48778,48778,48779,6,4,-2
48779,48779,48780,4,0,-4
48780,48780,48781,0,3,3
48781,48781,48782,3,4,1
48782,48782,48783,4,3,-1
48783,48783,48784,3,2,-1
48784,48784,48785,2,4,2
48785,48785,48786,4,4,0
48786,48786,48787,4,7,3
48787,48787,48788,7,3,-4
48788,48788,48789,3,9,6
48789,48789,48790,9,0,-9
48790,48790,48791,0,0,0
48791,48791,48792,0,6,6
48792,48792,48793,6,1,-5
48793,48793,48794,1,3,2
48794,48794,48795,3,9,6
48795,48795,48796,9,8,-1
48796,48796,48797,8,1,-7
48797,48797,48798,1,3,2
48798,48798,48799,3,2,-1
48799,48799,48800,2,5,3
48800,48800,48801,5,7,2
48801,48801,48802,7,9,2
48802,48802,48803,9,9,0
48803,48803,48804,9,9,0
48804,48804,48805,9,1,-8
48805,48805,48806,1,3,2
48806,48806,48807,3,0,-3
48807,48807,48808,0,0,0
48808,48808,48809,0,6,6
48809,48809,48810,6,6,0
48810,48810,48811,6,2,-4
48811,48811,48812,2,5,3
48812,48812,48813,5,4,-1
48813,48813,48814,4,5,1
48814,48814,48815,5,0,-5
48815,48815,48816,0,9,9
48816,48816,48817,9,3,-6
48817,48817,48818,3,9,6
48818,48818,48819,9,4,-5
48819,48819,48820,4,2,-2
48820,48820,48821,2,6,4
48821,48821,48822,6,2,-4
48822,48822,48823,2,6,4
48823,48823,48824,6,8,2
48824,48824,48825,8,5,-3
48825,48825,48826,5,5,0
48826,48826,48827,5,6,1
48827,48827,48828,6,8,2
48828,48828,48829,8,7,-1
48829,48829,48830,7,0,-7
48830,48830,48831,0,1,1
48831,48831,48832,1,7,6
48832,48832,48833,7,4,-3
48833,48833,48834,4,0,-4
48834,48834,48835,0,4,4
48835,48835,48836,4,9,5
48836,48836,48837,9,2,-7
48837,48837,48838,2,5,3
48838,48838,48839,5,6,1
48839,48839,48840,6,4,-2
48840,48840,48841,4,2,-2
48841,48841,48842,2,8,6
48842,48842,48843,8,9,1
48843,48843,48844,9,1,-8
48844,48844,48845,1,1,0
48845,48845,48846,1,4,3
48846,48846,48847,4,5,1
48847,48847,48848,5,1,-4
48848,48848,48849,1,3,2
48849,48849,48850,3,5,2
48850,48850,48851,5,1,-4
48851,48851,48852,1,7,6
48852,48852,48853,7,4,-3
48853,48853,48854,4,4,0
48854,48854,48855,4,8,4
48855,48855,48856,8,5,-3
48856,48856,48857,5,6,1
48857,48857,48858,6,6,0
48858,48858,48859,6,3,-3
48859,48859,48860,3,1,-2
48860,48860,48861,1,7,6
48861,48861,48862,7,1,-6
48862,48862,48863,1,0,-1
48863,48863,48864,0,6,6
48864,48864,48865,6,5,-1
48865,48865,48866,5,7,2
48866,48866,48867,7,6,-1
48867,48867,48868,6,3,-3
48868,48868,48869,3,7,4
48869,48869,48870,7,4,-3
48870,48870,48871,4,1,-3
48871,48871,48872,1,5,4
48872,48872,48873,5,3,-2
48873,48873,48874,3,7,4
48874,48874,48875,7,8,1
48875,48875,48876,8,4,-4
48876,48876,48877,4,2,-2
48877,48877,48878,2,7,5
48878,48878,48879,7,6,-1
48879,48879,48880,6,4,-2
48880,48880,48881,4,2,-2
48881,48881,48882,2,9,7
48882,48882,48883,9,6,-3
48883,48883,48884,6,2,-4
48884,48884,48885,2,4,2
48885,48885,48886,4,6,2
48886,48886,48887,6,2,-4
48887,48887,48888,2,9,7
48888,48888,48889,9,7,-2
48889,48889,48890,7,4,-3
48890,48890,48891,4,8,4
48891,48891,48892,8,4,-4
48892,48892,48893,4,7,3
48893,48893,48894,7,9,2
48894,48894,48895,9,0,-9
48895,48895,48896,0,1,1
48896,48896,48897,1,1,0
48897,48897,48898,1,2,1
48898,48898,48899,2,2,0
48899,48899,48900,2,1,-1
48900,48900,48901,1,3,2
48901,48901,48902,3,1,-2
48902,48902,48903,1,4,3
48903,48903,48904,4,3,-1
48904,48904,48905,3,5,2
48905,48905,48906,5,8,3
48906,48906,48907,8,6,-2
48907,48907,48908,6,1,-5
48908,48908,48909,1,7,6
48909,48909,48910,7,7,0
48910,48910,48911,7,0,-7
48911,48911,48912,0,2,2
48912,48912,48913,2,1,-1
48913,48913,48914,1,7,6
48914,48914,48915,7,2,-5
48915,48915,48916,2,1,-1
48916,48916,48917,1,3,2
48917,48917,48918,3,6,3
48918,48918,48919,6,4,-2
48919,48919,48920,4,0,-4
48920,48920,48921,0,5,5
48921,48921,48922,5,3,-2
48922,48922,48923,3,7,4
48923,48923,48924,7,9,2
48924,48924,48925,9,8,-1
48925,48925,48926,8,2,-6
48926,48926,48927,2,9,7
48927,48927,48928,9,4,-5
48928,48928,48929,4,0,-4
48929,48929,48930,0,3,3
48930,48930,48931,3,1,-2
48931,48931,48932,1,3,2
48932,48932,48933,3,2,-1
48933,48933,48934,2,2,0
48934,48934,48935,2,3,1
48935,48935,48936,3,4,1
48936,48936,48937,4,4,0
48937,48937,48938,4,9,5
48938,48938,48939,9,5,-4
48939,48939,48940,5,9,4
48940,48940,48941,9,6,-3
48941,48941,48942,6,4,-2
48942,48942,48943,4,1,-3
48943,48943,48944,1,7,6
48944,48944,48945,7,6,-1
48945,48945,48946,6,2,-4
48946,48946,48947,2,0,-2
48947,48947,48948,0,7,7
48948,48948,48949,7,1,-6
48949,48949,48950,1,5,4
48950,48950,48951,5,2,-3
48951,48951,48952,2,7,5
48952,48952,48953,7,4,-3
48953,48953,48954,4,2,-2
48954,48954,48955,2,7,5
48955,48955,48956,7,1,-6
48956,48956,48957,1,4,3
48957,48957,48958,4,6,2
48958,48958,48959,6,4,-2
48959,48959,48960,4,0,-4
48960,48960,48961,0,4,4
48961,48961,48962,4,4,0
48962,48962,48963,4,0,-4
48963,48963,48964,0,9,9
48964,48964,48965,9,3,-6
48965,48965,48966,3,5,2
48966,48966,48967,5,8,3
48967,48967,48968,8,9,1
48968,48968,48969,9,7,-2
48969,48969,48970,7,4,-3
48970,48970,48971,4,5,1
48971,48971,48972,5,4,-1
48972,48972,48973,4,8,4
48973,48973,48974,8,3,-5
48974,48974,48975,3,2,-1
48975,48975,48976,2,7,5
48976,48976,48977,7,1,-6
48977,48977,48978,1,3,2
48978,48978,48979,3,7,4
48979,48979,48980,7,9,2
48980,48980,48981,9,3,-6
48981,48981,48982,3,2,-1
48982,48982,48983,2,5,3
48983,48983,48984,5,4,-1
48984,48984,48985,4,5,1
48985,48985,48986,5,2,-3
48986,48986,48987,2,9,7
48987,48987,48988,9,7,-2
48988,48988,48989,7,1,-6
48989,48989,48990,1,4,3
48990,48990,48991,4,2,-2
48991,48991,48992,2,7,5
48992,48992,48993,7,1,-6
48993,48993,48994,1,6,5
48994,48994,48995,6,3,-3
48995,48995,48996,3,9,6
48996,48996,48997,9,8,-1
48997,48997,48998,8,3,-5
48998,48998,48999,3,6,3
48999,48999,49000,6,4,-2
49000,49000,49001,4,4,0
49001,49001,49002,4,1,-3
49002,49002,49003,1,9,8
49003,49003,49004,9,6,-3
49004,49004,49005,6,4,-2
49005,49005,49006,4,3,-1
49006,49006,49007,3,9,6
49007,49007,49008,9,1,-8
49008,49008,49009,1,2,1
49009,49009,49010,2,9,7
49010,49010,49011,9,0,-9
49011,49011,49012,0,7,7
49012,49012,49013,7,0,-7
49013,49013,49014,0,0,0
49014,49014,49015,0,4,4
49015,49015,49016,4,8,4
49016,49016,49017,8,4,-4
49017,49017,49018,4,3,-1
49018,49018,49019,3,6,3
49019,49019,49020,6,3,-3
49020,49020,49021,3,2,-1
49021,49021,49022,2,6,4
49022,49022,49023,6,5,-1
49023,49023,49024,5,7,2
49024,49024,49025,7,5,-2
49025,49025,49026,5,6,1
49026,49026,49027,6,0,-6
49027,49027,49028,0,2,2
49028,49028,49029,2,2,0
49029,49029,49030,2,9,7
49030,49030,49031,9,6,-3
49031,49031,49032,6,5,-1
49032,49032,49033,5,8,3
49033,49033,49034,8,2,-6
49034,49034,49035,2,1,-1
49035,49035,49036,1,6,5
49036,49036,49037,6,1,-5
49037,49037,49038,1,5,4
49038,49038,49039,5,9,4
49039,49039,49040,9,5,-4
49040,49040,49041,5,2,-3
49041,49041,49042,2,1,-1
49042,49042,49043,1,6,5
49043,49043,49044,6,8,2
49044,49044,49045,8,7,-1
49045,49045,49046,7,8,1
49046,49046,49047,8,6,-2
49047,49047,49048,6,5,-1
49048,49048,49049,5,6,1
49049,49049,49050,6,4,-2
49050,49050,49051,4,8,4
49051,49051,49052,8,8,0
49052,49052,49053,8,7,-1
49053,49053,49054,7,3,-4
49054,49054,49055,3,3,0
49055,49055,49056,3,7,4
49056,49056,49057,7,3,-4
49057,49057,49058,3,7,4
49058,49058,49059,7,0,-7
49059,49059,49060,0,6,6
49060,49060,49061,6,5,-1
49061,49061,49062,5,5,0
49062,49062,49063,5,7,2
49063,49063,49064,7,8,1
49064,49064,49065,8,0,-8
49065,49065,49066,0,6,6
49066,49066,49067,6,2,-4
49067,49067,49068,2,1,-1
49068,49068,49069,1,7,6
49069,49069,49070,7,2,-5
49070,49070,49071,2,7,5
49071,49071,49072,7,4,-3
49072,49072,49073,4,8,4
49073,49073,49074,8,2,-6
49074,49074,49075,2,0,-2
49075,49075,49076,0,1,1
49076,49076,49077,1,3,2
49077,49077,49078,3,4,1
49078,49078,49079,4,5,1
49079,49079,49080,5,3,-2
49080,49080,49081,3,3,0
49081,49081,49082,3,3,0
49082,49082,49083,3,6,3
49083,49083,49084,6,6,0
49084,49084,49085,6,0,-6
49085,49085,49086,0,0,0
49086,49086,49087,0,1,1
49087,49087,49088,1,8,7
49088,49088,49089,8,2,-6
49089,49089,49090,2,2,0
49090,49090,49091,2,3,1
49091,49091,49092,3,4,1
49092,49092,49093,4,7,3
49093,49093,49094,7,5,-2
49094,49094,49095,5,8,3
49095,49095,49096,8,9,1
49096,49096,49097,9,0,-9
49097,49097,49098,0,2,2
49098,49098,49099,2,1,-1
49099,49099,49100,1,5,4
49100,49100,49101,5,2,-3
49101,49101,49102,2,4,2
49102,49102,49103,4,3,-1
49103,49103,49104,3,6,3
49104,49104,49105,6,4,-2
49105,49105,49106,4,2,-2
49106,49106,49107,2,5,3
49107,49107,49108,5,3,-2
49108,49108,49109,3,6,3
49109,49109,49110,6,0,-6
49110,49110,49111,0,0,0
49111,49111,49112,0,9,9
49112,49112,49113,9,1,-8
49113,49113,49114,1,8,7
49114,49114,49115,8,2,-6
49115,49115,49116,2,7,5
49116,49116,49117,7,3,-4
49117,49117,49118,3,1,-2
49118,49118,49119,1,7,6
49119,49119,49120,7,7,0
49120,49120,49121,7,9,2
49121,49121,49122,9,3,-6
49122,49122,49123,3,1,-2
49123,49123,49124,1,0,-1
49124,49124,49125,0,7,7
49125,49125,49126,7,8,1
49126,49126,49127,8,4,-4
49127,49127,49128,4,9,5
49128,49128,49129,9,8,-1
49129,49129,49130,8,9,1
49130,49130,49131,9,1,-8
49131,49131,49132,1,5,4
49132,49132,49133,5,6,1
49133,49133,49134,6,1,-5
49134,49134,49135,1,3,2
49135,49135,49136,3,7,4
49136,49136,49137,7,3,-4
49137,49137,49138,3,4,1
49138,49138,49139,4,6,2
49139,49139,49140,6,5,-1
49140,49140,49141,5,5,0
49141,49141,49142,5,3,-2
49142,49142,49143,3,9,6
49143,49143,49144,9,4,-5
49144,49144,49145,4,1,-3
49145,49145,49146,1,4,3
49146,49146,49147,4,3,-1
49147,49147,49148,3,2,-1
49148,49148,49149,2,3,1
49149,49149,49150,3,0,-3
49150,49150,49151,0,0,0
49151,49151,49152,0,5,5
49152,49152,49153,5,6,1
49153,49153,49154,6,1,-5
49154,49154,49155,1,4,3
49155,49155,49156,4,3,-1
49156,49156,49157,3,3,0
49157,49157,49158,3,2,-1
49158,49158,49159,2,7,5
49159,49159,49160,7,2,-5
49160,49160,49161,2,6,4
49161,49161,49162,6,4,-2
49162,49162,49163,4,9,5
49163,49163,49164,9,2,-7
49164,49164,49165,2,8,6
49165,49165,49166,8,3,-5
49166,49166,49167,3,1,-2
49167,49167,49168,1,2,1
49168,49168,49169,2,4,2
49169,49169,49170,4,8,4
49170,49170,49171,8,0,-8
49171,49171,49172,0,4,4
49172,49172,49173,4,6,2
49173,49173,49174,6,7,1
49174,49174,49175,7,6,-1
49175,49175,49176,6,8,2
49176,49176,49177,8,9,1
49177,49177,49178,9,6,-3
49178,49178,49179,6,2,-4
49179,49179,49180,2,7,5
49180,49180,49181,7,2,-5
49181,49181,49182,2,9,7
49182,49182,49183,9,3,-6
49183,49183,49184,3,7,4
49184,49184,49185,7,0,-7
49185,49185,49186,0,1,1
49186,49186,49187,1,7,6
49187,49187,49188,7,3,-4
49188,49188,49189,3,2,-1
49189,49189,49190,2,5,3
49190,49190,49191,5,2,-3
49191,49191,49192,2,2,0
49192,49192,49193,2,3,1
49193,49193,49194,3,1,-2
49194,49194,49195,1,4,3
49195,49195,49196,4,4,0
49196,49196,49197,4,0,-4
49197,49197,49198,0,1,1
49198,49198,49199,1,0,-1
49199,49199,49200,0,0,0
49200,49200,49201,0,8,8
49201,49201,49202,8,5,-3
49202,49202,49203,5,5,0
49203,49203,49204,5,9,4
49204,49204,49205,9,1,-8
49205,49205,49206,1,4,3
49206,49206,49207,4,3,-1
49207,49207,49208,3,0,-3
49208,49208,49209,0,7,7
49209,49209,49210,7,1,-6
49210,49210,49211,1,4,3
49211,49211,49212,4,7,3
49212,49212,49213,7,9,2
49213,49213,49214,9,0,-9
49214,49214,49215,0,8,8
49215,49215,49216,8,6,-2
49216,49216,49217,6,8,2
49217,49217,49218,8,0,-8
49218,49218,49219,0,9,9
49219,49219,49220,9,0,-9
49220,49220,49221,0,0,0
49221,49221,49222,0,3,3
49222,49222,49223,3,9,6
49223,49223,49224,9,0,-9
49224,49224,49225,0,8,8
49225,49225,49226,8,9,1
49226,49226,49227,9,9,0
49227,49227,49228,9,3,-6
49228,49228,49229,3,0,-3
49229,49229,49230,0,3,3
49230,49230,49231,3,2,-1
49231,49231,49232,2,1,-1
49232,49232,49233,1,6,5
49233,49233,49234,6,3,-3
49234,49234,49235,3,7,4
49235,49235,49236,7,5,-2
49236,49236,49237,5,4,-1
49237,49237,49238,4,8,4
49238,49238,49239,8,7,-1
49239,49239,49240,7,7,0
49240,49240,49241,7,5,-2
49241,49241,49242,5,7,2
49242,49242,49243,7,0,-7
49243,49243,49244,0,0,0
49244,49244,49245,0,1,1
49245,49245,49246,1,1,0
49246,49246,49247,1,2,1
49247,49247,49248,2,2,0
49248,49248,49249,2,3,1
49249,49249,49250,3,8,5
49250,49250,49251,8,4,-4
49251,49251,49252,4,6,2
49252,49252,49253,6,5,-1
49253,49253,49254,5,3,-2
49254,49254,49255,3,6,3
49255,49255,49256,6,4,-2
49256,49256,49257,4,7,3
49257,49257,49258,7,6,-1
49258,49258,49259,6,8,2
49259,49259,49260,8,1,-7
49260,49260,49261,1,9,8
49261,49261,49262,9,9,0
49262,49262,49263,9,0,-9
49263,49263,49264,0,2,2
49264,49264,49265,2,1,-1
49265,49265,49266,1,8,7
49266,49266,49267,8,2,-6
49267,49267,49268,2,0,-2
49268,49268,49269,0,3,3
49269,49269,49270,3,5,2
49270,49270,49271,5,4,-1
49271,49271,49272,4,9,5
49272,49272,49273,9,5,-4
49273,49273,49274,5,4,-1
49274,49274,49275,4,6,2
49275,49275,49276,6,8,2
49276,49276,49277,8,7,-1
49277,49277,49278,7,0,-7
49278,49278,49279,0,8,8
49279,49279,49280,8,0,-8
49280,49280,49281,0,0,0
49281,49281,49282,0,2,2
49282,49282,49283,2,1,-1
49283,49283,49284,1,1,0
49284,49284,49285,1,2,1
49285,49285,49286,2,3,1
49286,49286,49287,3,3,0
49287,49287,49288,3,3,0
49288,49288,49289,3,4,1
49289,49289,49290,4,8,4
49290,49290,49291,8,5,-3
49291,49291,49292,5,1,-4
49292,49292,49293,1,6,5
49293,49293,49294,6,3,-3
49294,49294,49295,3,8,5
49295,49295,49296,8,6,-2
49296,49296,49297,6,3,-3
49297,49297,49298,3,9,6
49298,49298,49299,9,4,-5
49299,49299,49300,4,3,-1
49300,49300,49301,3,7,4
49301,49301,49302,7,8,1
49302,49302,49303,8,8,0
49303,49303,49304,8,0,-8
49304,49304,49305,0,6,6
49305,49305,49306,6,0,-6
49306,49306,49307,0,3,3
49307,49307,49308,3,1,-2
49308,49308,49309,1,4,3
49309,49309,49310,4,0,-4
49310,49310,49311,0,0,0
49311,49311,49312,0,3,3
49312,49312,49313,3,9,6
49313,49313,49314,9,2,-7
49314,49314,49315,2,7,5
49315,49315,49316,7,5,-2
49316,49316,49317,5,1,-4
49317,49317,49318,1,3,2
49318,49318,49319,3,9,6
49319,49319,49320,9,7,-2
49320,49320,49321,7,3,-4
49321,49321,49322,3,0,-3
49322,49322,49323,0,8,8
49323,49323,49324,8,3,-5
49324,49324,49325,3,4,1
49325,49325,49326,4,1,-3
49326,49326,49327,1,7,6
49327,49327,49328,7,6,-1
49328,49328,49329,6,3,-3
49329,49329,49330,3,7,4
49330,49330,49331,7,0,-7
49331,49331,49332,0,8,8
49332,49332,49333,8,9,1
49333,49333,49334,9,5,-4
49334,49334,49335,5,9,4
49335,49335,49336,9,0,-9
49336,49336,49337,0,6,6
49337,49337,49338,6,1,-5
49338,49338,49339,1,1,0
49339,49339,49340,1,2,1
49340,49340,49341,2,4,2
49341,49341,49342,4,0,-4
49342,49342,49343,0,5,5
49343,49343,49344,5,6,1
49344,49344,49345,6,4,-2
49345,49345,49346,4,6,2
49346,49346,49347,6,6,0
49347,49347,49348,6,5,-1
49348,49348,49349,5,2,-3
49349,49349,49350,2,3,1
49350,49350,49351,3,0,-3
49351,49351,49352,0,5,5
49352,49352,49353,5,6,1
49353,49353,49354,6,0,-6
49354,49354,49355,0,1,1
49355,49355,49356,1,7,6
49356,49356,49357,7,1,-6
49357,49357,49358,1,9,8
49358,49358,49359,9,1,-8
49359,49359,49360,1,5,4
49360,49360,49361,5,7,2
49361,49361,49362,7,1,-6
49362,49362,49363,1,2,1
49363,49363,49364,2,7,5
49364,49364,49365,7,7,0
49365,49365,49366,7,8,1
49366,49366,49367,8,5,-3
49367,49367,49368,5,1,-4
49368,49368,49369,1,2,1
49369,49369,49370,2,0,-2
49370,49370,49371,0,9,9
49371,49371,49372,9,7,-2
49372,49372,49373,7,4,-3
49373,49373,49374,4,0,-4
49374,49374,49375,0,5,5
49375,49375,49376,5,3,-2
49376,49376,49377,3,8,5
49377,49377,49378,8,3,-5
49378,49378,49379,3,4,1
49379,49379,49380,4,1,-3
49380,49380,49381,1,2,1
49381,49381,49382,2,4,2
49382,49382,49383,4,9,5
49383,49383,49384,9,1,-8
49384,49384,49385,1,7,6
49385,49385,49386,7,9,2
49386,49386,49387,9,0,-9
49387,49387,49388,0,9,9
49388,49388,49389,9,0,-9
49389,49389,49390,0,3,3
49390,49390,49391,3,7,4
49391,49391,49392,7,1,-6
49392,49392,49393,1,5,4
49393,49393,49394,5,0,-5
49394,49394,49395,0,1,1
49395,49395,49396,1,6,5
49396,49396,49397,6,1,-5
49397,49397,49398,1,4,3
49398,49398,49399,4,7,3
49399,49399,49400,7,8,1
49400,49400,49401,8,6,-2
49401,49401,49402,6,5,-1
49402,49402,49403,5,6,1
49403,49403,49404,6,3,-3
49404,49404,49405,3,6,3
49405,49405,49406,6,3,-3
49406,49406,49407,3,8,5
49407,49407,49408,8,2,-6
49408,49408,49409,2,2,0
49409,49409,49410,2,3,1
49410,49410,49411,3,2,-1
49411,49411,49412,2,7,5
49412,49412,49413,7,7,0
49413,49413,49414,7,8,1
49414,49414,49415,8,7,-1
49415,49415,49416,7,2,-5
49416,49416,49417,2,4,2
49417,49417,49418,4,6,2
49418,49418,49419,6,0,-6
49419,49419,49420,0,1,1
49420,49420,49421,1,2,1
49421,49421,49422,2,8,6
49422,49422,49423,8,4,-4
49423,49423,49424,4,5,1
49424,49424,49425,5,2,-3
49425,49425,49426,2,6,4
49426,49426,49427,6,5,-1
49427,49427,49428,5,5,0
49428,49428,49429,5,0,-5
49429,49429,49430,0,2,2
49430,49430,49431,2,3,1
49431,49431,49432,3,9,6
49432,49432,49433,9,3,-6
49433,49433,49434,3,2,-1
49434,49434,49435,2,3,1
49435,49435,49436,3,6,3
49436,49436,49437,6,1,-5
49437,49437,49438,1,8,7
49438,49438,49439,8,8,0
49439,49439,49440,8,1,-7
49440,49440,49441,1,1,0
49441,49441,49442,1,9,8
49442,49442,49443,9,0,-9
49443,49443,49444,0,7,7
49444,49444,49445,7,5,-2
49445,49445,49446,5,3,-2
49446,49446,49447,3,9,6
49447,49447,49448,9,6,-3
49448,49448,49449,6,6,0
49449,49449,49450,6,3,-3
49450,49450,49451,3,9,6
49451,49451,49452,9,2,-7
49452,49452,49453,2,8,6
49453,49453,49454,8,2,-6
49454,49454,49455,2,5,3
49455,49455,49456,5,6,1
49456,49456,49457,6,8,2
49457,49457,49458,8,7,-1
49458,49458,49459,7,0,-7
49459,49459,49460,0,5,5
49460,49460,49461,5,3,-2
49461,49461,49462,3,9,6
49462,49462,49463,9,0,-9
49463,49463,49464,0,9,9
49464,49464,49465,9,8,-1
49465,49465,49466,8,9,1
49466,49466,49467,9,3,-6
49467,49467,49468,3,9,6
49468,49468,49469,9,9,0
49469,49469,49470,9,5,-4
49470,49470,49471,5,0,-5
49471,49471,49472,0,7,7
49472,49472,49473,7,1,-6
49473,49473,49474,1,2,1
49474,49474,49475,2,2,0
49475,49475,49476,2,5,3
49476,49476,49477,5,3,-2
49477,49477,49478,3,6,3
49478,49478,49479,6,4,-2
49479,49479,49480,4,4,0
49480,49480,49481,4,5,1
49481,49481,49482,5,1,-4
49482,49482,49483,1,6,5
49483,49483,49484,6,6,0
49484,49484,49485,6,7,1
49485,49485,49486,7,2,-5
49486,49486,49487,2,8,6
49487,49487,49488,8,1,-7
49488,49488,49489,1,9,8
49489,49489,49490,9,5,-4
49490,49490,49491,5,7,2
49491,49491,49492,7,9,2
49492,49492,49493,9,8,-1
49493,49493,49494,8,3,-5
49494,49494,49495,3,9,6
49495,49495,49496,9,8,-1
49496,49496,49497,8,0,-8
49497,49497,49498,0,2,2
49498,49498,49499,2,1,-1
49499,49499,49500,1,0,-1
49500,49500,49501,0,4,4
49501,49501,49502,4,8,4
49502,49502,49503,8,5,-3
49503,49503,49504,5,1,-4
49504,49504,49505,1,6,5
49505,49505,49506,6,9,3
49506,49506,49507,9,7,-2
49507,49507,49508,7,5,-2
49508,49508,49509,5,8,3
49509,49509,49510,8,6,-2
49510,49510,49511,6,9,3
49511,49511,49512,9,1,-8
49512,49512,49513,1,4,3
49513,49513,49514,4,4,0
49514,49514,49515,4,2,-2
49515,49515,49516,2,7,5
49516,49516,49517,7,6,-1
49517,49517,49518,6,0,-6
49518,49518,49519,0,1,1
49519,49519,49520,1,5,4
49520,49520,49521,5,1,-4
49521,49521,49522,1,8,7
49522,49522,49523,8,7,-1
49523,49523,49524,7,6,-1
49524,49524,49525,6,8,2
49525,49525,49526,8,6,-2
49526,49526,49527,6,5,-1
49527,49527,49528,5,0,-5
49528,49528,49529,0,3,3
49529,49529,49530,3,0,-3
49530,49530,49531,0,7,7
49531,49531,49532,7,8,1
49532,49532,49533,8,0,-8
49533,49533,49534,0,1,1
49534,49534,49535,1,0,-1
49535,49535,49536,0,5,5
49536,49536,49537,5,2,-3
49537,49537,49538,2,1,-1
49538,49538,49539,1,6,5
49539,49539,49540,6,7,1
49540,49540,49541,7,9,2
49541,49541,49542,9,4,-5
49542,49542,49543,4,8,4
49543,49543,49544,8,9,1
49544,49544,49545,9,8,-1
49545,49545,49546,8,4,-4
49546,49546,49547,4,9,5
49547,49547,49548,9,8,-1
49548,49548,49549,8,9,1
49549,49549,49550,9,6,-3
49550,49550,49551,6,7,1
49551,49551,49552,7,4,-3
49552,49552,49553,4,7,3
49553,49553,49554,7,7,0
49554,49554,49555,7,2,-5
49555,49555,49556,2,3,1
49556,49556,49557,3,1,-2
49557,49557,49558,1,5,4
49558,49558,49559,5,1,-4
49559,49559,49560,1,3,2
49560,49560,49561,3,0,-3
49561,49561,49562,0,9,9
49562,49562,49563,9,8,-1
49563,49563,49564,8,9,1
49564,49564,49565,9,9,0
49565,49565,49566,9,3,-6
49566,49566,49567,3,2,-1
49567,49567,49568,2,5,3
49568,49568,49569,5,1,-4
49569,49569,49570,1,3,2
49570,49570,49571,3,7,4
49571,49571,49572,7,8,1
49572,49572,49573,8,2,-6
49573,49573,49574,2,9,7
49574,49574,49575,9,0,-9
49575,49575,49576,0,0,0
49576,49576,49577,0,6,6
49577,49577,49578,6,8,2
49578,49578,49579,8,8,0
49579,49579,49580,8,2,-6
49580,49580,49581,2,5,3
49581,49581,49582,5,2,-3
49582,49582,49583,2,0,-2
49583,49583,49584,0,7,7
49584,49584,49585,7,3,-4
49585,49585,49586,3,3,0
49586,49586,49587,3,4,1
49587,49587,49588,4,1,-3
49588,49588,49589,1,3,2
49589,49589,49590,3,7,4
49590,49590,49591,7,9,2
49591,49591,49592,9,1,-8
49592,49592,49593,1,6,5
49593,49593,49594,6,0,-6
49594,49594,49595,0,0,0
49595,49595,49596,0,0,0
49596,49596,49597,0,6,6
49597,49597,49598,6,2,-4
49598,49598,49599,2,9,7
49599,49599,49600,9,1,-8
49600,49600,49601,1,0,-1
49601,49601,49602,0,3,3
49602,49602,49603,3,1,-2
49603,49603,49604,1,5,4
49604,49604,49605,5,2,-3
49605,49605,49606,2,1,-1
49606,49606,49607,1,3,2
49607,49607,49608,3,9,6
49608,49608,49609,9,4,-5
49609,49609,49610,4,1,-3
49610,49610,49611,1,5,4
49611,49611,49612,5,1,-4
49612,49612,49613,1,6,5
49613,49613,49614,6,2,-4
49614,49614,49615,2,7,5
49615,49615,49616,7,7,0
49616,49616,49617,7,8,1
49617,49617,49618,8,8,0
49618,49618,49619,8,9,1
49619,49619,49620,9,8,-1
49620,49620,49621,8,0,-8
49621,49621,49622,0,0,0
49622,49622,49623,0,1,1
49623,49623,49624,1,6,5
49624,49624,49625,6,2,-4
49625,49625,49626,2,6,4
49626,49626,49627,6,3,-3
49627,49627,49628,3,1,-2
49628,49628,49629,1,4,3
49629,49629,49630,4,8,4
49630,49630,49631,8,5,-3
49631,49631,49632,5,5,0
49632,49632,49633,5,6,1
49633,49633,49634,6,8,2
49634,49634,49635,8,7,-1
49635,49635,49636,7,5,-2
49636,49636,49637,5,8,3
49637,49637,49638,8,3,-5
49638,49638,49639,3,0,-3
49639,49639,49640,0,9,9
49640,49640,49641,9,1,-8
49641,49641,49642,1,2,1
49642,49642,49643,2,2,0
49643,49643,49644,2,7,5
49644,49644,49645,7,3,-4
49645,49645,49646,3,4,1
49646,49646,49647,4,4,0
49647,49647,49648,4,3,-1
49648,49648,49649,3,5,2
49649,49649,49650,5,3,-2
49650,49650,49651,3,6,3
49651,49651,49652,6,5,-1
49652,49652,49653,5,9,4
49653,49653,49654,9,3,-6
49654,49654,49655,3,5,2
49655,49655,49656,5,9,4
49656,49656,49657,9,0,-9
49657,49657,49658,0,5,5
49658,49658,49659,5,6,1
49659,49659,49660,6,8,2
49660,49660,49661,8,8,0
49661,49661,49662,8,7,-1
49662,49662,49663,7,9,2
49663,49663,49664,9,1,-8
49664,49664,49665,1,4,3
49665,49665,49666,4,7,3
49666,49666,49667,7,1,-6
49667,49667,49668,1,5,4
49668,49668,49669,5,9,4
49669,49669,49670,9,3,-6
49670,49670,49671,3,5,2
49671,49671,49672,5,5,0
49672,49672,49673,5,3,-2
49673,49673,49674,3,2,-1
49674,49674,49675,2,0,-2
49675,49675,49676,0,4,4
49676,49676,49677,4,8,4
49677,49677,49678,8,3,-5
49678,49678,49679,3,9,6
49679,49679,49680,9,1,-8
49680,49680,49681,1,1,0
49681,49681,49682,1,5,4
49682,49682,49683,5,4,-1
49683,49683,49684,4,5,1
49684,49684,49685,5,0,-5
49685,49685,49686,0,5,5
49686,49686,49687,5,5,0
49687,49687,49688,5,4,-1
49688,49688,49689,4,5,1
49689,49689,49690,5,9,4
49690,49690,49691,9,7,-2
49691,49691,49692,7,4,-3
49692,49692,49693,4,6,2
49693,49693,49694,6,7,1
49694,49694,49695,7,0,-7
49695,49695,49696,0,9,9
49696,49696,49697,9,1,-8
49697,49697,49698,1,7,6
49698,49698,49699,7,6,-1
49699,49699,49700,6,4,-2
49700,49700,49701,4,8,4
49701,49701,49702,8,2,-6
49702,49702,49703,2,9,7
49703,49703,49704,9,8,-1
49704,49704,49705,8,5,-3
49705,49705,49706,5,1,-4
49706,49706,49707,1,4,3
49707,49707,49708,4,5,1
49708,49708,49709,5,7,2
49709,49709,49710,7,9,2
49710,49710,49711,9,6,-3
49711,49711,49712,6,4,-2
49712,49712,49713,4,0,-4
49713,49713,49714,0,9,9
49714,49714,49715,9,8,-1
49715,49715,49716,8,0,-8
49716,49716,49717,0,1,1
49717,49717,49718,1,6,5
49718,49718,49719,6,7,1
49719,49719,49720,7,0,-7
49720,49720,49721,0,7,7
49721,49721,49722,7,4,-3
49722,49722,49723,4,1,-3
49723,49723,49724,1,8,7
49724,49724,49725,8,3,-5
49725,49725,49726,3,5,2
49726,49726,49727,5,2,-3
49727,49727,49728,2,5,3
49728,49728,49729,5,3,-2
49729,49729,49730,3,9,6
49730,49730,49731,9,1,-8
49731,49731,49732,1,3,2
49732,49732,49733,3,4,1
49733,49733,49734,4,9,5
49734,49734,49735,9,2,-7
49735,49735,49736,2,7,5
49736,49736,49737,7,0,-7
49737,49737,49738,0,7,7
49738,49738,49739,7,0,-7
49739,49739,49740,0,9,9
49740,49740,49741,9,4,-5
49741,49741,49742,4,7,3
49742,49742,49743,7,6,-1
49743,49743,49744,6,8,2
49744,49744,49745,8,4,-4
49745,49745,49746,4,3,-1
49746,49746,49747,3,9,6
49747,49747,49748,9,3,-6
49748,49748,49749,3,3,0
49749,49749,49750,3,0,-3
49750,49750,49751,0,8,8
49751,49751,49752,8,9,1
49752,49752,49753,9,4,-5
49753,49753,49754,4,4,0
49754,49754,49755,4,7,3
49755,49755,49756,7,8,1
49756,49756,49757,8,2,-6
49757,49757,49758,2,7,5
49758,49758,49759,7,5,-2
49759,49759,49760,5,5,0
49760,49760,49761,5,6,1
49761,49761,49762,6,2,-4
49762,49762,49763,2,3,1
49763,49763,49764,3,9,6
49764,49764,49765,9,6,-3
49765,49765,49766,6,8,2
49766,49766,49767,8,9,1
49767,49767,49768,9,1,-8
49768,49768,49769,1,6,5
49769,49769,49770,6,0,-6
49770,49770,49771,0,3,3
49771,49771,49772,3,6,3
49772,49772,49773,6,2,-4
49773,49773,49774,2,0,-2
49774,49774,49775,0,2,2
49775,49775,49776,2,2,0
49776,49776,49777,2,4,2
49777,49777,49778,4,2,-2
49778,49778,49779,2,6,4
49779,49779,49780,6,0,-6
49780,49780,49781,0,2,2
49781,49781,49782,2,2,0
49782,49782,49783,2,5,3
49783,49783,49784,5,5,0
49784,49784,49785,5,5,0
49785,49785,49786,5,1,-4
49786,49786,49787,1,1,0
49787,49787,49788,1,5,4
49788,49788,49789,5,3,-2
49789,49789,49790,3,2,-1
49790,49790,49791,2,3,1
49791,49791,49792,3,2,-1
49792,49792,49793,2,9,7
49793,49793,49794,9,5,-4
49794,49794,49795,5,2,-3
49795,49795,49796,2,1,-1
49796,49796,49797,1,5,4
49797,49797,49798,5,9,4
49798,49798,49799,9,7,-2
49799,49799,49800,7,0,-7
49800,49800,49801,0,9,9
49801,49801,49802,9,6,-3
49802,49802,49803,6,8,2
49803,49803,49804,8,8,0
49804,49804,49805,8,2,-6
49805,49805,49806,2,7,5
49806,49806,49807,7,1,-6
49807,49807,49808,1,8,7
49808,49808,49809,8,3,-5
49809,49809,49810,3,3,0
49810,49810,49811,3,1,-2
49811,49811,49812,1,7,6
49812,49812,49813,7,3,-4
49813,49813,49814,3,3,0
49814,49814,49815,3,0,-3
49815,49815,49816,0,6,6
49816,49816,49817,6,1,-5
49817,49817,49818,1,7,6
49818,49818,49819,7,2,-5
49819,49819,49820,2,5,3
49820,49820,49821,5,3,-2
49821,49821,49822,3,8,5
49822,49822,49823,8,4,-4
49823,49823,49824,4,8,4
49824,49824,49825,8,5,-3
49825,49825,49826,5,3,-2
49826,49826,49827,3,6,3
49827,49827,49828,6,6,0
49828,49828,49829,6,7,1
49829,49829,49830,7,8,1
49830,49830,49831,8,8,0
49831,49831,49832,8,1,-7
49832,49832,49833,1,9,8
49833,49833,49834,9,2,-7
49834,49834,49835,2,0,-2
49835,49835,49836,0,9,9
49836,49836,49837,9,1,-8
49837,49837,49838,1,6,5
49838,49838,49839,6,2,-4
49839,49839,49840,2,1,-1
49840,49840,49841,1,3,2
49841,49841,49842,3,5,2
49842,49842,49843,5,4,-1
49843,49843,49844,4,9,5
49844,49844,49845,9,5,-4
49845,49845,49846,5,7,2
49846,49846,49847,7,6,-1
49847,49847,49848,6,0,-6
49848,49848,49849,0,7,7
49849,49849,49850,7,4,-3
49850,49850,49851,4,8,4
49851,49851,49852,8,1,-7
49852,49852,49853,1,0,-1
49853,49853,49854,0,9,9
49854,49854,49855,9,1,-8
49855,49855,49856,1,2,1
49856,49856,49857,2,2,0
49857,49857,49858,2,4,2
49858,49858,49859,4,3,-1
49859,49859,49860,3,1,-2
49860,49860,49861,1,4,3
49861,49861,49862,4,7,3
49862,49862,49863,7,5,-2
49863,49863,49864,5,3,-2
49864,49864,49865,3,6,3
49865,49865,49866,6,7,1
49866,49866,49867,7,7,0
49867,49867,49868,7,3,-4
49868,49868,49869,3,8,5
49869,49869,49870,8,9,1
49870,49870,49871,9,9,0
49871,49871,49872,9,0,-9
49872,49872,49873,0,2,2
49873,49873,49874,2,4,2
49874,49874,49875,4,2,-2
49875,49875,49876,2,1,-1
49876,49876,49877,1,7,6
49877,49877,49878,7,1,-6
49878,49878,49879,1,6,5
49879,49879,49880,6,9,3
49880,49880,49881,9,4,-5
49881,49881,49882,4,3,-1
49882,49882,49883,3,0,-3
49883,49883,49884,0,1,1
49884,49884,49885,1,5,4
49885,49885,49886,5,6,1
49886,49886,49887,6,8,2
49887,49887,49888,8,1,-7
49888,49888,49889,1,0,-1
49889,49889,49890,0,5,5
49890,49890,49891,5,7,2
49891,49891,49892,7,5,-2
49892,49892,49893,5,3,-2
49893,49893,49894,3,0,-3
49894,49894,49895,0,5,5
49895,49895,49896,5,3,-2
49896,49896,49897,3,4,1
49897,49897,49898,4,9,5
49898,49898,49899,9,1,-8
49899,49899,49900,1,6,5
49900,49900,49901,6,8,2
49901,49901,49902,8,1,-7
49902,49902,49903,1,0,-1
49903,49903,49904,0,9,9
49904,49904,49905,9,5,-4
49905,49905,49906,5,7,2
49906,49906,49907,7,2,-5
49907,49907,49908,2,2,0
49908,49908,49909,2,7,5
49909,49909,49910,7,6,-1
49910,49910,49911,6,2,-4
49911,49911,49912,2,3,1
49912,49912,49913,3,3,0
49913,49913,49914,3,2,-1
49914,49914,49915,2,6,4
49915,49915,49916,6,2,-4
49916,49916,49917,2,2,0
49917,49917,49918,2,7,5
49918,49918,49919,7,1,-6
49919,49919,49920,1,4,3
49920,49920,49921,4,7,3
49921,49921,49922,7,5,-2
49922,49922,49923,5,7,2
49923,49923,49924,7,0,-7
49924,49924,49925,0,9,9
49925,49925,49926,9,3,-6
49926,49926,49927,3,1,-2
49927,49927,49928,1,5,4
49928,49928,49929,5,2,-3
49929,49929,49930,2,6,4
49930,49930,49931,6,6,0
49931,49931,49932,6,1,-5
49932,49932,49933,1,7,6
49933,49933,49934,7,4,-3
49934,49934,49935,4,5,1
49935,49935,49936,5,2,-3
49936,49936,49937,2,4,2
49937,49937,49938,4,3,-1
49938,49938,49939,3,0,-3
49939,49939,49940,0,4,4
49940,49940,49941,4,1,-3
49941,49941,49942,1,4,3
49942,49942,49943,4,1,-3
49943,49943,49944,1,9,8
49944,49944,49945,9,9,0
49945,49945,49946,9,3,-6
49946,49946,49947,3,8,5
49947,49947,49948,8,3,-5
49948,49948,49949,3,0,-3
49949,49949,49950,0,5,5
49950,49950,49951,5,2,-3
49951,49951,49952,2,0,-2
49952,49952,49953,0,0,0
49953,49953,49954,0,0,0
49954,49954,49955,0,3,3
49955,49955,49956,3,9,6
49956,49956,49957,9,5,-4
49957,49957,49958,5,7,2
49958,49958,49959,7,6,-1
49959,49959,49960,6,6,0
49960,49960,49961,6,1,-5
49961,49961,49962,1,2,1
49962,49962,49963,2,8,6
49963,49963,49964,8,1,-7
49964,49964,49965,1,6,5
49965,49965,49966,6,3,-3
49966,49966,49967,3,4,1
49967,49967,49968,4,3,-1
49968,49968,49969,3,6,3
49969,49969,49970,6,6,0
49970,49970,49971,6,0,-6
49971,49971,49972,0,1,1
49972,49972,49973,1,9,8
49973,49973,49974,9,0,-9
49974,49974,49975,0,2,2
49975,49975,49976,2,2,0
49976,49976,49977,2,6,4
49977,49977,49978,6,7,1
49978,49978,49979,7,4,-3
49979,49979,49980,4,7,3
49980,49980,49981,7,3,-4
49981,49981,49982,3,4,1
49982,49982,49983,4,9,5
49983,49983,49984,9,9,0
49984,49984,49985,9,3,-6
49985,49985,49986,3,7,4
49986,49986,49987,7,0,-7
49987,49987,49988,0,9,9
49988,49988,49989,9,0,-9
49989,49989,49990,0,8,8
49990,49990,49991,8,5,-3
49991,49991,49992,5,5,0
49992,49992,49993,5,2,-3
49993,49993,49994,2,4,2
49994,49994,49995,4,5,1
49995,49995,49996,5,0,-5
49996,49996,49997,0,8,8
49997,49997,49998,8,4,-4
49998,49998,49999,4,8,4
49999,49999,50000,8,3,-5
50000,50000,50001,3,8,5
50001,50001,50002,8,6,-2
50002,50002,50003,6,9,3
50003,50003,50004,9,6,-3
50004,50004,50005,6,4,-2
50005,50005,50006,4,5,1
50006,50006,50007,5,3,-2
50007,50007,50008,3,8,5
50008,50008,50009,8,4,-4
50009,50009,50010,4,5,1
50010,50010,50011,5,2,-3
50011,50011,50012,2,3,1
50012,50012,50013,3,8,5
50013,50013,50014,8,4,-4
50014,50014,50015,4,8,4
50015,50015,50016,8,1,-7
50016,50016,50017,1,5,4
50017,50017,50018,5,0,-5
50018,50018,50019,0,5,5
50019,50019,50020,5,9,4
50020,50020,50021,9,7,-2
50021,50021,50022,7,4,-3
50022,50022,50023,4,1,-3
50023,50023,50024,1,0,-1
50024,50024,50025,0,3,3
50025,50025,50026,3,0,-3
50026,50026,50027,0,6,6
50027,50027,50028,6,2,-4
50028,50028,50029,2,9,7
50029,50029,50030,9,9,0
50030,50030,50031,9,4,-5
50031,50031,50032,4,1,-3
50032,50032,50033,1,3,2
50033,50033,50034,3,6,3
50034,50034,50035,6,8,2
50035,50035,50036,8,0,-8
50036,50036,50037,0,7,7
50037,50037,50038,7,7,0
50038,50038,50039,7,6,-1
50039,50039,50040,6,8,2
50040,50040,50041,8,9,1
50041,50041,50042,9,0,-9
50042,50042,50043,0,3,3
50043,50043,50044,3,8,5
50044,50044,50045,8,3,-5
50045,50045,50046,3,7,4
50046,50046,50047,7,7,0
50047,50047,50048,7,8,1
50048,50048,50049,8,4,-4
50049,50049,50050,4,4,0
50050,50050,50051,4,1,-3
50051,50051,50052,1,2,1
50052,50052,50053,2,9,7
50053,50053,50054,9,8,-1
50054,50054,50055,8,1,-7
50055,50055,50056,1,1,0
50056,50056,50057,1,0,-1
50057,50057,50058,0,6,6
50058,50058,50059,6,6,0
50059,50059,50060,6,5,-1
50060,50060,50061,5,0,-5
50061,50061,50062,0,1,1
50062,50062,50063,1,1,0
50063,50063,50064,1,7,6
50064,50064,50065,7,2,-5
50065,50065,50066,2,7,5
50066,50066,50067,7,3,-4
50067,50067,50068,3,1,-2
50068,50068,50069,1,4,3
50069,50069,50070,4,0,-4
50070,50070,50071,0,5,5
50071,50071,50072,5,0,-5
50072,50072,50073,0,6,6
50073,50073,50074,6,8,2
50074,50074,50075,8,7,-1
50075,50075,50076,7,6,-1
50076,50076,50077,6,8,2
50077,50077,50078,8,9,1
50078,50078,50079,9,9,0
50079,50079,50080,9,4,-5
50080,50080,50081,4,0,-4
50081,50081,50082,0,6,6
50082,50082,50083,6,1,-5
50083,50083,50084,1,9,8
50084,50084,50085,9,2,-7
50085,50085,50086,2,6,4
50086,50086,50087,6,3,-3
50087,50087,50088,3,9,6
50088,50088,50089,9,4,-5
50089,50089,50090,4,4,0
50090,50090,50091,4,5,1
50091,50091,50092,5,6,1
50092,50092,50093,6,6,0
50093,50093,50094,6,1,-5
50094,50094,50095,1,7,6
50095,50095,50096,7,2,-5
50096,50096,50097,2,8,6
50097,50097,50098,8,6,-2
50098,50098,50099,6,9,3
50099,50099,50100,9,7,-2
50100,50100,50101,7,0,-7
50101,50101,50102,0,9,9
50102,50102,50103,9,1,-8
50103,50103,50104,1,6,5
50104,50104,50105,6,2,-4
50105,50105,50106,2,8,6
50106,50106,50107,8,3,-5
50107,50107,50108,3,6,3
50108,50108,50109,6,4,-2
50109,50109,50110,4,9,5
50110,50110,50111,9,5,-4
50111,50111,50112,5,8,3
50112,50112,50113,8,6,-2
50113,50113,50114,6,8,2
50114,50114,50115,8,7,-1
50115,50115,50116,7,8,1
50116,50116,50117,8,8,0
50117,50117,50118,8,6,-2
50118,50118,50119,6,9,3
50119,50119,50120,9,1,-8
50120,50120,50121,1,7,6
50121,50121,50122,7,6,-1
50122,50122,50123,6,0,-6
50123,50123,50124,0,9,9
50124,50124,50125,9,6,-3
50125,50125,50126,6,7,1
50126,50126,50127,7,0,-7
50127,50127,50128,0,9,9
50128,50128,50129,9,7,-2
50129,50129,50130,7,1,-6
50130,50130,50131,1,3,2
50131,50131,50132,3,6,3
50132,50132,50133,6,8,2
50133,50133,50134,8,4,-4
50134,50134,50135,4,6,2
50135,50135,50136,6,1,-5
50136,50136,50137,1,7,6
50137,50137,50138,7,5,-2
50138,50138,50139,5,1,-4
50139,50139,50140,1,3,2
50140,50140,50141,3,3,0
50141,50141,50142,3,5,2
50142,50142,50143,5,7,2
50143,50143,50144,7,9,2
50144,50144,50145,9,9,0
50145,50145,50146,9,6,-3
50146,50146,50147,6,7,1
50147,50147,50148,7,3,-4
50148,50148,50149,3,4,1
50149,50149,50150,4,1,-3
50150,50150,50151,1,0,-1
50151,50151,50152,0,4,4
50152,50152,50153,4,2,-2
50153,50153,50154,2,4,2
50154,50154,50155,4,5,1
50155,50155,50156,5,0,-5
50156,50156,50157,0,0,0
50157,50157,50158,0,1,1
50158,50158,50159,1,6,5
50159,50159,50160,6,6,0
50160,50160,50161,6,4,-2
50161,50161,50162,4,7,3
50162,50162,50163,7,9,2
50163,50163,50164,9,4,-5
50164,50164,50165,4,6,2
50165,50165,50166,6,5,-1
50166,50166,50167,5,2,-3
50167,50167,50168,2,6,4
50168,50168,50169,6,9,3
50169,50169,50170,9,8,-1
50170,50170,50171,8,8,0
50171,50171,50172,8,8,0
50172,50172,50173,8,5,-3
50173,50173,50174,5,9,4
50174,50174,50175,9,3,-6
50175,50175,50176,3,8,5
50176,50176,50177,8,9,1
50177,50177,50178,9,8,-1
50178,50178,50179,8,8,0
50179,50179,50180,8,8,0
50180,50180,50181,8,3,-5
50181,50181,50182,3,4,1
50182,50182,50183,4,4,0
50183,50183,50184,4,3,-1
50184,50184,50185,3,0,-3
50185,50185,50186,0,9,9
50186,50186,50187,9,5,-4
50187,50187,50188,5,4,-1
50188,50188,50189,4,4,0
50189,50189,50190,4,1,-3
50190,50190,50191,1,8,7
50191,50191,50192,8,0,-8
50192,50192,50193,0,6,6
50193,50193,50194,6,1,-5
50194,50194,50195,1,3,2
50195,50195,50196,3,2,-1
50196,50196,50197,2,0,-2
50197,50197,50198,0,8,8
50198,50198,50199,8,6,-2
50199,50199,50200,6,0,-6
50200,50200,50201,0,3,3
50201,50201,50202,3,5,2
50202,50202,50203,5,4,-1
50203,50203,50204,4,9,5
50204,50204,50205,9,0,-9
50205,50205,50206,0,3,3
50206,50206,50207,3,1,-2
50207,50207,50208,1,0,-1
50208,50208,50209,0,9,9
50209,50209,50210,9,3,-6
50210,50210,50211,3,2,-1
50211,50211,50212,2,3,1
50212,50212,50213,3,3,0
50213,50213,50214,3,3,0
50214,50214,50215,3,7,4
50215,50215,50216,7,4,-3
50216,50216,50217,4,9,5
50217,50217,50218,9,2,-7
50218,50218,50219,2,1,-1
50219,50219,50220,1,6,5
50220,50220,50221,6,2,-4
50221,50221,50222,2,1,-1
50222,50222,50223,1,5,4
50223,50223,50224,5,7,2
50224,50224,50225,7,1,-6
50225,50225,50226,1,9,8
50226,50226,50227,9,7,-2
50227,50227,50228,7,9,2
50228,50228,50229,9,2,-7
50229,50229,50230,2,2,0
50230,50230,50231,2,8,6
50231,50231,50232,8,1,-7
50232,50232,50233,1,7,6
50233,50233,50234,7,7,0
50234,50234,50235,7,0,-7
50235,50235,50236,0,0,0
50236,50236,50237,0,1,1
50237,50237,50238,1,8,7
50238,50238,50239,8,9,1
50239,50239,50240,9,0,-9
50240,50240,50241,0,6,6
50241,50241,50242,6,6,0
50242,50242,50243,6,4,-2
50243,50243,50244,4,7,3
50244,50244,50245,7,9,2
50245,50245,50246,9,8,-1
50246,50246,50247,8,2,-6
50247,50247,50248,2,9,7
50248,50248,50249,9,1,-8
50249,50249,50250,1,5,4
50250,50250,50251,5,2,-3
50251,50251,50252,2,5,3
50252,50252,50253,5,3,-2
50253,50253,50254,3,7,4
50254,50254,50255,7,7,0
50255,50255,50256,7,0,-7
50256,50256,50257,0,0,0
50257,50257,50258,0,8,8
50258,50258,50259,8,2,-6
50259,50259,50260,2,3,1
50260,50260,50261,3,1,-2
50261,50261,50262,1,3,2
50262,50262,50263,3,5,2
50263,50263,50264,5,1,-4
50264,50264,50265,1,3,2
50265,50265,50266,3,6,3
50266,50266,50267,6,4,-2
50267,50267,50268,4,8,4
50268,50268,50269,8,7,-1
50269,50269,50270,7,6,-1
50270,50270,50271,6,2,-4
50271,50271,50272,2,8,6
50272,50272,50273,8,1,-7
50273,50273,50274,1,8,7
50274,50274,50275,8,6,-2
50275,50275,50276,6,6,0
50276,50276,50277,6,8,2
50277,50277,50278,8,7,-1
50278,50278,50279,7,5,-2
50279,50279,50280,5,6,1
50280,50280,50281,6,0,-6
50281,50281,50282,0,4,4
50282,50282,50283,4,8,4
50283,50283,50284,8,4,-4
50284,50284,50285,4,9,5
50285,50285,50286,9,3,-6
50286,50286,50287,3,2,-1
50287,50287,50288,2,3,1
50288,50288,50289,3,6,3
50289,50289,50290,6,2,-4
50290,50290,50291,2,0,-2
50291,50291,50292,0,1,1
50292,50292,50293,1,1,0
50293,50293,50294,1,6,5
50294,50294,50295,6,2,-4
50295,50295,50296,2,5,3
50296,50296,50297,5,3,-2
50297,50297,50298,3,0,-3
50298,50298,50299,0,4,4
50299,50299,50300,4,3,-1
50300,50300,50301,3,5,2
50301,50301,50302,5,8,3
50302,50302,50303,8,6,-2
50303,50303,50304,6,9,3
50304,50304,50305,9,7,-2
50305,50305,50306,7,8,1
50306,50306,50307,8,8,0
50307,50307,50308,8,3,-5
50308,50308,50309,3,9,6
50309,50309,50310,9,0,-9
50310,50310,50311,0,0,0
50311,50311,50312,0,3,3
50312,50312,50313,3,1,-2
50313,50313,50314,1,4,3
50314,50314,50315,4,2,-2
50315,50315,50316,2,5,3
50316,50316,50317,5,3,-2
50317,50317,50318,3,9,6
50318,50318,50319,9,4,-5
50319,50319,50320,4,5,1
50320,50320,50321,5,5,0
50321,50321,50322,5,5,0
50322,50322,50323,5,6,1
50323,50323,50324,6,0,-6
50324,50324,50325,0,7,7
50325,50325,50326,7,1,-6
50326,50326,50327,1,8,7
50327,50327,50328,8,0,-8
50328,50328,50329,0,9,9
50329,50329,50330,9,3,-6
50330,50330,50331,3,0,-3
50331,50331,50332,0,5,5
50332,50332,50333,5,1,-4
50333,50333,50334,1,2,1
50334,50334,50335,2,2,0
50335,50335,50336,2,3,1
50336,50336,50337,3,3,0
50337,50337,50338,3,1,-2
50338,50338,50339,1,4,3
50339,50339,50340,4,3,-1
50340,50340,50341,3,5,2
50341,50341,50342,5,8,3
50342,50342,50343,8,6,-2
50343,50343,50344,6,0,-6
50344,50344,50345,0,7,7
50345,50345,50346,7,8,1
50346,50346,50347,8,8,0
50347,50347,50348,8,2,-6
50348,50348,50349,2,9,7
50349,50349,50350,9,1,-8
50350,50350,50351,1,7,6
50351,50351,50352,7,5,-2
50352,50352,50353,5,0,-5
50353,50353,50354,0,0,0
50354,50354,50355,0,6,6
50355,50355,50356,6,1,-5
50356,50356,50357,1,0,-1
50357,50357,50358,0,9,9
50358,50358,50359,9,7,-2
50359,50359,50360,7,7,0
50360,50360,50361,7,3,-4
50361,50361,50362,3,1,-2
50362,50362,50363,1,8,7
50363,50363,50364,8,3,-5
50364,50364,50365,3,7,4
50365,50365,50366,7,5,-2
50366,50366,50367,5,1,-4
50367,50367,50368,1,2,1
50368,50368,50369,2,3,1
50369,50369,50370,3,7,4
50370,50370,50371,7,7,0
50371,50371,50372,7,3,-4
50372,50372,50373,3,9,6
50373,50373,50374,9,3,-6
50374,50374,50375,3,7,4
50375,50375,50376,7,7,0
50376,50376,50377,7,4,-3
50377,50377,50378,4,3,-1
50378,50378,50379,3,0,-3
50379,50379,50380,0,7,7
50380,50380,50381,7,2,-5
50381,50381,50382,2,7,5
50382,50382,50383,7,5,-2
50383,50383,50384,5,9,4
50384,50384,50385,9,0,-9
50385,50385,50386,0,9,9
50386,50386,50387,9,6,-3
50387,50387,50388,6,4,-2
50388,50388,50389,4,4,0
50389,50389,50390,4,0,-4
50390,50390,50391,0,9,9
50391,50391,50392,9,7,-2
50392,50392,50393,7,8,1
50393,50393,50394,8,8,0
50394,50394,50395,8,5,-3
50395,50395,50396,5,1,-4
50396,50396,50397,1,1,0
50397,50397,50398,1,5,4
50398,50398,50399,5,5,0
50399,50399,50400,5,1,-4
50400,50400,50401,1,3,2
50401,50401,50402,3,6,3
50402,50402,50403,6,3,-3
50403,50403,50404,3,1,-2
50404,50404,50405,1,4,3
50405,50405,50406,4,5,1
50406,50406,50407,5,0,-5
50407,50407,50408,0,9,9
50408,50408,50409,9,5,-4
50409,50409,50410,5,8,3
50410,50410,50411,8,4,-4
50411,50411,50412,4,3,-1
50412,50412,50413,3,8,5
50413,50413,50414,8,9,1
50414,50414,50415,9,6,-3
50415,50415,50416,6,4,-2
50416,50416,50417,4,3,-1
50417,50417,50418,3,6,3
50418,50418,50419,6,4,-2
50419,50419,50420,4,5,1
50420,50420,50421,5,8,3
50421,50421,50422,8,5,-3
50422,50422,50423,5,0,-5
50423,50423,50424,0,0,0
50424,50424,50425,0,6,6
50425,50425,50426,6,7,1
50426,50426,50427,7,4,-3
50427,50427,50428,4,6,2
50428,50428,50429,6,8,2
50429,50429,50430,8,5,-3
50430,50430,50431,5,3,-2
50431,50431,50432,3,4,1
50432,50432,50433,4,4,0
50433,50433,50434,4,0,-4
50434,50434,50435,0,0,0
50435,50435,50436,0,9,9
50436,50436,50437,9,1,-8
50437,50437,50438,1,7,6
50438,50438,50439,7,9,2
50439,50439,50440,9,7,-2
50440,50440,50441,7,2,-5
50441,50441,50442,2,8,6
50442,50442,50443,8,7,-1
50443,50443,50444,7,0,-7
50444,50444,50445,0,9,9
50445,50445,50446,9,2,-7
50446,50446,50447,2,1,-1
50447,50447,50448,1,8,7
50448,50448,50449,8,2,-6
50449,50449,50450,2,4,2
50450,50450,50451,4,5,1
50451,50451,50452,5,2,-3
50452,50452,50453,2,1,-1
50453,50453,50454,1,2,1
50454,50454,50455,2,7,5
50455,50455,50456,7,5,-2
50456,50456,50457,5,2,-3
50457,50457,50458,2,9,7
50458,50458,50459,9,8,-1
50459,50459,50460,8,5,-3
50460,50460,50461,5,7,2
50461,50461,50462,7,9,2
50462,50462,50463,9,0,-9
50463,50463,50464,0,7,7
50464,50464,50465,7,1,-6
50465,50465,50466,1,4,3
50466,50466,50467,4,9,5
50467,50467,50468,9,7,-2
50468,50468,50469,7,6,-1
50469,50469,50470,6,3,-3
50470,50470,50471,3,4,1
50471,50471,50472,4,1,-3
50472,50472,50473,1,9,8
50473,50473,50474,9,2,-7
50474,50474,50475,2,2,0
50475,50475,50476,2,0,-2
50476,50476,50477,0,1,1
50477,50477,50478,1,2,1
50478,50478,50479,2,2,0
50479,50479,50480,2,0,-2
50480,50480,50481,0,3,3
50481,50481,50482,3,1,-2
50482,50482,50483,1,7,6
50483,50483,50484,7,5,-2
50484,50484,50485,5,0,-5
50485,50485,50486,0,4,4
50486,50486,50487,4,2,-2
50487,50487,50488,2,7,5
50488,50488,50489,7,1,-6
50489,50489,50490,1,9,8
50490,50490,50491,9,3,-6
50491,50491,50492,3,0,-3
50492,50492,50493,0,1,1
50493,50493,50494,1,6,5
50494,50494,50495,6,2,-4
50495,50495,50496,2,2,0
50496,50496,50497,2,5,3
50497,50497,50498,5,1,-4
50498,50498,50499,1,8,7
50499,50499,50500,8,3,-5
50500,50500,50501,3,1,-2
50501,50501,50502,1,4,3
50502,50502,50503,4,6,2
50503,50503,50504,6,2,-4
50504,50504,50505,2,8,6
50505,50505,50506,8,6,-2
50506,50506,50507,6,5,-1
50507,50507,50508,5,2,-3
50508,50508,50509,2,6,4
50509,50509,50510,6,4,-2
50510,50510,50511,4,0,-4
50511,50511,50512,0,8,8
50512,50512,50513,8,8,0
50513,50513,50514,8,8,0
50514,50514,50515,8,9,1
50515,50515,50516,9,3,-6
50516,50516,50517,3,4,1
50517,50517,50518,4,0,-4
50518,50518,50519,0,9,9
50519,50519,50520,9,7,-2
50520,50520,50521,7,2,-5
50521,50521,50522,2,9,7
50522,50522,50523,9,0,-9
50523,50523,50524,0,8,8
50524,50524,50525,8,1,-7
50525,50525,50526,1,0,-1
50526,50526,50527,0,2,2
50527,50527,50528,2,9,7
50528,50528,50529,9,3,-6
50529,50529,50530,3,8,5
50530,50530,50531,8,4,-4
50531,50531,50532,4,8,4
50532,50532,50533,8,5,-3
50533,50533,50534,5,0,-5
50534,50534,50535,0,8,8
50535,50535,50536,8,7,-1
50536,50536,50537,7,9,2
50537,50537,50538,9,2,-7
50538,50538,50539,2,0,-2
50539,50539,50540,0,5,5
50540,50540,50541,5,1,-4
50541,50541,50542,1,0,-1
50542,50542,50543,0,2,2
50543,50543,50544,2,9,7
50544,50544,50545,9,3,-6
50545,50545,50546,3,2,-1
50546,50546,50547,2,4,2
50547,50547,50548,4,8,4
50548,50548,50549,8,5,-3
50549,50549,50550,5,1,-4
50550,50550,50551,1,6,5
50551,50551,50552,6,8,2
50552,50552,50553,8,7,-1
50553,50553,50554,7,3,-4
50554,50554,50555,3,8,5
50555,50555,50556,8,6,-2
50556,50556,50557,6,9,3
50557,50557,50558,9,9,0
50558,50558,50559,9,0,-9
50559,50559,50560,0,3,3
50560,50560,50561,3,1,-2
50561,50561,50562,1,9,8
50562,50562,50563,9,2,-7
50563,50563,50564,2,4,2
50564,50564,50565,4,3,-1
50565,50565,50566,3,0,-3
50566,50566,50567,0,4,4
50567,50567,50568,4,2,-2
50568,50568,50569,2,5,3
50569,50569,50570,5,5,0
50570,50570,50571,5,8,3
50571,50571,50572,8,1,-7
50572,50572,50573,1,5,4
50573,50573,50574,5,5,0
50574,50574,50575,5,2,-3
50575,50575,50576,2,2,0
50576,50576,50577,2,1,-1
50577,50577,50578,1,9,8
50578,50578,50579,9,7,-2
50579,50579,50580,7,6,-1
50580,50580,50581,6,2,-4
50581,50581,50582,2,1,-1
50582,50582,50583,1,4,3
50583,50583,50584,4,6,2
50584,50584,50585,6,1,-5
50585,50585,50586,1,0,-1
50586,50586,50587,0,4,4
50587,50587,50588,4,6,2
50588,50588,50589,6,1,-5
50589,50589,50590,1,6,5
50590,50590,50591,6,4,-2
50591,50591,50592,4,5,1
50592,50592,50593,5,9,4
50593,50593,50594,9,6,-3
50594,50594,50595,6,6,0
50595,50595,50596,6,8,2
50596,50596,50597,8,8,0
50597,50597,50598,8,6,-2
50598,50598,50599,6,4,-2
50599,50599,50600,4,1,-3
50600,50600,50601,1,5,4
50601,50601,50602,5,5,0
50602,50602,50603,5,3,-2
50603,50603,50604,3,8,5
50604,50604,50605,8,7,-1
50605,50605,50606,7,4,-3
50606,50606,50607,4,8,4
50607,50607,50608,8,1,-7
50608,50608,50609,1,4,3
50609,50609,50610,4,6,2
50610,50610,50611,6,3,-3
50611,50611,50612,3,6,3
50612,50612,50613,6,3,-3
50613,50613,50614,3,7,4
50614,50614,50615,7,5,-2
50615,50615,50616,5,4,-1
50616,50616,50617,4,0,-4
50617,50617,50618,0,6,6
50618,50618,50619,6,6,0
50619,50619,50620,6,7,1
50620,50620,50621,7,1,-6
50621,50621,50622,1,6,5
50622,50622,50623,6,6,0
50623,50623,50624,6,5,-1
50624,50624,50625,5,8,3
50625,50625,50626,8,8,0
50626,50626,50627,8,7,-1
50627,50627,50628,7,0,-7
50628,50628,50629,0,0,0
50629,50629,50630,0,0,0
50630,50630,50631,0,1,1
50631,50631,50632,1,1,0
50632,50632,50633,1,5,4
50633,50633,50634,5,8,3
50634,50634,50635,8,6,-2
50635,50635,50636,6,4,-2
50636,50636,50637,4,0,-4
50637,50637,50638,0,0,0
50638,50638,50639,0,8,8
50639,50639,50640,8,2,-6
50640,50640,50641,2,5,3
50641,50641,50642,5,2,-3
50642,50642,50643,2,0,-2
50643,50643,50644,0,3,3
50644,50644,50645,3,6,3
50645,50645,50646,6,1,-5
50646,50646,50647,1,1,0
50647,50647,50648,1,7,6
50648,50648,50649,7,5,-2
50649,50649,50650,5,5,0
50650,50650,50651,5,8,3
50651,50651,50652,8,1,-7
50652,50652,50653,1,4,3
50653,50653,50654,4,0,-4
50654,50654,50655,0,7,7
50655,50655,50656,7,4,-3
50656,50656,50657,4,6,2
50657,50657,50658,6,3,-3
50658,50658,50659,3,9,6
50659,50659,50660,9,8,-1
50660,50660,50661,8,1,-7
50661,50661,50662,1,5,4
50662,50662,50663,5,9,4
50663,50663,50664,9,7,-2
50664,50664,50665,7,7,0
50665,50665,50666,7,6,-1
50666,50666,50667,6,1,-5
50667,50667,50668,1,7,6
50668,50668,50669,7,2,-5
50669,50669,50670,2,6,4
50670,50670,50671,6,3,-3
50671,50671,50672,3,3,0
50672,50672,50673,3,4,1
50673,50673,50674,4,2,-2
50674,50674,50675,2,5,3
50675,50675,50676,5,2,-3
50676,50676,50677,2,5,3
50677,50677,50678,5,1,-4
50678,50678,50679,1,3,2
50679,50679,50680,3,3,0
50680,50680,50681,3,7,4
50681,50681,50682,7,1,-6
50682,50682,50683,1,3,2
50683,50683,50684,3,0,-3
50684,50684,50685,0,1,1
50685,50685,50686,1,9,8
50686,50686,50687,9,8,-1
50687,50687,50688,8,3,-5
50688,50688,50689,3,2,-1
50689,50689,50690,2,5,3
50690,50690,50691,5,2,-3
50691,50691,50692,2,8,6
50692,50692,50693,8,3,-5
50693,50693,50694,3,4,1
50694,50694,50695,4,2,-2
50695,50695,50696,2,0,-2
50696,50696,50697,0,7,7
50697,50697,50698,7,9,2
50698,50698,50699,9,4,-5
50699,50699,50700,4,2,-2
50700,50700,50701,2,9,7
50701,50701,50702,9,8,-1
50702,50702,50703,8,9,1
50703,50703,50704,9,4,-5
50704,50704,50705,4,2,-2
50705,50705,50706,2,7,5
50706,50706,50707,7,8,1
50707,50707,50708,8,7,-1
50708,50708,50709,7,1,-6
50709,50709,50710,1,9,8
50710,50710,50711,9,8,-1
50711,50711,50712,8,4,-4
50712,50712,50713,4,3,-1
50713,50713,50714,3,8,5
50714,50714,50715,8,8,0
50715,50715,50716,8,2,-6
50716,50716,50717,2,3,1
50717,50717,50718,3,5,2
50718,50718,50719,5,6,1
50719,50719,50720,6,2,-4
50720,50720,50721,2,7,5
50721,50721,50722,7,2,-5
50722,50722,50723,2,0,-2
50723,50723,50724,0,9,9
50724,50724,50725,9,4,-5
50725,50725,50726,4,3,-1
50726,50726,50727,3,0,-3
50727,50727,50728,0,3,3
50728,50728,50729,3,0,-3
50729,50729,50730,0,7,7
50730,50730,50731,7,1,-6
50731,50731,50732,1,7,6
50732,50732,50733,7,2,-5
50733,50733,50734,2,5,3
50734,50734,50735,5,3,-2
50735,50735,50736,3,2,-1
50736,50736,50737,2,4,2
50737,50737,50738,4,8,4
50738,50738,50739,8,5,-3
50739,50739,50740,5,8,3
50740,50740,50741,8,6,-2
50741,50741,50742,6,7,1
50742,50742,50743,7,7,0
50743,50743,50744,7,2,-5
50744,50744,50745,2,8,6
50745,50745,50746,8,9,1
50746,50746,50747,9,9,0
50747,50747,50748,9,2,-7
50748,50748,50749,2,0,-2
50749,50749,50750,0,0,0
50750,50750,50751,0,1,1
50751,50751,50752,1,9,8
50752,50752,50753,9,2,-7
50753,50753,50754,2,9,7
50754,50754,50755,9,3,-6
50755,50755,50756,3,2,-1
50756,50756,50757,2,4,2
50757,50757,50758,4,9,5
50758,50758,50759,9,5,-4
50759,50759,50760,5,7,2
50760,50760,50761,7,6,-1
50761,50761,50762,6,8,2
50762,50762,50763,8,7,-1
50763,50763,50764,7,5,-2
50764,50764,50765,5,8,3
50765,50765,50766,8,5,-3
50766,50766,50767,5,9,4
50767,50767,50768,9,5,-4
50768,50768,50769,5,0,-5
50769,50769,50770,0,3,3
50770,50770,50771,3,1,-2
50771,50771,50772,1,1,0
50772,50772,50773,1,2,1
50773,50773,50774,2,0,-2
50774,50774,50775,0,3,3
50775,50775,50776,3,6,3
50776,50776,50777,6,4,-2
50777,50777,50778,4,5,1
50778,50778,50779,5,5,0
50779,50779,50780,5,6,1
50780,50780,50781,6,6,0
50781,50781,50782,6,5,-1
50782,50782,50783,5,7,2
50783,50783,50784,7,9,2
50784,50784,50785,9,8,-1
50785,50785,50786,8,5,-3
50786,50786,50787,5,9,4
50787,50787,50788,9,1,-8
50788,50788,50789,1,1,0
50789,50789,50790,1,8,7
50790,50790,50791,8,8,0
50791,50791,50792,8,7,-1
50792,50792,50793,7,6,-1
50793,50793,50794,6,7,1
50794,50794,50795,7,7,0
50795,50795,50796,7,7,0
50796,50796,50797,7,1,-6
50797,50797,50798,1,9,8
50798,50798,50799,9,1,-8
50799,50799,50800,1,5,4
50800,50800,50801,5,4,-1
50801,50801,50802,4,2,-2
50802,50802,50803,2,3,1
50803,50803,50804,3,0,-3
50804,50804,50805,0,7,7
50805,50805,50806,7,9,2
50806,50806,50807,9,9,0
50807,50807,50808,9,0,-9
50808,50808,50809,0,3,3
50809,50809,50810,3,6,3
50810,50810,50811,6,6,0
50811,50811,50812,6,2,-4
50812,50812,50813,2,0,-2
50813,50813,50814,0,2,2
50814,50814,50815,2,3,1
50815,50815,50816,3,9,6
50816,50816,50817,9,6,-3
50817,50817,50818,6,6,0
50818,50818,50819,6,4,-2
50819,50819,50820,4,0,-4
50820,50820,50821,0,8,8
50821,50821,50822,8,7,-1
50822,50822,50823,7,6,-1
50823,50823,50824,6,3,-3
50824,50824,50825,3,0,-3
50825,50825,50826,0,2,2
50826,50826,50827,2,1,-1
50827,50827,50828,1,0,-1
50828,50828,50829,0,1,1
50829,50829,50830,1,1,0
50830,50830,50831,1,5,4
50831,50831,50832,5,9,4
50832,50832,50833,9,9,0
50833,50833,50834,9,3,-6
50834,50834,50835,3,4,1
50835,50835,50836,4,6,2
50836,50836,50837,6,3,-3
50837,50837,50838,3,1,-2
50838,50838,50839,1,0,-1
50839,50839,50840,0,2,2
50840,50840,50841,2,4,2
50841,50841,50842,4,1,-3
50842,50842,50843,1,6,5
50843,50843,50844,6,4,-2
50844,50844,50845,4,9,5
50845,50845,50846,9,4,-5
50846,50846,50847,4,1,-3
50847,50847,50848,1,5,4
50848,50848,50849,5,7,2
50849,50849,50850,7,1,-6
50850,50850,50851,1,9,8
50851,50851,50852,9,0,-9
50852,50852,50853,0,5,5
50853,50853,50854,5,9,4
50854,50854,50855,9,1,-8
50855,50855,50856,1,6,5
50856,50856,50857,6,1,-5
50857,50857,50858,1,4,3
50858,50858,50859,4,9,5
50859,50859,50860,9,8,-1
50860,50860,50861,8,8,0
50861,50861,50862,8,0,-8
50862,50862,50863,0,6,6
50863,50863,50864,6,1,-5
50864,50864,50865,1,6,5
50865,50865,50866,6,6,0
50866,50866,50867,6,9,3
50867,50867,50868,9,7,-2
50868,50868,50869,7,8,1
50869,50869,50870,8,6,-2
50870,50870,50871,6,8,2
50871,50871,50872,8,7,-1
50872,50872,50873,7,8,1
50873,50873,50874,8,7,-1
50874,50874,50875,7,2,-5
50875,50875,50876,2,0,-2
50876,50876,50877,0,7,7
50877,50877,50878,7,7,0
50878,50878,50879,7,4,-3
50879,50879,50880,4,6,2
50880,50880,50881,6,5,-1
50881,50881,50882,5,9,4
50882,50882,50883,9,8,-1
50883,50883,50884,8,7,-1
50884,50884,50885,7,3,-4
50885,50885,50886,3,8,5
50886,50886,50887,8,5,-3
50887,50887,50888,5,6,1
50888,50888,50889,6,4,-2
50889,50889,50890,4,6,2
50890,50890,50891,6,7,1
50891,50891,50892,7,3,-4
50892,50892,50893,3,6,3
50893,50893,50894,6,7,1
50894,50894,50895,7,5,-2
50895,50895,50896,5,9,4
50896,50896,50897,9,2,-7
50897,50897,50898,2,2,0
50898,50898,50899,2,2,0
50899,50899,50900,2,8,6
50900,50900,50901,8,2,-6
50901,50901,50902,2,8,6
50902,50902,50903,8,7,-1
50903,50903,50904,7,5,-2
50904,50904,50905,5,7,2
50905,50905,50906,7,3,-4
50906,50906,50907,3,1,-2
50907,50907,50908,1,9,8
50908,50908,50909,9,0,-9
50909,50909,50910,0,7,7
50910,50910,50911,7,1,-6
50911,50911,50912,1,6,5
50912,50912,50913,6,2,-4
50913,50913,50914,2,1,-1
50914,50914,50915,1,3,2
50915,50915,50916,3,4,1
50916,50916,50917,4,4,0
50917,50917,50918,4,1,-3
50918,50918,50919,1,5,4
50919,50919,50920,5,7,2
50920,50920,50921,7,6,-1
50921,50921,50922,6,3,-3
50922,50922,50923,3,7,4
50923,50923,50924,7,0,-7
50924,50924,50925,0,8,8
50925,50925,50926,8,5,-3
50926,50926,50927,5,9,4
50927,50927,50928,9,1,-8
50928,50928,50929,1,0,-1
50929,50929,50930,0,0,0
50930,50930,50931,0,1,1
50931,50931,50932,1,6,5
50932,50932,50933,6,2,-4
50933,50933,50934,2,6,4
50934,50934,50935,6,3,-3
50935,50935,50936,3,3,0
50936,50936,50937,3,4,1
50937,50937,50938,4,6,2
50938,50938,50939,6,5,-1
50939,50939,50940,5,3,-2
50940,50940,50941,3,6,3
50941,50941,50942,6,7,1
50942,50942,50943,7,7,0
50943,50943,50944,7,0,-7
50944,50944,50945,0,8,8
50945,50945,50946,8,3,-5
50946,50946,50947,3,9,6
50947,50947,50948,9,4,-5
50948,50948,50949,4,0,-4
50949,50949,50950,0,3,3
50950,50950,50951,3,1,-2
50951,50951,50952,1,1,0
50952,50952,50953,1,2,1
50953,50953,50954,2,5,3
50954,50954,50955,5,3,-2
50955,50955,50956,3,1,-2
50956,50956,50957,1,4,3
50957,50957,50958,4,0,-4
50958,50958,50959,0,5,5
50959,50959,50960,5,3,-2
50960,50960,50961,3,6,3
50961,50961,50962,6,2,-4
50962,50962,50963,2,7,5
50963,50963,50964,7,3,-4
50964,50964,50965,3,8,5
50965,50965,50966,8,2,-6
50966,50966,50967,2,9,7
50967,50967,50968,9,0,-9
50968,50968,50969,0,3,3
50969,50969,50970,3,8,5
50970,50970,50971,8,2,-6
50971,50971,50972,2,7,5
50972,50972,50973,7,9,2
50973,50973,50974,9,0,-9
50974,50974,50975,0,3,3
50975,50975,50976,3,3,0
50976,50976,50977,3,2,-1
50977,50977,50978,2,7,5
50978,50978,50979,7,1,-6
50979,50979,50980,1,4,3
50980,50980,50981,4,4,0
50981,50981,50982,4,3,-1
50982,50982,50983,3,5,2
50983,50983,50984,5,7,2
50984,50984,50985,7,5,-2
50985,50985,50986,5,2,-3
50986,50986,50987,2,2,0
50987,50987,50988,2,8,6
50988,50988,50989,8,3,-5
50989,50989,50990,3,0,-3
50990,50990,50991,0,2,2
50991,50991,50992,2,7,5
50992,50992,50993,7,1,-6
50993,50993,50994,1,7,6
50994,50994,50995,7,3,-4
50995,50995,50996,3,8,5
50996,50996,50997,8,9,1
50997,50997,50998,9,4,-5
50998,50998,50999,4,7,3
50999,50999,51000,7,7,0
51000,51000,51001,7,2,-5
51001,51001,51002,2,0,-2
51002,51002,51003,0,1,1
51003,51003,51004,1,7,6
51004,51004,51005,7,1,-6
51005,51005,51006,1,0,-1
51006,51006,51007,0,8,8
51007,51007,51008,8,8,0
51008,51008,51009,8,8,0
51009,51009,51010,8,1,-7
51010,51010,51011,1,7,6
51011,51011,51012,7,9,2
51012,51012,51013,9,8,-1
51013,51013,51014,8,8,0
51014,51014,51015,8,1,-7
51015,51015,51016,1,2,1
51016,51016,51017,2,0,-2
51017,51017,51018,0,4,4
51018,51018,51019,4,0,-4
51019,51019,51020,0,9,9
51020,51020,51021,9,6,-3
51021,51021,51022,6,9,3
51022,51022,51023,9,7,-2
51023,51023,51024,7,0,-7
51024,51024,51025,0,7,7
51025,51025,51026,7,4,-3
51026,51026,51027,4,5,1
51027,51027,51028,5,4,-1
51028,51028,51029,4,0,-4
51029,51029,51030,0,3,3
51030,51030,51031,3,6,3
51031,51031,51032,6,9,3
51032,51032,51033,9,1,-8
51033,51033,51034,1,7,6
51034,51034,51035,7,1,-6
51035,51035,51036,1,9,8
51036,51036,51037,9,2,-7
51037,51037,51038,2,3,1
51038,51038,51039,3,5,2
51039,51039,51040,5,5,0
51040,51040,51041,5,0,-5
51041,51041,51042,0,9,9
51042,51042,51043,9,7,-2
51043,51043,51044,7,0,-7
51044,51044,51045,0,0,0
51045,51045,51046,0,4,4
51046,51046,51047,4,4,0
51047,51047,51048,4,1,-3
51048,51048,51049,1,4,3
51049,51049,51050,4,5,1
51050,51050,51051,5,1,-4
51051,51051,51052,1,0,-1
51052,51052,51053,0,8,8
51053,51053,51054,8,3,-5
51054,51054,51055,3,6,3
51055,51055,51056,6,4,-2
51056,51056,51057,4,0,-4
51057,51057,51058,0,8,8
51058,51058,51059,8,0,-8
51059,51059,51060,0,1,1
51060,51060,51061,1,0,-1
51061,51061,51062,0,7,7
51062,51062,51063,7,3,-4
51063,51063,51064,3,2,-1
51064,51064,51065,2,7,5
51065,51065,51066,7,6,-1
51066,51066,51067,6,1,-5
51067,51067,51068,1,7,6
51068,51068,51069,7,6,-1
51069,51069,51070,6,7,1
51070,51070,51071,7,4,-3
51071,51071,51072,4,5,1
51072,51072,51073,5,2,-3
51073,51073,51074,2,7,5
51074,51074,51075,7,6,-1
51075,51075,51076,6,4,-2
51076,51076,51077,4,4,0
51077,51077,51078,4,8,4
51078,51078,51079,8,5,-3
51079,51079,51080,5,7,2
51080,51080,51081,7,4,-3
51081,51081,51082,4,9,5
51082,51082,51083,9,1,-8
51083,51083,51084,1,7,6
51084,51084,51085,7,3,-4
51085,51085,51086,3,5,2
51086,51086,51087,5,8,3
51087,51087,51088,8,7,-1
51088,51088,51089,7,6,-1
51089,51089,51090,6,2,-4
51090,51090,51091,2,3,1
51091,51091,51092,3,3,0
51092,51092,51093,3,9,6
51093,51093,51094,9,8,-1
51094,51094,51095,8,9,1
51095,51095,51096,9,6,-3
51096,51096,51097,6,5,-1
51097,51097,51098,5,4,-1
51098,51098,51099,4,9,5
51099,51099,51100,9,2,-7
51100,51100,51101,2,3,1
51101,51101,51102,3,7,4
51102,51102,51103,7,7,0
51103,51103,51104,7,8,1
51104,51104,51105,8,8,0
51105,51105,51106,8,3,-5
51106,51106,51107,3,5,2
51107,51107,51108,5,0,-5
51108,51108,51109,0,6,6
51109,51109,51110,6,1,-5
51110,51110,51111,1,4,3
51111,51111,51112,4,1,-3
51112,51112,51113,1,7,6
51113,51113,51114,7,4,-3
51114,51114,51115,4,6,2
51115,51115,51116,6,3,-3
51116,51116,51117,3,2,-1
51117,51117,51118,2,2,0
51118,51118,51119,2,2,0
51119,51119,51120,2,1,-1
51120,51120,51121,1,0,-1
51121,51121,51122,0,0,0
51122,51122,51123,0,9,9
51123,51123,51124,9,5,-4
51124,51124,51125,5,4,-1
51125,51125,51126,4,7,3
51126,51126,51127,7,0,-7
51127,51127,51128,0,8,8
51128,51128,51129,8,1,-7
51129,51129,51130,1,5,4
51130,51130,51131,5,2,-3
51131,51131,51132,2,9,7
51132,51132,51133,9,3,-6
51133,51133,51134,3,8,5
51134,51134,51135,8,4,-4
51135,51135,51136,4,1,-3
51136,51136,51137,1,5,4
51137,51137,51138,5,7,2
51138,51138,51139,7,6,-1
51139,51139,51140,6,9,3
51140,51140,51141,9,7,-2
51141,51141,51142,7,3,-4
51142,51142,51143,3,8,5
51143,51143,51144,8,5,-3
51144,51144,51145,5,9,4
51145,51145,51146,9,4,-5
51146,51146,51147,4,0,-4
51147,51147,51148,0,0,0
51148,51148,51149,0,1,1
51149,51149,51150,1,0,-1
51150,51150,51151,0,2,2
51151,51151,51152,2,6,4
51152,51152,51153,6,3,-3
51153,51153,51154,3,3,0
51154,51154,51155,3,4,1
51155,51155,51156,4,9,5
51156,51156,51157,9,5,-4
51157,51157,51158,5,8,3
51158,51158,51159,8,6,-2
51159,51159,51160,6,8,2
51160,51160,51161,8,7,-1
51161,51161,51162,7,7,0
51162,51162,51163,7,8,1
51163,51163,51164,8,8,0
51164,51164,51165,8,9,1
51165,51165,51166,9,7,-2
51166,51166,51167,7,0,-7
51167,51167,51168,0,9,9
51168,51168,51169,9,1,-8
51169,51169,51170,1,4,3
51170,51170,51171,4,2,-2
51171,51171,51172,2,8,6
51172,51172,51173,8,3,-5
51173,51173,51174,3,7,4
51174,51174,51175,7,4,-3
51175,51175,51176,4,5,1
51176,51176,51177,5,5,0
51177,51177,51178,5,7,2
51178,51178,51179,7,6,-1
51179,51179,51180,6,7,1
51180,51180,51181,7,7,0
51181,51181,51182,7,4,-3
51182,51182,51183,4,8,4
51183,51183,51184,8,8,0
51184,51184,51185,8,9,1
51185,51185,51186,9,0,-9
51186,51186,51187,0,1,1
51187,51187,51188,1,1,0
51188,51188,51189,1,8,7
51189,51189,51190,8,1,-7
51190,51190,51191,1,6,5
51191,51191,51192,6,9,3
51192,51192,51193,9,7,-2
51193,51193,51194,7,9,2
51194,51194,51195,9,1,-8
51195,51195,51196,1,3,2
51196,51196,51197,3,1,-2
51197,51197,51198,1,7,6
51198,51198,51199,7,4,-3
51199,51199,51200,4,9,5
51200,51200,51201,9,3,-6
51201,51201,51202,3,4,1
51202,51202,51203,4,7,3
51203,51203,51204,7,7,0
51204,51204,51205,7,7,0
51205,51205,51206,7,1,-6
51206,51206,51207,1,8,7
51207,51207,51208,8,8,0
51208,51208,51209,8,9,1
51209,51209,51210,9,0,-9
51210,51210,51211,0,3,3
51211,51211,51212,3,2,-1
51212,51212,51213,2,6,4
51213,51213,51214,6,2,-4
51214,51214,51215,2,0,-2
51215,51215,51216,0,2,2
51216,51216,51217,2,3,1
51217,51217,51218,3,8,5
51218,51218,51219,8,6,-2
51219,51219,51220,6,6,0
51220,51220,51221,6,4,-2
51221,51221,51222,4,3,-1
51222,51222,51223,3,8,5
51223,51223,51224,8,8,0
51224,51224,51225,8,4,-4
51225,51225,51226,4,0,-4
51226,51226,51227,0,5,5
51227,51227,51228,5,0,-5
51228,51228,51229,0,7,7
51229,51229,51230,7,3,-4
51230,51230,51231,3,5,2
51231,51231,51232,5,6,1
51232,51232,51233,6,6,0
51233,51233,51234,6,5,-1
51234,51234,51235,5,0,-5
51235,51235,51236,0,7,7
51236,51236,51237,7,3,-4
51237,51237,51238,3,2,-1
51238,51238,51239,2,9,7
51239,51239,51240,9,9,0
51240,51240,51241,9,2,-7
51241,51241,51242,2,8,6
51242,51242,51243,8,8,0
51243,51243,51244,8,8,0
51244,51244,51245,8,3,-5
51245,51245,51246,3,6,3
51246,51246,51247,6,1,-5
51247,51247,51248,1,9,8
51248,51248,51249,9,1,-8
51249,51249,51250,1,1,0
51250,51250,51251,1,5,4
51251,51251,51252,5,1,-4
51252,51252,51253,1,9,8
51253,51253,51254,9,5,-4
51254,51254,51255,5,4,-1
51255,51255,51256,4,2,-2
51256,51256,51257,2,3,1
51257,51257,51258,3,5,2
51258,51258,51259,5,0,-5
51259,51259,51260,0,3,3
51260,51260,51261,3,4,1
51261,51261,51262,4,2,-2
51262,51262,51263,2,4,2
51263,51263,51264,4,4,0
51264,51264,51265,4,0,-4
51265,51265,51266,0,8,8
51266,51266,51267,8,9,1
51267,51267,51268,9,3,-6
51268,51268,51269,3,6,3
51269,51269,51270,6,4,-2
51270,51270,51271,4,9,5
51271,51271,51272,9,8,-1
51272,51272,51273,8,2,-6
51273,51273,51274,2,3,1
51274,51274,51275,3,2,-1
51275,51275,51276,2,6,4
51276,51276,51277,6,1,-5
51277,51277,51278,1,5,4
51278,51278,51279,5,7,2
51279,51279,51280,7,9,2
51280,51280,51281,9,9,0
51281,51281,51282,9,7,-2
51282,51282,51283,7,5,-2
51283,51283,51284,5,9,4
51284,51284,51285,9,1,-8
51285,51285,51286,1,0,-1
51286,51286,51287,0,1,1
51287,51287,51288,1,4,3
51288,51288,51289,4,9,5
51289,51289,51290,9,0,-9
51290,51290,51291,0,8,8
51291,51291,51292,8,7,-1
51292,51292,51293,7,6,-1
51293,51293,51294,6,7,1
51294,51294,51295,7,6,-1
51295,51295,51296,6,5,-1
51296,51296,51297,5,9,4
51297,51297,51298,9,5,-4
51298,51298,51299,5,0,-5
51299,51299,51300,0,7,7
51300,51300,51301,7,0,-7
51301,51301,51302,0,8,8
51302,51302,51303,8,0,-8
51303,51303,51304,0,7,7
51304,51304,51305,7,1,-6
51305,51305,51306,1,7,6
51306,51306,51307,7,8,1
51307,51307,51308,8,0,-8
51308,51308,51309,0,4,4
51309,51309,51310,4,6,2
51310,51310,51311,6,6,0
51311,51311,51312,6,4,-2
51312,51312,51313,4,8,4
51313,51313,51314,8,0,-8
51314,51314,51315,0,8,8
51315,51315,51316,8,9,1
51316,51316,51317,9,2,-7
51317,51317,51318,2,9,7
51318,51318,51319,9,6,-3
51319,51319,51320,6,2,-4
51320,51320,51321,2,3,1
51321,51321,51322,3,7,4
51322,51322,51323,7,2,-5
51323,51323,51324,2,8,6
51324,51324,51325,8,4,-4
51325,51325,51326,4,8,4
51326,51326,51327,8,0,-8
51327,51327,51328,0,4,4
51328,51328,51329,4,9,5
51329,51329,51330,9,8,-1
51330,51330,51331,8,0,-8
51331,51331,51332,0,3,3
51332,51332,51333,3,3,0
51333,51333,51334,3,9,6
51334,51334,51335,9,7,-2
51335,51335,51336,7,0,-7
51336,51336,51337,0,4,4
51337,51337,51338,4,4,0
51338,51338,51339,4,5,1
51339,51339,51340,5,2,-3
51340,51340,51341,2,8,6
51341,51341,51342,8,5,-3
51342,51342,51343,5,3,-2
51343,51343,51344,3,7,4
51344,51344,51345,7,5,-2
51345,51345,51346,5,7,2
51346,51346,51347,7,8,1
51347,51347,51348,8,0,-8
51348,51348,51349,0,5,5
51349,51349,51350,5,4,-1
51350,51350,51351,4,4,0
51351,51351,51352,4,0,-4
51352,51352,51353,0,7,7
51353,51353,51354,7,6,-1
51354,51354,51355,6,6,0
51355,51355,51356,6,2,-4
51356,51356,51357,2,2,0
51357,51357,51358,2,7,5
51358,51358,51359,7,2,-5
51359,51359,51360,2,4,2
51360,51360,51361,4,7,3
51361,51361,51362,7,5,-2
51362,51362,51363,5,7,2
51363,51363,51364,7,5,-2
51364,51364,51365,5,0,-5
51365,51365,51366,0,5,5
51366,51366,51367,5,5,0
51367,51367,51368,5,4,-1
51368,51368,51369,4,1,-3
51369,51369,51370,1,6,5
51370,51370,51371,6,5,-1
51371,51371,51372,5,1,-4
51372,51372,51373,1,3,2
51373,51373,51374,3,4,1
51374,51374,51375,4,0,-4
51375,51375,51376,0,3,3
51376,51376,51377,3,1,-2
51377,51377,51378,1,6,5
51378,51378,51379,6,2,-4
51379,51379,51380,2,5,3
51380,51380,51381,5,3,-2
51381,51381,51382,3,4,1
51382,51382,51383,4,4,0
51383,51383,51384,4,7,3
51384,51384,51385,7,5,-2
51385,51385,51386,5,6,1
51386,51386,51387,6,6,0
51387,51387,51388,6,3,-3
51388,51388,51389,3,7,4
51389,51389,51390,7,1,-6
51390,51390,51391,1,8,7
51391,51391,51392,8,5,-3
51392,51392,51393,5,9,4
51393,51393,51394,9,8,-1
51394,51394,51395,8,0,-8
51395,51395,51396,0,4,4
51396,51396,51397,4,1,-3
51397,51397,51398,1,2,1
51398,51398,51399,2,2,0
51399,51399,51400,2,6,4
51400,51400,51401,6,3,-3
51401,51401,51402,3,6,3
51402,51402,51403,6,4,-2
51403,51403,51404,4,0,-4
51404,51404,51405,0,5,5
51405,51405,51406,5,6,1
51406,51406,51407,6,6,0
51407,51407,51408,6,6,0
51408,51408,51409,6,7,1
51409,51409,51410,7,6,-1
51410,51410,51411,6,8,2
51411,51411,51412,8,8,0
51412,51412,51413,8,9,1
51413,51413,51414,9,8,-1
51414,51414,51415,8,0,-8
51415,51415,51416,0,5,5
51416,51416,51417,5,1,-4
51417,51417,51418,1,2,1
51418,51418,51419,2,2,0
51419,51419,51420,2,7,5
51420,51420,51421,7,3,-4
51421,51421,51422,3,0,-3
51422,51422,51423,0,4,4
51423,51423,51424,4,8,4
51424,51424,51425,8,5,-3
51425,51425,51426,5,1,-4
51426,51426,51427,1,6,5
51427,51427,51428,6,3,-3
51428,51428,51429,3,7,4
51429,51429,51430,7,9,2
51430,51430,51431,9,8,-1
51431,51431,51432,8,1,-7
51432,51432,51433,1,5,4
51433,51433,51434,5,0,-5
51434,51434,51435,0,2,2
51435,51435,51436,2,1,-1
51436,51436,51437,1,8,7
51437,51437,51438,8,6,-2
51438,51438,51439,6,1,-5
51439,51439,51440,1,8,7
51440,51440,51441,8,7,-1
51441,51441,51442,7,9,2
51442,51442,51443,9,2,-7
51443,51443,51444,2,5,3
51444,51444,51445,5,4,-1
51445,51445,51446,4,6,2
51446,51446,51447,6,1,-5
51447,51447,51448,1,2,1
51448,51448,51449,2,4,2
51449,51449,51450,4,8,4
51450,51450,51451,8,1,-7
51451,51451,51452,1,7,6
51452,51452,51453,7,4,-3
51453,51453,51454,4,4,0
51454,51454,51455,4,9,5
51455,51455,51456,9,6,-3
51456,51456,51457,6,6,0
51457,51457,51458,6,2,-4
51458,51458,51459,2,8,6
51459,51459,51460,8,7,-1
51460,51460,51461,7,5,-2
51461,51461,51462,5,3,-2
51462,51462,51463,3,3,0
51463,51463,51464,3,0,-3
51464,51464,51465,0,7,7
51465,51465,51466,7,0,-7
51466,51466,51467,0,8,8
51467,51467,51468,8,1,-7
51468,51468,51469,1,3,2
51469,51469,51470,3,9,6
51470,51470,51471,9,3,-6
51471,51471,51472,3,9,6
51472,51472,51473,9,5,-4
51473,51473,51474,5,3,-2
51474,51474,51475,3,6,3
51475,51475,51476,6,6,0
51476,51476,51477,6,7,1
51477,51477,51478,7,0,-7
51478,51478,51479,0,0,0
51479,51479,51480,0,6,6
51480,51480,51481,6,6,0
51481,51481,51482,6,4,-2
51482,51482,51483,4,1,-3
51483,51483,51484,1,8,7
51484,51484,51485,8,6,-2
51485,51485,51486,6,3,-3
51486,51486,51487,3,8,5
51487,51487,51488,8,8,0
51488,51488,51489,8,7,-1
51489,51489,51490,7,0,-7
51490,51490,51491,0,0,0
51491,51491,51492,0,5,5
51492,51492,51493,5,1,-4
51493,51493,51494,1,5,4
51494,51494,51495,5,5,0
51495,51495,51496,5,7,2
51496,51496,51497,7,6,-1
51497,51497,51498,6,5,-1
51498,51498,51499,5,0,-5
51499,51499,51500,0,7,7
51500,51500,51501,7,8,1
51501,51501,51502,8,7,-1
51502,51502,51503,7,5,-2
51503,51503,51504,5,8,3
51504,51504,51505,8,0,-8
51505,51505,51506,0,2,2
51506,51506,51507,2,6,4
51507,51507,51508,6,6,0
51508,51508,51509,6,1,-5
51509,51509,51510,1,8,7
51510,51510,51511,8,5,-3
51511,51511,51512,5,9,4
51512,51512,51513,9,8,-1
51513,51513,51514,8,6,-2
51514,51514,51515,6,4,-2
51515,51515,51516,4,9,5
51516,51516,51517,9,2,-7
51517,51517,51518,2,6,4
51518,51518,51519,6,3,-3
51519,51519,51520,3,0,-3
51520,51520,51521,0,9,9
51521,51521,51522,9,3,-6
51522,51522,51523,3,7,4
51523,51523,51524,7,5,-2
51524,51524,51525,5,6,1
51525,51525,51526,6,7,1
51526,51526,51527,7,9,2
51527,51527,51528,9,6,-3
51528,51528,51529,6,1,-5
51529,51529,51530,1,2,1
51530,51530,51531,2,9,7
51531,51531,51532,9,7,-2
51532,51532,51533,7,0,-7
51533,51533,51534,0,3,3
51534,51534,51535,3,6,3
51535,51535,51536,6,3,-3
51536,51536,51537,3,7,4
51537,51537,51538,7,6,-1
51538,51538,51539,6,1,-5
51539,51539,51540,1,1,0
51540,51540,51541,1,2,1
51541,51541,51542,2,2,0
51542,51542,51543,2,3,1
51543,51543,51544,3,1,-2
51544,51544,51545,1,9,8
51545,51545,51546,9,0,-9
51546,51546,51547,0,2,2
51547,51547,51548,2,1,-1
51548,51548,51549,1,4,3
51549,51549,51550,4,2,-2
51550,51550,51551,2,5,3
51551,51551,51552,5,9,4
51552,51552,51553,9,5,-4
51553,51553,51554,5,1,-4
51554,51554,51555,1,3,2
51555,51555,51556,3,1,-2
51556,51556,51557,1,7,6
51557,51557,51558,7,7,0
51558,51558,51559,7,5,-2
51559,51559,51560,5,7,2
51560,51560,51561,7,3,-4
51561,51561,51562,3,5,2
51562,51562,51563,5,1,-4
51563,51563,51564,1,1,0
51564,51564,51565,1,8,7
51565,51565,51566,8,1,-7
51566,51566,51567,1,2,1
51567,51567,51568,2,7,5
51568,51568,51569,7,2,-5
51569,51569,51570,2,6,4
51570,51570,51571,6,3,-3
51571,51571,51572,3,5,2
51572,51572,51573,5,0,-5
51573,51573,51574,0,9,9
51574,51574,51575,9,2,-7
51575,51575,51576,2,8,6
51576,51576,51577,8,9,1
51577,51577,51578,9,3,-6
51578,51578,51579,3,4,1
51579,51579,51580,4,2,-2
51580,51580,51581,2,9,7
51581,51581,51582,9,9,0
51582,51582,51583,9,7,-2
51583,51583,51584,7,9,2
51584,51584,51585,9,0,-9
51585,51585,51586,0,7,7
51586,51586,51587,7,0,-7
51587,51587,51588,0,8,8
51588,51588,51589,8,2,-6
51589,51589,51590,2,9,7
51590,51590,51591,9,7,-2
51591,51591,51592,7,9,2
51592,51592,51593,9,4,-5
51593,51593,51594,4,1,-3
51594,51594,51595,1,9,8
51595,51595,51596,9,6,-3
51596,51596,51597,6,9,3
51597,51597,51598,9,0,-9
51598,51598,51599,0,2,2
51599,51599,51600,2,4,2
51600,51600,51601,4,8,4
51601,51601,51602,8,6,-2
51602,51602,51603,6,1,-5
51603,51603,51604,1,4,3
51604,51604,51605,4,5,1
51605,51605,51606,5,1,-4
51606,51606,51607,1,6,5
51607,51607,51608,6,2,-4
51608,51608,51609,2,9,7
51609,51609,51610,9,5,-4
51610,51610,51611,5,8,3
51611,51611,51612,8,8,0
51612,51612,51613,8,3,-5
51613,51613,51614,3,2,-1
51614,51614,51615,2,8,6
51615,51615,51616,8,3,-5
51616,51616,51617,3,3,0
51617,51617,51618,3,0,-3
51618,51618,51619,0,6,6
51619,51619,51620,6,6,0
51620,51620,51621,6,7,1
51621,51621,51622,7,4,-3
51622,51622,51623,4,0,-4
51623,51623,51624,0,6,6
51624,51624,51625,6,4,-2
51625,51625,51626,4,5,1
51626,51626,51627,5,0,-5
51627,51627,51628,0,6,6
51628,51628,51629,6,0,-6
51629,51629,51630,0,2,2
51630,51630,51631,2,1,-1
51631,51631,51632,1,9,8
51632,51632,51633,9,2,-7
51633,51633,51634,2,7,5
51634,51634,51635,7,3,-4
51635,51635,51636,3,7,4
51636,51636,51637,7,4,-3
51637,51637,51638,4,0,-4
51638,51638,51639,0,5,5
51639,51639,51640,5,3,-2
51640,51640,51641,3,6,3
51641,51641,51642,6,2,-4
51642,51642,51643,2,7,5
51643,51643,51644,7,9,2
51644,51644,51645,9,8,-1
51645,51645,51646,8,5,-3
51646,51646,51647,5,9,4
51647,51647,51648,9,2,-7
51648,51648,51649,2,0,-2
51649,51649,51650,0,7,7
51650,51650,51651,7,1,-6
51651,51651,51652,1,4,3
51652,51652,51653,4,2,-2
51653,51653,51654,2,9,7
51654,51654,51655,9,3,-6
51655,51655,51656,3,8,5
51656,51656,51657,8,4,-4
51657,51657,51658,4,2,-2
51658,51658,51659,2,5,3
51659,51659,51660,5,2,-3
51660,51660,51661,2,6,4
51661,51661,51662,6,6,0
51662,51662,51663,6,7,1
51663,51663,51664,7,6,-1
51664,51664,51665,6,8,2
51665,51665,51666,8,1,-7
51666,51666,51667,1,9,8
51667,51667,51668,9,8,-1
51668,51668,51669,8,0,-8
51669,51669,51670,0,8,8
51670,51670,51671,8,1,-7
51671,51671,51672,1,1,0
51672,51672,51673,1,2,1
51673,51673,51674,2,5,3
51674,51674,51675,5,3,-2
51675,51675,51676,3,6,3
51676,51676,51677,6,4,-2
51677,51677,51678,4,4,0
51678,51678,51679,4,5,1
51679,51679,51680,5,0,-5
51680,51680,51681,0,6,6
51681,51681,51682,6,2,-4
51682,51682,51683,2,7,5
51683,51683,51684,7,4,-3
51684,51684,51685,4,0,-4
51685,51685,51686,0,3,3
51686,51686,51687,3,6,3
51687,51687,51688,6,9,3
51688,51688,51689,9,4,-5
51689,51689,51690,4,6,2
51690,51690,51691,6,7,1
51691,51691,51692,7,5,-2
51692,51692,51693,5,4,-1
51693,51693,51694,4,4,0
51694,51694,51695,4,3,-1
51695,51695,51696,3,6,3
51696,51696,51697,6,6,0
51697,51697,51698,6,2,-4
51698,51698,51699,2,2,0
51699,51699,51700,2,6,4
51700,51700,51701,6,3,-3
51701,51701,51702,3,2,-1
51702,51702,51703,2,4,2
51703,51703,51704,4,7,3
51704,51704,51705,7,8,1
51705,51705,51706,8,3,-5
51706,51706,51707,3,7,4
51707,51707,51708,7,9,2
51708,51708,51709,9,8,-1
51709,51709,51710,8,1,-7
51710,51710,51711,1,6,5
51711,51711,51712,6,4,-2
51712,51712,51713,4,9,5
51713,51713,51714,9,1,-8
51714,51714,51715,1,8,7
51715,51715,51716,8,9,1
51716,51716,51717,9,3,-6
51717,51717,51718,3,5,2
51718,51718,51719,5,2,-3
51719,51719,51720,2,8,6
51720,51720,51721,8,2,-6
51721,51721,51722,2,4,2
51722,51722,51723,4,4,0
51723,51723,51724,4,1,-3
51724,51724,51725,1,8,7
51725,51725,51726,8,2,-6
51726,51726,51727,2,5,3
51727,51727,51728,5,6,1
51728,51728,51729,6,6,0
51729,51729,51730,6,9,3
51730,51730,51731,9,5,-4
51731,51731,51732,5,8,3
51732,51732,51733,8,0,-8
51733,51733,51734,0,6,6
51734,51734,51735,6,2,-4
51735,51735,51736,2,5,3
51736,51736,51737,5,0,-5
51737,51737,51738,0,2,2
51738,51738,51739,2,1,-1
51739,51739,51740,1,5,4
51740,51740,51741,5,1,-4
51741,51741,51742,1,1,0
51742,51742,51743,1,2,1
51743,51743,51744,2,5,3
51744,51744,51745,5,6,1
51745,51745,51746,6,8,2
51746,51746,51747,8,8,0
51747,51747,51748,8,2,-6
51748,51748,51749,2,1,-1
51749,51749,51750,1,1,0
51750,51750,51751,1,2,1
51751,51751,51752,2,7,5
51752,51752,51753,7,0,-7
51753,51753,51754,0,8,8
51754,51754,51755,8,6,-2
51755,51755,51756,6,3,-3
51756,51756,51757,3,9,6
51757,51757,51758,9,0,-9
51758,51758,51759,0,3,3
51759,51759,51760,3,2,-1
51760,51760,51761,2,9,7
51761,51761,51762,9,5,-4
51762,51762,51763,5,3,-2
51763,51763,51764,3,5,2
51764,51764,51765,5,7,2
51765,51765,51766,7,7,0
51766,51766,51767,7,1,-6
51767,51767,51768,1,3,2
51768,51768,51769,3,8,5
51769,51769,51770,8,9,1
51770,51770,51771,9,3,-6
51771,51771,51772,3,1,-2
51772,51772,51773,1,8,7
51773,51773,51774,8,0,-8
51774,51774,51775,0,5,5
51775,51775,51776,5,3,-2
51776,51776,51777,3,0,-3
51777,51777,51778,0,6,6
51778,51778,51779,6,1,-5
51779,51779,51780,1,4,3
51780,51780,51781,4,1,-3
51781,51781,51782,1,2,1
51782,51782,51783,2,9,7
51783,51783,51784,9,1,-8
51784,51784,51785,1,8,7
51785,51785,51786,8,2,-6
51786,51786,51787,2,2,0
51787,51787,51788,2,6,4
51788,51788,51789,6,0,-6
51789,51789,51790,0,3,3
51790,51790,51791,3,4,1
51791,51791,51792,4,5,1
51792,51792,51793,5,5,0
51793,51793,51794,5,5,0
51794,51794,51795,5,5,0
51795,51795,51796,5,9,4
51796,51796,51797,9,0,-9
51797,51797,51798,0,3,3
51798,51798,51799,3,3,0
51799,51799,51800,3,5,2
51800,51800,51801,5,1,-4
51801,51801,51802,1,7,6
51802,51802,51803,7,8,1
51803,51803,51804,8,6,-2
51804,51804,51805,6,6,0
51805,51805,51806,6,7,1
51806,51806,51807,7,9,2
51807,51807,51808,9,2,-7
51808,51808,51809,2,0,-2
51809,51809,51810,0,2,2
51810,51810,51811,2,3,1
51811,51811,51812,3,9,6
51812,51812,51813,9,1,-8
51813,51813,51814,1,4,3
51814,51814,51815,4,0,-4
51815,51815,51816,0,3,3
51816,51816,51817,3,4,1
51817,51817,51818,4,0,-4
51818,51818,51819,0,7,7
51819,51819,51820,7,4,-3
51820,51820,51821,4,5,1
51821,51821,51822,5,5,0
51822,51822,51823,5,4,-1
51823,51823,51824,4,0,-4
51824,51824,51825,0,7,7
51825,51825,51826,7,0,-7
51826,51826,51827,0,9,9
51827,51827,51828,9,0,-9
51828,51828,51829,0,7,7
51829,51829,51830,7,8,1
51830,51830,51831,8,0,-8
51831,51831,51832,0,7,7
51832,51832,51833,7,1,-6
51833,51833,51834,1,0,-1
51834,51834,51835,0,2,2
51835,51835,51836,2,1,-1
51836,51836,51837,1,3,2
51837,51837,51838,3,4,1
51838,51838,51839,4,7,3
51839,51839,51840,7,9,2
51840,51840,51841,9,8,-1
51841,51841,51842,8,9,1
51842,51842,51843,9,9,0
51843,51843,51844,9,5,-4
51844,51844,51845,5,0,-5
51845,51845,51846,0,8,8
51846,51846,51847,8,1,-7
51847,51847,51848,1,3,2
51848,51848,51849,3,2,-1
51849,51849,51850,2,8,6
51850,51850,51851,8,3,-5
51851,51851,51852,3,5,2
51852,51852,51853,5,4,-1
51853,51853,51854,4,5,1
51854,51854,51855,5,5,0
51855,51855,51856,5,7,2
51856,51856,51857,7,6,-1
51857,51857,51858,6,7,1
51858,51858,51859,7,7,0
51859,51859,51860,7,4,-3
51860,51860,51861,4,8,4
51861,51861,51862,8,7,-1
51862,51862,51863,7,9,2
51863,51863,51864,9,8,-1
51864,51864,51865,8,0,-8
51865,51865,51866,0,0,0
51866,51866,51867,0,1,1
51867,51867,51868,1,4,3
51868,51868,51869,4,2,-2
51869,51869,51870,2,2,0
51870,51870,51871,2,3,1
51871,51871,51872,3,6,3
51872,51872,51873,6,4,-2
51873,51873,51874,4,5,1
51874,51874,51875,5,5,0
51875,51875,51876,5,1,-4
51876,51876,51877,1,6,5
51877,51877,51878,6,8,2
51878,51878,51879,8,7,-1
51879,51879,51880,7,8,1
51880,51880,51881,8,8,0
51881,51881,51882,8,1,-7
51882,51882,51883,1,0,-1
51883,51883,51884,0,2,2
51884,51884,51885,2,7,5
51885,51885,51886,7,5,-2
51886,51886,51887,5,5,0
51887,51887,51888,5,1,-4
51888,51888,51889,1,0,-1
51889,51889,51890,0,3,3
51890,51890,51891,3,8,5
51891,51891,51892,8,0,-8
51892,51892,51893,0,4,4
51893,51893,51894,4,4,0
51894,51894,51895,4,1,-3
51895,51895,51896,1,3,2
51896,51896,51897,3,8,5
51897,51897,51898,8,2,-6
51898,51898,51899,2,8,6
51899,51899,51900,8,1,-7
51900,51900,51901,1,1,0
51901,51901,51902,1,4,3
51902,51902,51903,4,3,-1
51903,51903,51904,3,8,5
51904,51904,51905,8,1,-7
51905,51905,51906,1,8,7
51906,51906,51907,8,8,0
51907,51907,51908,8,1,-7
51908,51908,51909,1,3,2
51909,51909,51910,3,9,6
51910,51910,51911,9,7,-2
51911,51911,51912,7,6,-1
51912,51912,51913,6,9,3
51913,51913,51914,9,7,-2
51914,51914,51915,7,3,-4
51915,51915,51916,3,7,4
51916,51916,51917,7,0,-7
51917,51917,51918,0,3,3
51918,51918,51919,3,9,6
51919,51919,51920,9,6,-3
51920,51920,51921,6,4,-2
51921,51921,51922,4,2,-2
51922,51922,51923,2,4,2
51923,51923,51924,4,6,2
51924,51924,51925,6,0,-6
51925,51925,51926,0,4,4
51926,51926,51927,4,7,3
51927,51927,51928,7,5,-2
51928,51928,51929,5,4,-1
51929,51929,51930,4,9,5
51930,51930,51931,9,2,-7
51931,51931,51932,2,1,-1
51932,51932,51933,1,8,7
51933,51933,51934,8,3,-5
51934,51934,51935,3,7,4
51935,51935,51936,7,1,-6
51936,51936,51937,1,2,1
51937,51937,51938,2,9,7
51938,51938,51939,9,4,-5
51939,51939,51940,4,3,-1
51940,51940,51941,3,7,4
51941,51941,51942,7,9,2
51942,51942,51943,9,8,-1
51943,51943,51944,8,4,-4
51944,51944,51945,4,9,5
51945,51945,51946,9,3,-6
51946,51946,51947,3,3,0
51947,51947,51948,3,8,5
51948,51948,51949,8,1,-7
51949,51949,51950,1,5,4
51950,51950,51951,5,4,-1
51951,51951,51952,4,1,-3
51952,51952,51953,1,6,5
51953,51953,51954,6,8,2
51954,51954,51955,8,5,-3
51955,51955,51956,5,9,4
51956,51956,51957,9,2,-7
51957,51957,51958,2,7,5
51958,51958,51959,7,2,-5
51959,51959,51960,2,0,-2
51960,51960,51961,0,2,2
51961,51961,51962,2,4,2
51962,51962,51963,4,5,1
51963,51963,51964,5,8,3
51964,51964,51965,8,6,-2
51965,51965,51966,6,4,-2
51966,51966,51967,4,7,3
51967,51967,51968,7,8,1
51968,51968,51969,8,8,0
51969,51969,51970,8,3,-5
51970,51970,51971,3,7,4
51971,51971,51972,7,5,-2
51972,51972,51973,5,5,0
51973,51973,51974,5,7,2
51974,51974,51975,7,1,-6
51975,51975,51976,1,2,1
51976,51976,51977,2,6,4
51977,51977,51978,6,0,-6
51978,51978,51979,0,4,4
51979,51979,51980,4,0,-4
51980,51980,51981,0,9,9
51981,51981,51982,9,9,0
51982,51982,51983,9,2,-7
51983,51983,51984,2,7,5
51984,51984,51985,7,9,2
51985,51985,51986,9,2,-7
51986,51986,51987,2,3,1
51987,51987,51988,3,7,4
51988,51988,51989,7,5,-2
51989,51989,51990,5,5,0
51990,51990,51991,5,3,-2
51991,51991,51992,3,0,-3
51992,51992,51993,0,6,6
51993,51993,51994,6,5,-1
51994,51994,51995,5,6,1
51995,51995,51996,6,7,1
51996,51996,51997,7,0,-7
51997,51997,51998,0,3,3
51998,51998,51999,3,0,-3
51999,51999,52000,0,6,6
52000,52000,52001,6,2,-4
52001,52001,52002,2,1,-1
52002,52002,52003,1,5,4
52003,52003,52004,5,6,1
52004,52004,52005,6,6,0
52005,52005,52006,6,2,-4
52006,52006,52007,2,4,2
52007,52007,52008,4,7,3
52008,52008,52009,7,9,2
52009,52009,52010,9,7,-2
52010,52010,52011,7,2,-5
52011,52011,52012,2,8,6
52012,52012,52013,8,7,-1
52013,52013,52014,7,3,-4
52014,52014,52015,3,4,1
52015,52015,52016,4,2,-2
52016,52016,52017,2,9,7
52017,52017,52018,9,9,0
52018,52018,52019,9,5,-4
52019,52019,52020,5,1,-4
52020,52020,52021,1,0,-1
52021,52021,52022,0,3,3
52022,52022,52023,3,2,-1
52023,52023,52024,2,4,2
52024,52024,52025,4,2,-2
52025,52025,52026,2,5,3
52026,52026,52027,5,3,-2
52027,52027,52028,3,0,-3
52028,52028,52029,0,6,6
52029,52029,52030,6,9,3
52030,52030,52031,9,1,-8
52031,52031,52032,1,1,0
52032,52032,52033,1,8,7
52033,52033,52034,8,9,1
52034,52034,52035,9,3,-6
52035,52035,52036,3,0,-3
52036,52036,52037,0,8,8
52037,52037,52038,8,3,-5
52038,52038,52039,3,0,-3
52039,52039,52040,0,5,5
52040,52040,52041,5,3,-2
52041,52041,52042,3,1,-2
52042,52042,52043,1,5,4
52043,52043,52044,5,8,3
52044,52044,52045,8,0,-8
52045,52045,52046,0,1,1
52046,52046,52047,1,0,-1
52047,52047,52048,0,0,0
52048,52048,52049,0,6,6
52049,52049,52050,6,8,2
52050,52050,52051,8,1,-7
52051,52051,52052,1,7,6
52052,52052,52053,7,6,-1
52053,52053,52054,6,6,0
52054,52054,52055,6,9,3
52055,52055,52056,9,1,-8
52056,52056,52057,1,5,4
52057,52057,52058,5,1,-4
52058,52058,52059,1,3,2
52059,52059,52060,3,9,6
52060,52060,52061,9,9,0
52061,52061,52062,9,6,-3
52062,52062,52063,6,4,-2
52063,52063,52064,4,0,-4
52064,52064,52065,0,5,5
52065,52065,52066,5,6,1
52066,52066,52067,6,8,2
52067,52067,52068,8,2,-6
52068,52068,52069,2,6,4
52069,52069,52070,6,8,2
52070,52070,52071,8,7,-1
52071,52071,52072,7,8,1
52072,52072,52073,8,1,-7
52073,52073,52074,1,4,3
52074,52074,52075,4,1,-3
52075,52075,52076,1,6,5
52076,52076,52077,6,7,1
52077,52077,52078,7,1,-6
52078,52078,52079,1,0,-1
52079,52079,52080,0,8,8
52080,52080,52081,8,1,-7
52081,52081,52082,1,1,0
52082,52082,52083,1,2,1
52083,52083,52084,2,1,-1
52084,52084,52085,1,3,2
52085,52085,52086,3,5,2
52086,52086,52087,5,4,-1
52087,52087,52088,4,1,-3
52088,52088,52089,1,7,6
52089,52089,52090,7,8,1
52090,52090,52091,8,8,0
52091,52091,52092,8,7,-1
52092,52092,52093,7,9,2
52093,52093,52094,9,9,0
52094,52094,52095,9,0,-9
52095,52095,52096,0,3,3
52096,52096,52097,3,1,-2
52097,52097,52098,1,3,2
52098,52098,52099,3,2,-1
52099,52099,52100,2,6,4
52100,52100,52101,6,3,-3
52101,52101,52102,3,6,3
52102,52102,52103,6,4,-2
52103,52103,52104,4,3,-1
52104,52104,52105,3,0,-3
52105,52105,52106,0,5,5
52106,52106,52107,5,1,-4
52107,52107,52108,1,5,4
52108,52108,52109,5,2,-3
52109,52109,52110,2,7,5
52110,52110,52111,7,3,-4
52111,52111,52112,3,4,1
52112,52112,52113,4,7,3
52113,52113,52114,7,0,-7
52114,52114,52115,0,8,8
52115,52115,52116,8,3,-5
52116,52116,52117,3,9,6
52117,52117,52118,9,2,-7
52118,52118,52119,2,1,-1
52119,52119,52120,1,1,0
52120,52120,52121,1,5,4
52121,52121,52122,5,5,0
52122,52122,52123,5,9,4
52123,52123,52124,9,7,-2
52124,52124,52125,7,6,-1
52125,52125,52126,6,0,-6
52126,52126,52127,0,9,9
52127,52127,52128,9,4,-5
52128,52128,52129,4,3,-1
52129,52129,52130,3,0,-3
52130,52130,52131,0,5,5
52131,52131,52132,5,2,-3
52132,52132,52133,2,0,-2
52133,52133,52134,0,3,3
52134,52134,52135,3,0,-3
52135,52135,52136,0,1,1
52136,52136,52137,1,7,6
52137,52137,52138,7,9,2
52138,52138,52139,9,9,0
52139,52139,52140,9,4,-5
52140,52140,52141,4,6,2
52141,52141,52142,6,2,-4
52142,52142,52143,2,1,-1
52143,52143,52144,1,2,1
52144,52144,52145,2,6,4
52145,52145,52146,6,7,1
52146,52146,52147,7,7,0
52147,52147,52148,7,9,2
52148,52148,52149,9,7,-2
52149,52149,52150,7,6,-1
52150,52150,52151,6,9,3
52151,52151,52152,9,2,-7
52152,52152,52153,2,2,0
52153,52153,52154,2,0,-2
52154,52154,52155,0,4,4
52155,52155,52156,4,6,2
52156,52156,52157,6,8,2
52157,52157,52158,8,4,-4
52158,52158,52159,4,8,4
52159,52159,52160,8,3,-5
52160,52160,52161,3,0,-3
52161,52161,52162,0,7,7
52162,52162,52163,7,6,-1
52163,52163,52164,6,3,-3
52164,52164,52165,3,4,1
52165,52165,52166,4,7,3
52166,52166,52167,7,1,-6
52167,52167,52168,1,3,2
52168,52168,52169,3,2,-1
52169,52169,52170,2,5,3
52170,52170,52171,5,8,3
52171,52171,52172,8,5,-3
52172,52172,52173,5,7,2
52173,52173,52174,7,1,-6
52174,52174,52175,1,1,0
52175,52175,52176,1,7,6
52176,52176,52177,7,1,-6
52177,52177,52178,1,7,6
52178,52178,52179,7,0,-7
52179,52179,52180,0,9,9
52180,52180,52181,9,7,-2
52181,52181,52182,7,0,-7
52182,52182,52183,0,6,6
52183,52183,52184,6,9,3
52184,52184,52185,9,0,-9
52185,52185,52186,0,2,2
52186,52186,52187,2,1,-1
52187,52187,52188,1,2,1
52188,52188,52189,2,2,0
52189,52189,52190,2,5,3
52190,52190,52191,5,3,-2
52191,52191,52192,3,5,2
52192,52192,52193,5,4,-1
52193,52193,52194,4,6,2
52194,52194,52195,6,5,-1
52195,52195,52196,5,7,2
52196,52196,52197,7,6,-1
52197,52197,52198,6,6,0
52198,52198,52199,6,7,1
52199,52199,52200,7,4,-3
52200,52200,52201,4,8,4
52201,52201,52202,8,0,-8
52202,52202,52203,0,9,9
52203,52203,52204,9,0,-9
52204,52204,52205,0,1,1
52205,52205,52206,1,6,5
52206,52206,52207,6,2,-4
52207,52207,52208,2,2,0
52208,52208,52209,2,3,1
52209,52209,52210,3,5,2
52210,52210,52211,5,4,-1
52211,52211,52212,4,6,2
52212,52212,52213,6,5,-1
52213,52213,52214,5,9,4
52214,52214,52215,9,6,-3
52215,52215,52216,6,7,1
52216,52216,52217,7,7,0
52217,52217,52218,7,8,1
52218,52218,52219,8,8,0
52219,52219,52220,8,1,-7
52220,52220,52221,1,0,-1
52221,52221,52222,0,4,4
52222,52222,52223,4,1,-3
52223,52223,52224,1,2,1
52224,52224,52225,2,2,0
52225,52225,52226,2,0,-2
52226,52226,52227,0,3,3
52227,52227,52228,3,0,-3
52228,52228,52229,0,4,4
52229,52229,52230,4,9,5
52230,52230,52231,9,5,-4
52231,52231,52232,5,9,4
52232,52232,52233,9,6,-3
52233,52233,52234,6,1,-5
52234,52234,52235,1,7,6
52235,52235,52236,7,9,2
52236,52236,52237,9,8,-1
52237,52237,52238,8,0,-8
52238,52238,52239,0,9,9
52239,52239,52240,9,3,-6
52240,52240,52241,3,8,5
52241,52241,52242,8,2,-6
52242,52242,52243,2,4,2
52243,52243,52244,4,1,-3
52244,52244,52245,1,0,-1
52245,52245,52246,0,4,4
52246,52246,52247,4,0,-4
52247,52247,52248,0,1,1
52248,52248,52249,1,7,6
52249,52249,52250,7,8,1
52250,52250,52251,8,2,-6
52251,52251,52252,2,3,1
52252,52252,52253,3,6,3
52253,52253,52254,6,1,-5
52254,52254,52255,1,5,4
52255,52255,52256,5,7,2
52256,52256,52257,7,5,-2
52257,52257,52258,5,9,4
52258,52258,52259,9,3,-6
52259,52259,52260,3,4,1
52260,52260,52261,4,7,3
52261,52261,52262,7,1,-6
52262,52262,52263,1,6,5
52263,52263,52264,6,5,-1
52264,52264,52265,5,6,1
52265,52265,52266,6,5,-1
52266,52266,52267,5,4,-1
52267,52267,52268,4,1,-3
52268,52268,52269,1,3,2
52269,52269,52270,3,9,6
52270,52270,52271,9,2,-7
52271,52271,52272,2,3,1
52272,52272,52273,3,6,3
52273,52273,52274,6,4,-2
52274,52274,52275,4,6,2
52275,52275,52276,6,0,-6
52276,52276,52277,0,4,4
52277,52277,52278,4,1,-3
52278,52278,52279,1,4,3
52279,52279,52280,4,8,4
52280,52280,52281,8,3,-5
52281,52281,52282,3,6,3
52282,52282,52283,6,8,2
52283,52283,52284,8,5,-3
52284,52284,52285,5,8,3
52285,52285,52286,8,9,1
52286,52286,52287,9,3,-6
52287,52287,52288,3,0,-3
52288,52288,52289,0,0,0
52289,52289,52290,0,8,8
52290,52290,52291,8,1,-7
52291,52291,52292,1,8,7
52292,52292,52293,8,4,-4
52293,52293,52294,4,0,-4
52294,52294,52295,0,5,5
52295,52295,52296,5,8,3
52296,52296,52297,8,6,-2
52297,52297,52298,6,3,-3
52298,52298,52299,3,4,1
52299,52299,52300,4,3,-1
52300,52300,52301,3,7,4
52301,52301,52302,7,7,0
52302,52302,52303,7,8,1
52303,52303,52304,8,9,1
52304,52304,52305,9,0,-9
52305,52305,52306,0,8,8
52306,52306,52307,8,3,-5
52307,52307,52308,3,4,1
52308,52308,52309,4,1,-3
52309,52309,52310,1,5,4
52310,52310,52311,5,9,4
52311,52311,52312,9,0,-9
52312,52312,52313,0,0,0
52313,52313,52314,0,5,5
52314,52314,52315,5,9,4
52315,52315,52316,9,2,-7
52316,52316,52317,2,1,-1
52317,52317,52318,1,0,-1
52318,52318,52319,0,2,2
52319,52319,52320,2,0,-2
52320,52320,52321,0,7,7
52321,52321,52322,7,7,0
52322,52322,52323,7,0,-7
52323,52323,52324,0,9,9
52324,52324,52325,9,1,-8
52325,52325,52326,1,5,4
52326,52326,52327,5,3,-2
52327,52327,52328,3,9,6
52328,52328,52329,9,8,-1
52329,52329,52330,8,7,-1
52330,52330,52331,7,2,-5
52331,52331,52332,2,5,3
52332,52332,52333,5,9,4
52333,52333,52334,9,1,-8
52334,52334,52335,1,2,1
52335,52335,52336,2,0,-2
52336,52336,52337,0,7,7
52337,52337,52338,7,6,-1
52338,52338,52339,6,7,1
52339,52339,52340,7,9,2
52340,52340,52341,9,9,0
52341,52341,52342,9,1,-8
52342,52342,52343,1,4,3
52343,52343,52344,4,4,0
52344,52344,52345,4,2,-2
52345,52345,52346,2,4,2
52346,52346,52347,4,5,1
52347,52347,52348,5,4,-1
52348,52348,52349,4,8,4
52349,52349,52350,8,3,-5
52350,52350,52351,3,6,3
52351,52351,52352,6,8,2
52352,52352,52353,8,5,-3
52353,52353,52354,5,0,-5
52354,52354,52355,0,9,9
52355,52355,52356,9,9,0
52356,52356,52357,9,9,0
52357,52357,52358,9,2,-7
52358,52358,52359,2,1,-1
52359,52359,52360,1,1,0
52360,52360,52361,1,1,0
52361,52361,52362,1,1,0
52362,52362,52363,1,7,6
52363,52363,52364,7,5,-2
52364,52364,52365,5,6,1
52365,52365,52366,6,2,-4
52366,52366,52367,2,9,7
52367,52367,52368,9,1,-8
52368,52368,52369,1,1,0
52369,52369,52370,1,2,1
52370,52370,52371,2,3,1
52371,52371,52372,3,9,6
52372,52372,52373,9,2,-7
52373,52373,52374,2,6,4
52374,52374,52375,6,3,-3
52375,52375,52376,3,1,-2
52376,52376,52377,1,4,3
52377,52377,52378,4,3,-1
52378,52378,52379,3,3,0
52379,52379,52380,3,6,3
52380,52380,52381,6,1,-5
52381,52381,52382,1,1,0
52382,52382,52383,1,9,8
52383,52383,52384,9,4,-5
52384,52384,52385,4,3,-1
52385,52385,52386,3,3,0
52386,52386,52387,3,6,3
52387,52387,52388,6,5,-1
52388,52388,52389,5,8,3
52389,52389,52390,8,8,0
52390,52390,52391,8,7,-1
52391,52391,52392,7,1,-6
52392,52392,52393,1,0,-1
52393,52393,52394,0,3,3
52394,52394,52395,3,1,-2
52395,52395,52396,1,0,-1
52396,52396,52397,0,0,0
52397,52397,52398,0,8,8
52398,52398,52399,8,5,-3
52399,52399,52400,5,2,-3
52400,52400,52401,2,8,6
52401,52401,52402,8,4,-4
52402,52402,52403,4,2,-2
52403,52403,52404,2,3,1
52404,52404,52405,3,7,4
52405,52405,52406,7,9,2
52406,52406,52407,9,7,-2
52407,52407,52408,7,2,-5
52408,52408,52409,2,0,-2
52409,52409,52410,0,2,2
52410,52410,52411,2,1,-1
52411,52411,52412,1,6,5
52412,52412,52413,6,2,-4
52413,52413,52414,2,4,2
52414,52414,52415,4,3,-1
52415,52415,52416,3,1,-2
52416,52416,52417,1,4,3
52417,52417,52418,4,1,-3
52418,52418,52419,1,5,4
52419,52419,52420,5,6,1
52420,52420,52421,6,6,0
52421,52421,52422,6,2,-4
52422,52422,52423,2,7,5
52423,52423,52424,7,4,-3
52424,52424,52425,4,8,4
52425,52425,52426,8,6,-2
52426,52426,52427,6,9,3
52427,52427,52428,9,0,-9
52428,52428,52429,0,0,0
52429,52429,52430,0,8,8
52430,52430,52431,8,1,-7
52431,52431,52432,1,3,2
52432,52432,52433,3,2,-1
52433,52433,52434,2,6,4
52434,52434,52435,6,3,-3
52435,52435,52436,3,7,4
52436,52436,52437,7,4,-3
52437,52437,52438,4,0,-4
52438,52438,52439,0,5,5
52439,52439,52440,5,2,-3
52440,52440,52441,2,6,4
52441,52441,52442,6,4,-2
52442,52442,52443,4,7,3
52443,52443,52444,7,1,-6
52444,52444,52445,1,8,7
52445,52445,52446,8,3,-5
52446,52446,52447,3,9,6
52447,52447,52448,9,4,-5
52448,52448,52449,4,0,-4
52449,52449,52450,0,1,1
52450,52450,52451,1,1,0
52451,52451,52452,1,5,4
52452,52452,52453,5,2,-3
52453,52453,52454,2,1,-1
52454,52454,52455,1,3,2
52455,52455,52456,3,2,-1
52456,52456,52457,2,4,2
52457,52457,52458,4,5,1
52458,52458,52459,5,5,0
52459,52459,52460,5,7,2
52460,52460,52461,7,6,-1
52461,52461,52462,6,9,3
52462,52462,52463,9,7,-2
52463,52463,52464,7,3,-4
52464,52464,52465,3,8,5
52465,52465,52466,8,7,-1
52466,52466,52467,7,9,2
52467,52467,52468,9,8,-1
52468,52468,52469,8,8,0
52469,52469,52470,8,0,-8
52470,52470,52471,0,7,7
52471,52471,52472,7,6,-1
52472,52472,52473,6,4,-2
52473,52473,52474,4,5,1
52474,52474,52475,5,7,2
52475,52475,52476,7,3,-4
52476,52476,52477,3,7,4
52477,52477,52478,7,9,2
52478,52478,52479,9,3,-6
52479,52479,52480,3,7,4
52480,52480,52481,7,9,2
52481,52481,52482,9,6,-3
52482,52482,52483,6,8,2
52483,52483,52484,8,7,-1
52484,52484,52485,7,8,1
52485,52485,52486,8,7,-1
52486,52486,52487,7,3,-4
52487,52487,52488,3,2,-1
52488,52488,52489,2,1,-1
52489,52489,52490,1,7,6
52490,52490,52491,7,5,-2
52491,52491,52492,5,1,-4
52492,52492,52493,1,8,7
52493,52493,52494,8,6,-2
52494,52494,52495,6,2,-4
52495,52495,52496,2,8,6
52496,52496,52497,8,7,-1
52497,52497,52498,7,1,-6
52498,52498,52499,1,4,3
52499,52499,52500,4,9,5
52500,52500,52501,9,2,-7
52501,52501,52502,2,6,4
52502,52502,52503,6,6,0
52503,52503,52504,6,6,0
52504,52504,52505,6,1,-5
52505,52505,52506,1,9,8
52506,52506,52507,9,5,-4
52507,52507,52508,5,0,-5
52508,52508,52509,0,5,5
52509,52509,52510,5,9,4
52510,52510,52511,9,8,-1
52511,52511,52512,8,2,-6
52512,52512,52513,2,6,4
52513,52513,52514,6,6,0
52514,52514,52515,6,4,-2
52515,52515,52516,4,6,2
52516,52516,52517,6,4,-2
52517,52517,52518,4,6,2
52518,52518,52519,6,4,-2
52519,52519,52520,4,0,-4
52520,52520,52521,0,1,1
52521,52521,52522,1,4,3
52522,52522,52523,4,8,4
52523,52523,52524,8,7,-1
52524,52524,52525,7,7,0
52525,52525,52526,7,0,-7
52526,52526,52527,0,5,5
52527,52527,52528,5,7,2
52528,52528,52529,7,5,-2
52529,52529,52530,5,1,-4
52530,52530,52531,1,1,0
52531,52531,52532,1,4,3
52532,52532,52533,4,8,4
52533,52533,52534,8,6,-2
52534,52534,52535,6,9,3
52535,52535,52536,9,8,-1
52536,52536,52537,8,1,-7
52537,52537,52538,1,9,8
52538,52538,52539,9,3,-6
52539,52539,52540,3,5,2
52540,52540,52541,5,6,1
52541,52541,52542,6,6,0
52542,52542,52543,6,3,-3
52543,52543,52544,3,6,3
52544,52544,52545,6,3,-3
52545,52545,52546,3,9,6
52546,52546,52547,9,2,-7
52547,52547,52548,2,2,0
52548,52548,52549,2,2,0
52549,52549,52550,2,2,0
52550,52550,52551,2,6,4
52551,52551,52552,6,1,-5
52552,52552,52553,1,9,8
52553,52553,52554,9,0,-9
52554,52554,52555,0,9,9
52555,52555,52556,9,9,0
52556,52556,52557,9,6,-3
52557,52557,52558,6,0,-6
52558,52558,52559,0,5,5
52559,52559,52560,5,6,1
52560,52560,52561,6,5,-1
52561,52561,52562,5,1,-4
52562,52562,52563,1,3,2
52563,52563,52564,3,4,1
52564,52564,52565,4,3,-1
52565,52565,52566,3,4,1
52566,52566,52567,4,8,4
52567,52567,52568,8,7,-1
52568,52568,52569,7,1,-6
52569,52569,52570,1,9,8
52570,52570,52571,9,6,-3
52571,52571,52572,6,4,-2
52572,52572,52573,4,8,4
52573,52573,52574,8,2,-6
52574,52574,52575,2,1,-1
52575,52575,52576,1,9,8
52576,52576,52577,9,9,0
52577,52577,52578,9,6,-3
52578,52578,52579,6,7,1
52579,52579,52580,7,4,-3
52580,52580,52581,4,6,2
52581,52581,52582,6,2,-4
52582,52582,52583,2,8,6
52583,52583,52584,8,6,-2
52584,52584,52585,6,3,-3
52585,52585,52586,3,1,-2
52586,52586,52587,1,7,6
52587,52587,52588,7,7,0
52588,52588,52589,7,4,-3
52589,52589,52590,4,3,-1
52590,52590,52591,3,7,4
52591,52591,52592,7,8,1
52592,52592,52593,8,0,-8
52593,52593,52594,0,7,7
52594,52594,52595,7,9,2
52595,52595,52596,9,0,-9
52596,52596,52597,0,0,0
52597,52597,52598,0,6,6
52598,52598,52599,6,0,-6
52599,52599,52600,0,4,4
52600,52600,52601,4,3,-1
52601,52601,52602,3,2,-1
52602,52602,52603,2,7,5
52603,52603,52604,7,4,-3
52604,52604,52605,4,9,5
52605,52605,52606,9,7,-2
52606,52606,52607,7,3,-4
52607,52607,52608,3,5,2
52608,52608,52609,5,0,-5
52609,52609,52610,0,5,5
52610,52610,52611,5,2,-3
52611,52611,52612,2,8,6
52612,52612,52613,8,0,-8
52613,52613,52614,0,1,1
52614,52614,52615,1,1,0
52615,52615,52616,1,1,0
52616,52616,52617,1,0,-1
52617,52617,52618,0,9,9
52618,52618,52619,9,1,-8
52619,52619,52620,1,6,5
52620,52620,52621,6,0,-6
52621,52621,52622,0,1,1
52622,52622,52623,1,4,3
52623,52623,52624,4,1,-3
52624,52624,52625,1,0,-1
52625,52625,52626,0,6,6
52626,52626,52627,6,1,-5
52627,52627,52628,1,0,-1
52628,52628,52629,0,0,0
52629,52629,52630,0,2,2
52630,52630,52631,2,4,2
52631,52631,52632,4,8,4
52632,52632,52633,8,7,-1
52633,52633,52634,7,2,-5
52634,52634,52635,2,9,7
52635,52635,52636,9,3,-6
52636,52636,52637,3,2,-1
52637,52637,52638,2,9,7
52638,52638,52639,9,0,-9
52639,52639,52640,0,6,6
52640,52640,52641,6,6,0
52641,52641,52642,6,4,-2
52642,52642,52643,4,2,-2
52643,52643,52644,2,7,5
52644,52644,52645,7,6,-1
52645,52645,52646,6,9,3
52646,52646,52647,9,2,-7
52647,52647,52648,2,1,-1
52648,52648,52649,1,2,1
52649,52649,52650,2,5,3
52650,52650,52651,5,9,4
52651,52651,52652,9,4,-5
52652,52652,52653,4,9,5
52653,52653,52654,9,1,-8
52654,52654,52655,1,0,-1
52655,52655,52656,0,2,2
52656,52656,52657,2,1,-1
52657,52657,52658,1,4,3
52658,52658,52659,4,2,-2
52659,52659,52660,2,2,0
52660,52660,52661,2,3,1
52661,52661,52662,3,8,5
52662,52662,52663,8,4,-4
52663,52663,52664,4,3,-1
52664,52664,52665,3,5,2
52665,52665,52666,5,7,2
52666,52666,52667,7,6,-1
52667,52667,52668,6,1,-5
52668,52668,52669,1,7,6
52669,52669,52670,7,7,0
52670,52670,52671,7,8,1
52671,52671,52672,8,9,1
52672,52672,52673,9,0,-9
52673,52673,52674,0,6,6
52674,52674,52675,6,1,-5
52675,52675,52676,1,3,2
52676,52676,52677,3,2,-1
52677,52677,52678,2,6,4
52678,52678,52679,6,3,-3
52679,52679,52680,3,7,4
52680,52680,52681,7,4,-3
52681,52681,52682,4,4,0
52682,52682,52683,4,5,1
52683,52683,52684,5,2,-3
52684,52684,52685,2,6,4
52685,52685,52686,6,5,-1
52686,52686,52687,5,7,2
52687,52687,52688,7,6,-1
52688,52688,52689,6,8,2
52689,52689,52690,8,3,-5
52690,52690,52691,3,0,-3
52691,52691,52692,0,3,3
52692,52692,52693,3,1,-2
52693,52693,52694,1,2,1
52694,52694,52695,2,2,0
52695,52695,52696,2,0,-2
52696,52696,52697,0,3,3
52697,52697,52698,3,0,-3
52698,52698,52699,0,8,8
52699,52699,52700,8,3,-5
52700,52700,52701,3,7,4
52701,52701,52702,7,3,-4
52702,52702,52703,3,4,1
52703,52703,52704,4,4,0
52704,52704,52705,4,7,3
52705,52705,52706,7,5,-2
52706,52706,52707,5,7,2
52707,52707,52708,7,4,-3
52708,52708,52709,4,9,5
52709,52709,52710,9,1,-8
52710,52710,52711,1,8,7
52711,52711,52712,8,9,1
52712,52712,52713,9,3,-6
52713,52713,52714,3,9,6
52714,52714,52715,9,1,-8
52715,52715,52716,1,0,-1
52716,52716,52717,0,5,5
52717,52717,52718,5,9,4
52718,52718,52719,9,8,-1
52719,52719,52720,8,0,-8
52720,52720,52721,0,4,4
52721,52721,52722,4,8,4
52722,52722,52723,8,2,-6
52723,52723,52724,2,6,4
52724,52724,52725,6,6,0
52725,52725,52726,6,2,-4
52726,52726,52727,2,4,2
52727,52727,52728,4,0,-4
52728,52728,52729,0,4,4
52729,52729,52730,4,7,3
52730,52730,52731,7,1,-6
52731,52731,52732,1,7,6
52732,52732,52733,7,8,1
52733,52733,52734,8,4,-4
52734,52734,52735,4,7,3
52735,52735,52736,7,7,0
52736,52736,52737,7,5,-2
52737,52737,52738,5,1,-4
52738,52738,52739,1,5,4
52739,52739,52740,5,3,-2
52740,52740,52741,3,1,-2
52741,52741,52742,1,6,5
52742,52742,52743,6,9,3
52743,52743,52744,9,7,-2
52744,52744,52745,7,1,-6
52745,52745,52746,1,8,7
52746,52746,52747,8,3,-5
52747,52747,52748,3,4,1
52748,52748,52749,4,6,2
52749,52749,52750,6,7,1
52750,52750,52751,7,3,-4
52751,52751,52752,3,7,4
52752,52752,52753,7,3,-4
52753,52753,52754,3,6,3
52754,52754,52755,6,2,-4
52755,52755,52756,2,4,2
52756,52756,52757,4,2,-2
52757,52757,52758,2,1,-1
52758,52758,52759,1,6,5
52759,52759,52760,6,7,1
52760,52760,52761,7,9,2
52761,52761,52762,9,2,-7
52762,52762,52763,2,9,7
52763,52763,52764,9,8,-1
52764,52764,52765,8,6,-2
52765,52765,52766,6,0,-6
52766,52766,52767,0,5,5
52767,52767,52768,5,6,1
52768,52768,52769,6,5,-1
52769,52769,52770,5,9,4
52770,52770,52771,9,3,-6
52771,52771,52772,3,9,6
52772,52772,52773,9,3,-6
52773,52773,52774,3,2,-1
52774,52774,52775,2,8,6
52775,52775,52776,8,5,-3
52776,52776,52777,5,1,-4
52777,52777,52778,1,5,4
52778,52778,52779,5,7,2
52779,52779,52780,7,1,-6
52780,52780,52781,1,6,5
52781,52781,52782,6,2,-4
52782,52782,52783,2,8,6
52783,52783,52784,8,2,-6
52784,52784,52785,2,3,1
52785,52785,52786,3,7,4
52786,52786,52787,7,7,0
52787,52787,52788,7,6,-1
52788,52788,52789,6,4,-2
52789,52789,52790,4,3,-1
52790,52790,52791,3,7,4
52791,52791,52792,7,5,-2
52792,52792,52793,5,0,-5
52793,52793,52794,0,3,3
52794,52794,52795,3,9,6
52795,52795,52796,9,2,-7
52796,52796,52797,2,0,-2
52797,52797,52798,0,5,5
52798,52798,52799,5,0,-5
52799,52799,52800,0,9,9
52800,52800,52801,9,2,-7
52801,52801,52802,2,2,0
52802,52802,52803,2,7,5
52803,52803,52804,7,0,-7
52804,52804,52805,0,9,9
52805,52805,52806,9,6,-3
52806,52806,52807,6,1,-5
52807,52807,52808,1,8,7
52808,52808,52809,8,0,-8
52809,52809,52810,0,3,3
52810,52810,52811,3,1,-2
52811,52811,52812,1,2,1
52812,52812,52813,2,0,-2
52813,52813,52814,0,9,9
52814,52814,52815,9,4,-5
52815,52815,52816,4,3,-1
52816,52816,52817,3,0,-3
52817,52817,52818,0,3,3
52818,52818,52819,3,1,-2
52819,52819,52820,1,6,5
52820,52820,52821,6,0,-6
52821,52821,52822,0,1,1
52822,52822,52823,1,4,3
52823,52823,52824,4,7,3
52824,52824,52825,7,7,0
52825,52825,52826,7,5,-2
52826,52826,52827,5,9,4
52827,52827,52828,9,3,-6
52828,52828,52829,3,2,-1
52829,52829,52830,2,8,6
52830,52830,52831,8,0,-8
52831,52831,52832,0,0,0
52832,52832,52833,0,6,6
52833,52833,52834,6,2,-4
52834,52834,52835,2,2,0
52835,52835,52836,2,0,-2
52836,52836,52837,0,6,6
52837,52837,52838,6,4,-2
52838,52838,52839,4,2,-2
52839,52839,52840,2,2,0
52840,52840,52841,2,2,0
52841,52841,52842,2,7,5
52842,52842,52843,7,9,2
52843,52843,52844,9,6,-3
52844,52844,52845,6,9,3
52845,52845,52846,9,9,0
52846,52846,52847,9,0,-9
52847,52847,52848,0,8,8
52848,52848,52849,8,1,-7
52849,52849,52850,1,1,0
52850,52850,52851,1,2,1
52851,52851,52852,2,4,2
52852,52852,52853,4,3,-1
52853,52853,52854,3,1,-2
52854,52854,52855,1,4,3
52855,52855,52856,4,6,2
52856,52856,52857,6,5,-1
52857,52857,52858,5,6,1
52858,52858,52859,6,6,0
52859,52859,52860,6,8,2
52860,52860,52861,8,7,-1
52861,52861,52862,7,8,1
52862,52862,52863,8,8,0
52863,52863,52864,8,3,-5
52864,52864,52865,3,0,-3
52865,52865,52866,0,7,7
52866,52866,52867,7,1,-6
52867,52867,52868,1,1,0
52868,52868,52869,1,2,1
52869,52869,52870,2,5,3
52870,52870,52871,5,3,-2
52871,52871,52872,3,1,-2
52872,52872,52873,1,4,3
52873,52873,52874,4,2,-2
52874,52874,52875,2,5,3
52875,52875,52876,5,4,-1
52876,52876,52877,4,6,2
52877,52877,52878,6,1,-5
52878,52878,52879,1,7,6
52879,52879,52880,7,6,-1
52880,52880,52881,6,8,2
52881,52881,52882,8,1,-7
52882,52882,52883,1,9,8
52883,52883,52884,9,8,-1
52884,52884,52885,8,0,-8
52885,52885,52886,0,7,7
52886,52886,52887,7,1,-6
52887,52887,52888,1,1,0
52888,52888,52889,1,2,1
52889,52889,52890,2,8,6
52890,52890,52891,8,3,-5
52891,52891,52892,3,8,5
52892,52892,52893,8,4,-4
52893,52893,52894,4,2,-2
52894,52894,52895,2,5,3
52895,52895,52896,5,5,0
52896,52896,52897,5,6,1
52897,52897,52898,6,2,-4
52898,52898,52899,2,7,5
52899,52899,52900,7,8,1
52900,52900,52901,8,8,0
52901,52901,52902,8,5,-3
52902,52902,52903,5,9,4
52903,52903,52904,9,3,-6
52904,52904,52905,3,8,5
52905,52905,52906,8,1,-7
52906,52906,52907,1,3,2
52907,52907,52908,3,6,3
52908,52908,52909,6,4,-2
52909,52909,52910,4,9,5
52910,52910,52911,9,7,-2
52911,52911,52912,7,6,-1
52912,52912,52913,6,8,2
52913,52913,52914,8,5,-3
52914,52914,52915,5,6,1
52915,52915,52916,6,1,-5
52916,52916,52917,1,3,2
52917,52917,52918,3,6,3
52918,52918,52919,6,4,-2
52919,52919,52920,4,4,0
52920,52920,52921,4,0,-4
52921,52921,52922,0,3,3
52922,52922,52923,3,9,6
52923,52923,52924,9,3,-6
52924,52924,52925,3,7,4
52925,52925,52926,7,7,0
52926,52926,52927,7,1,-6
52927,52927,52928,1,0,-1
52928,52928,52929,0,9,9
52929,52929,52930,9,0,-9
52930,52930,52931,0,3,3
52931,52931,52932,3,8,5
52932,52932,52933,8,8,0
52933,52933,52934,8,0,-8
52934,52934,52935,0,4,4
52935,52935,52936,4,3,-1
52936,52936,52937,3,7,4
52937,52937,52938,7,2,-5
52938,52938,52939,2,3,1
52939,52939,52940,3,3,0
52940,52940,52941,3,0,-3
52941,52941,52942,0,2,2
52942,52942,52943,2,9,7
52943,52943,52944,9,8,-1
52944,52944,52945,8,4,-4
52945,52945,52946,4,6,2
52946,52946,52947,6,5,-1
52947,52947,52948,5,9,4
52948,52948,52949,9,4,-5
52949,52949,52950,4,8,4
52950,52950,52951,8,6,-2
52951,52951,52952,6,7,1
52952,52952,52953,7,2,-5
52953,52953,52954,2,8,6
52954,52954,52955,8,0,-8
52955,52955,52956,0,2,2
52956,52956,52957,2,6,4
52957,52957,52958,6,4,-2
52958,52958,52959,4,2,-2
52959,52959,52960,2,7,5
52960,52960,52961,7,1,-6
52961,52961,52962,1,5,4
52962,52962,52963,5,1,-4
52963,52963,52964,1,7,6
52964,52964,52965,7,1,-6
52965,52965,52966,1,3,2
52966,52966,52967,3,1,-2
52967,52967,52968,1,8,7
52968,52968,52969,8,7,-1
52969,52969,52970,7,5,-2
52970,52970,52971,5,2,-3
52971,52971,52972,2,3,1
52972,52972,52973,3,4,1
52973,52973,52974,4,3,-1
52974,52974,52975,3,2,-1
52975,52975,52976,2,6,4
52976,52976,52977,6,9,3
52977,52977,52978,9,0,-9
52978,52978,52979,0,4,4
52979,52979,52980,4,8,4
52980,52980,52981,8,5,-3
52981,52981,52982,5,2,-3
52982,52982,52983,2,8,6
52983,52983,52984,8,1,-7
52984,52984,52985,1,4,3
52985,52985,52986,4,6,2
52986,52986,52987,6,2,-4
52987,52987,52988,2,4,2
52988,52988,52989,4,9,5
52989,52989,52990,9,1,-8
52990,52990,52991,1,7,6
52991,52991,52992,7,7,0
52992,52992,52993,7,0,-7
52993,52993,52994,0,3,3
52994,52994,52995,3,0,-3
52995,52995,52996,0,4,4
52996,52996,52997,4,7,3
52997,52997,52998,7,7,0
52998,52998,52999,7,5,-2
52999,52999,53000,5,5,0
53000,53000,53001,5,1,-4
53001,53001,53002,1,8,7
53002,53002,53003,8,7,-1
53003,53003,53004,7,1,-6
53004,53004,53005,1,6,5
53005,53005,53006,6,8,2
53006,53006,53007,8,6,-2
53007,53007,53008,6,2,-4
53008,53008,53009,2,6,4
53009,53009,53010,6,9,3
53010,53010,53011,9,8,-1
53011,53011,53012,8,1,-7
53012,53012,53013,1,2,1
53013,53013,53014,2,0,-2
53014,53014,53015,0,5,5
53015,53015,53016,5,1,-4
53016,53016,53017,1,2,1
53017,53017,53018,2,1,-1
53018,53018,53019,1,2,1
53019,53019,53020,2,9,7
53020,53020,53021,9,7,-2
53021,53021,53022,7,9,2
53022,53022,53023,9,7,-2
53023,53023,53024,7,5,-2
53024,53024,53025,5,4,-1
53025,53025,53026,4,2,-2
53026,53026,53027,2,0,-2
53027,53027,53028,0,8,8
53028,53028,53029,8,2,-6
53029,53029,53030,2,0,-2
53030,53030,53031,0,4,4
53031,53031,53032,4,4,0
53032,53032,53033,4,2,-2
53033,53033,53034,2,2,0
53034,53034,53035,2,3,1
53035,53035,53036,3,8,5
53036,53036,53037,8,3,-5
53037,53037,53038,3,0,-3
53038,53038,53039,0,3,3
53039,53039,53040,3,1,-2
53040,53040,53041,1,1,0
53041,53041,53042,1,3,2
53042,53042,53043,3,8,5
53043,53043,53044,8,9,1
53044,53044,53045,9,9,0
53045,53045,53046,9,5,-4
53046,53046,53047,5,6,1
53047,53047,53048,6,3,-3
53048,53048,53049,3,1,-2
53049,53049,53050,1,5,4
53050,53050,53051,5,0,-5
53051,53051,53052,0,4,4
53052,53052,53053,4,5,1
53053,53053,53054,5,5,0
53054,53054,53055,5,9,4
53055,53055,53056,9,2,-7
53056,53056,53057,2,6,4
53057,53057,53058,6,1,-5
53058,53058,53059,1,9,8
53059,53059,53060,9,7,-2
53060,53060,53061,7,8,1
53061,53061,53062,8,4,-4
53062,53062,53063,4,5,1
53063,53063,53064,5,8,3
53064,53064,53065,8,8,0
53065,53065,53066,8,7,-1
53066,53066,53067,7,5,-2
53067,53067,53068,5,6,1
53068,53068,53069,6,5,-1
53069,53069,53070,5,9,4
53070,53070,53071,9,8,-1
53071,53071,53072,8,2,-6
53072,53072,53073,2,0,-2
53073,53073,53074,0,7,7
53074,53074,53075,7,3,-4
53075,53075,53076,3,2,-1
53076,53076,53077,2,0,-2
53077,53077,53078,0,4,4
53078,53078,53079,4,8,4
53079,53079,53080,8,1,-7
53080,53080,53081,1,6,5
53081,53081,53082,6,8,2
53082,53082,53083,8,3,-5
53083,53083,53084,3,3,0
53084,53084,53085,3,0,-3
53085,53085,53086,0,5,5
53086,53086,53087,5,1,-4
53087,53087,53088,1,2,1
53088,53088,53089,2,2,0
53089,53089,53090,2,8,6
53090,53090,53091,8,3,-5
53091,53091,53092,3,8,5
53092,53092,53093,8,4,-4
53093,53093,53094,4,7,3
53094,53094,53095,7,6,-1
53095,53095,53096,6,5,-1
53096,53096,53097,5,7,2
53097,53097,53098,7,1,-6
53098,53098,53099,1,8,7
53099,53099,53100,8,5,-3
53100,53100,53101,5,0,-5
53101,53101,53102,0,7,7
53102,53102,53103,7,1,-6
53103,53103,53104,1,3,2
53104,53104,53105,3,2,-1
53105,53105,53106,2,6,4
53106,53106,53107,6,3,-3
53107,53107,53108,3,3,0
53108,53108,53109,3,4,1
53109,53109,53110,4,8,4
53110,53110,53111,8,6,-2
53111,53111,53112,6,8,2
53112,53112,53113,8,7,-1
53113,53113,53114,7,5,-2
53114,53114,53115,5,8,3
53115,53115,53116,8,0,-8
53116,53116,53117,0,0,0
53117,53117,53118,0,0,0
53118,53118,53119,0,1,1
53119,53119,53120,1,5,4
53120,53120,53121,5,2,-3
53121,53121,53122,2,5,3
53122,53122,53123,5,3,-2
53123,53123,53124,3,0,-3
53124,53124,53125,0,4,4
53125,53125,53126,4,9,5
53126,53126,53127,9,6,-3
53127,53127,53128,6,8,2
53128,53128,53129,8,7,-1
53129,53129,53130,7,4,-3
53130,53130,53131,4,8,4
53131,53131,53132,8,2,-6
53132,53132,53133,2,8,6
53133,53133,53134,8,4,-4
53134,53134,53135,4,1,-3
53135,53135,53136,1,3,2
53136,53136,53137,3,7,4
53137,53137,53138,7,2,-5
53138,53138,53139,2,2,0
53139,53139,53140,2,1,-1
53140,53140,53141,1,4,3
53141,53141,53142,4,9,5
53142,53142,53143,9,1,-8
53143,53143,53144,1,4,3
53144,53144,53145,4,4,0
53145,53145,53146,4,9,5
53146,53146,53147,9,1,-8
53147,53147,53148,1,6,5
53148,53148,53149,6,4,-2
53149,53149,53150,4,8,4
53150,53150,53151,8,9,1
53151,53151,53152,9,5,-4
53152,53152,53153,5,6,1
53153,53153,53154,6,9,3
53154,53154,53155,9,8,-1
53155,53155,53156,8,3,-5
53156,53156,53157,3,4,1
53157,53157,53158,4,3,-1
53158,53158,53159,3,7,4
53159,53159,53160,7,1,-6
53160,53160,53161,1,8,7
53161,53161,53162,8,1,-7
53162,53162,53163,1,4,3
53163,53163,53164,4,7,3
53164,53164,53165,7,3,-4
53165,53165,53166,3,9,6
53166,53166,53167,9,3,-6
53167,53167,53168,3,1,-2
53168,53168,53169,1,6,5
53169,53169,53170,6,8,2
53170,53170,53171,8,7,-1
53171,53171,53172,7,5,-2
53172,53172,53173,5,0,-5
53173,53173,53174,0,0,0
53174,53174,53175,0,6,6
53175,53175,53176,6,1,-5
53176,53176,53177,1,1,0
53177,53177,53178,1,1,0
53178,53178,53179,1,6,5
53179,53179,53180,6,1,-5
53180,53180,53181,1,8,7
53181,53181,53182,8,3,-5
53182,53182,53183,3,7,4
53183,53183,53184,7,8,1
53184,53184,53185,8,0,-8
53185,53185,53186,0,8,8
53186,53186,53187,8,1,-7
53187,53187,53188,1,7,6
53188,53188,53189,7,0,-7
53189,53189,53190,0,9,9
53190,53190,53191,9,8,-1
53191,53191,53192,8,4,-4
53192,53192,53193,4,5,1
53193,53193,53194,5,1,-4
53194,53194,53195,1,0,-1
53195,53195,53196,0,9,9
53196,53196,53197,9,6,-3
53197,53197,53198,6,6,0
53198,53198,53199,6,1,-5
53199,53199,53200,1,5,4
53200,53200,53201,5,5,0
53201,53201,53202,5,9,4
53202,53202,53203,9,8,-1
53203,53203,53204,8,9,1
53204,53204,53205,9,4,-5
53205,53205,53206,4,1,-3
53206,53206,53207,1,2,1
53207,53207,53208,2,8,6
53208,53208,53209,8,3,-5
53209,53209,53210,3,7,4
53210,53210,53211,7,9,2
53211,53211,53212,9,0,-9
53212,53212,53213,0,7,7
53213,53213,53214,7,7,0
53214,53214,53215,7,6,-1
53215,53215,53216,6,9,3
53216,53216,53217,9,9,0
53217,53217,53218,9,2,-7
53218,53218,53219,2,0,-2
53219,53219,53220,0,6,6
53220,53220,53221,6,6,0
53221,53221,53222,6,4,-2
53222,53222,53223,4,3,-1
53223,53223,53224,3,2,-1
53224,53224,53225,2,3,1
53225,53225,53226,3,4,1
53226,53226,53227,4,7,3
53227,53227,53228,7,6,-1
53228,53228,53229,6,5,-1
53229,53229,53230,5,6,1
53230,53230,53231,6,3,-3
53231,53231,53232,3,7,4
53232,53232,53233,7,1,-6
53233,53233,53234,1,7,6
53234,53234,53235,7,8,1
53235,53235,53236,8,8,0
53236,53236,53237,8,2,-6
53237,53237,53238,2,9,7
53238,53238,53239,9,2,-7
53239,53239,53240,2,8,6
53240,53240,53241,8,3,-5
53241,53241,53242,3,7,4
53242,53242,53243,7,0,-7
53243,53243,53244,0,5,5
53244,53244,53245,5,2,-3
53245,53245,53246,2,3,1
53246,53246,53247,3,9,6
53247,53247,53248,9,8,-1
53248,53248,53249,8,4,-4
53249,53249,53250,4,9,5
53250,53250,53251,9,9,0
53251,53251,53252,9,3,-6
53252,53252,53253,3,7,4
53253,53253,53254,7,4,-3
53254,53254,53255,4,0,-4
53255,53255,53256,0,0,0
53256,53256,53257,0,0,0
53257,53257,53258,0,7,7
53258,53258,53259,7,2,-5
53259,53259,53260,2,4,2
53260,53260,53261,4,7,3
53261,53261,53262,7,3,-4
53262,53262,53263,3,4,1
53263,53263,53264,4,2,-2
53264,53264,53265,2,9,7
53265,53265,53266,9,2,-7
53266,53266,53267,2,9,7
53267,53267,53268,9,5,-4
53268,53268,53269,5,2,-3
53269,53269,53270,2,0,-2
53270,53270,53271,0,8,8
53271,53271,53272,8,5,-3
53272,53272,53273,5,1,-4
53273,53273,53274,1,7,6
53274,53274,53275,7,5,-2
53275,53275,53276,5,9,4
53276,53276,53277,9,6,-3
53277,53277,53278,6,4,-2
53278,53278,53279,4,9,5
53279,53279,53280,9,9,0
53280,53280,53281,9,8,-1
53281,53281,53282,8,3,-5
53282,53282,53283,3,3,0
53283,53283,53284,3,2,-1
53284,53284,53285,2,8,6
53285,53285,53286,8,8,0
53286,53286,53287,8,3,-5
53287,53287,53288,3,4,1
53288,53288,53289,4,6,2
53289,53289,53290,6,0,-6
53290,53290,53291,0,7,7
53291,53291,53292,7,5,-2
53292,53292,53293,5,0,-5
53293,53293,53294,0,8,8
53294,53294,53295,8,4,-4
53295,53295,53296,4,5,1
53296,53296,53297,5,0,-5
53297,53297,53298,0,0,0
53298,53298,53299,0,0,0
53299,53299,53300,0,4,4
53300,53300,53301,4,1,-3
53301,53301,53302,1,7,6
53302,53302,53303,7,2,-5
53303,53303,53304,2,1,-1
53304,53304,53305,1,3,2
53305,53305,53306,3,5,2
53306,53306,53307,5,4,-1
53307,53307,53308,4,1,-3
53308,53308,53309,1,5,4
53309,53309,53310,5,1,-4
53310,53310,53311,1,6,5
53311,53311,53312,6,8,2
53312,53312,53313,8,7,-1
53313,53313,53314,7,1,-6
53314,53314,53315,1,8,7
53315,53315,53316,8,5,-3
53316,53316,53317,5,9,4
53317,53317,53318,9,6,-3
53318,53318,53319,6,0,-6
53319,53319,53320,0,6,6
53320,53320,53321,6,1,-5
53321,53321,53322,1,2,1
53322,53322,53323,2,2,0
53323,53323,53324,2,9,7
53324,53324,53325,9,3,-6
53325,53325,53326,3,1,-2
53326,53326,53327,1,4,3
53327,53327,53328,4,0,-4
53328,53328,53329,0,5,5
53329,53329,53330,5,1,-4
53330,53330,53331,1,6,5
53331,53331,53332,6,3,-3
53332,53332,53333,3,7,4
53333,53333,53334,7,7,0
53334,53334,53335,7,8,1
53335,53335,53336,8,6,-2
53336,53336,53337,6,9,3
53337,53337,53338,9,7,-2
53338,53338,53339,7,0,-7
53339,53339,53340,0,2,2
53340,53340,53341,2,1,-1
53341,53341,53342,1,9,8
53342,53342,53343,9,2,-7
53343,53343,53344,2,0,-2
53344,53344,53345,0,3,3
53345,53345,53346,3,4,1
53346,53346,53347,4,4,0
53347,53347,53348,4,1,-3
53348,53348,53349,1,9,8
53349,53349,53350,9,0,-9
53350,53350,53351,0,1,1
53351,53351,53352,1,5,4
53352,53352,53353,5,0,-5
53353,53353,53354,0,0,0
53354,53354,53355,0,0,0
53355,53355,53356,0,5,5
53356,53356,53357,5,3,-2
53357,53357,53358,3,3,0
53358,53358,53359,3,6,3
53359,53359,53360,6,0,-6
53360,53360,53361,0,1,1
53361,53361,53362,1,4,3
53362,53362,53363,4,4,0
53363,53363,53364,4,4,0
53364,53364,53365,4,3,-1
53365,53365,53366,3,2,-1
53366,53366,53367,2,2,0
53367,53367,53368,2,7,5
53368,53368,53369,7,9,2
53369,53369,53370,9,9,0
53370,53370,53371,9,1,-8
53371,53371,53372,1,7,6
53372,53372,53373,7,2,-5
53373,53373,53374,2,3,1
53374,53374,53375,3,1,-2
53375,53375,53376,1,3,2
53376,53376,53377,3,2,-1
53377,53377,53378,2,4,2
53378,53378,53379,4,9,5
53379,53379,53380,9,0,-9
53380,53380,53381,0,0,0
53381,53381,53382,0,3,3
53382,53382,53383,3,1,-2
53383,53383,53384,1,4,3
53384,53384,53385,4,3,-1
53385,53385,53386,3,9,6
53386,53386,53387,9,0,-9
53387,53387,53388,0,2,2
53388,53388,53389,2,6,4
53389,53389,53390,6,2,-4
53390,53390,53391,2,2,0
53391,53391,53392,2,7,5
53392,53392,53393,7,9,2
53393,53393,53394,9,1,-8
53394,53394,53395,1,1,0
53395,53395,53396,1,9,8
53396,53396,53397,9,9,0
53397,53397,53398,9,6,-3
53398,53398,53399,6,0,-6
53399,53399,53400,0,8,8
53400,53400,53401,8,0,-8
53401,53401,53402,0,3,3
53402,53402,53403,3,0,-3
53403,53403,53404,0,0,0
53404,53404,53405,0,1,1
53405,53405,53406,1,6,5
53406,53406,53407,6,0,-6
53407,53407,53408,0,5,5
53408,53408,53409,5,1,-4
53409,53409,53410,1,5,4
53410,53410,53411,5,4,-1
53411,53411,53412,4,3,-1
53412,53412,53413,3,5,2
53413,53413,53414,5,5,0
53414,53414,53415,5,7,2
53415,53415,53416,7,6,-1
53416,53416,53417,6,8,2
53417,53417,53418,8,7,-1
53418,53418,53419,7,3,-4
53419,53419,53420,3,8,5
53420,53420,53421,8,4,-4
53421,53421,53422,4,6,2
53422,53422,53423,6,7,1
53423,53423,53424,7,0,-7
53424,53424,53425,0,1,1
53425,53425,53426,1,4,3
53426,53426,53427,4,1,-3
53427,53427,53428,1,5,4
53428,53428,53429,5,0,-5
53429,53429,53430,0,2,2
53430,53430,53431,2,7,5
53431,53431,53432,7,0,-7
53432,53432,53433,0,5,5
53433,53433,53434,5,2,-3
53434,53434,53435,2,9,7
53435,53435,53436,9,1,-8
53436,53436,53437,1,9,8
53437,53437,53438,9,9,0
53438,53438,53439,9,4,-5
53439,53439,53440,4,8,4
53440,53440,53441,8,7,-1
53441,53441,53442,7,9,2
53442,53442,53443,9,5,-4
53443,53443,53444,5,0,-5
53444,53444,53445,0,8,8
53445,53445,53446,8,4,-4
53446,53446,53447,4,3,-1
53447,53447,53448,3,1,-2
53448,53448,53449,1,4,3
53449,53449,53450,4,4,0
53450,53450,53451,4,4,0
53451,53451,53452,4,4,0
53452,53452,53453,4,3,-1
53453,53453,53454,3,0,-3
53454,53454,53455,0,2,2
53455,53455,53456,2,9,7
53456,53456,53457,9,3,-6
53457,53457,53458,3,4,1
53458,53458,53459,4,4,0
53459,53459,53460,4,0,-4
53460,53460,53461,0,5,5
53461,53461,53462,5,8,3
53462,53462,53463,8,6,-2
53463,53463,53464,6,8,2
53464,53464,53465,8,7,-1
53465,53465,53466,7,5,-2
53466,53466,53467,5,1,-4
53467,53467,53468,1,1,0
53468,53468,53469,1,0,-1
53469,53469,53470,0,5,5
53470,53470,53471,5,1,-4
53471,53471,53472,1,6,5
53472,53472,53473,6,2,-4
53473,53473,53474,2,3,1
53474,53474,53475,3,3,0
53475,53475,53476,3,4,1
53476,53476,53477,4,4,0
53477,53477,53478,4,7,3
53478,53478,53479,7,5,-2
53479,53479,53480,5,3,-2
53480,53480,53481,3,6,3
53481,53481,53482,6,3,-3
53482,53482,53483,3,7,4
53483,53483,53484,7,1,-6
53484,53484,53485,1,8,7
53485,53485,53486,8,8,0
53486,53486,53487,8,0,-8
53487,53487,53488,0,3,3
53488,53488,53489,3,1,-2
53489,53489,53490,1,7,6
53490,53490,53491,7,2,-5
53491,53491,53492,2,4,2
53492,53492,53493,4,3,-1
53493,53493,53494,3,2,-1
53494,53494,53495,2,4,2
53495,53495,53496,4,9,5
53496,53496,53497,9,5,-4
53497,53497,53498,5,1,-4
53498,53498,53499,1,6,5
53499,53499,53500,6,2,-4
53500,53500,53501,2,7,5
53501,53501,53502,7,0,-7
53502,53502,53503,0,0,0
53503,53503,53504,0,2,2
53504,53504,53505,2,9,7
53505,53505,53506,9,8,-1
53506,53506,53507,8,5,-3
53507,53507,53508,5,8,3
53508,53508,53509,8,0,-8
53509,53509,53510,0,7,7
53510,53510,53511,7,9,2
53511,53511,53512,9,2,-7
53512,53512,53513,2,8,6
53513,53513,53514,8,3,-5
53514,53514,53515,3,9,6
53515,53515,53516,9,6,-3
53516,53516,53517,6,8,2
53517,53517,53518,8,1,-7
53518,53518,53519,1,4,3
53519,53519,53520,4,8,4
53520,53520,53521,8,1,-7
53521,53521,53522,1,2,1
53522,53522,53523,2,7,5
53523,53523,53524,7,0,-7
53524,53524,53525,0,7,7
53525,53525,53526,7,6,-1
53526,53526,53527,6,3,-3
53527,53527,53528,3,4,1
53528,53528,53529,4,5,1
53529,53529,53530,5,9,4
53530,53530,53531,9,1,-8
53531,53531,53532,1,9,8
53532,53532,53533,9,0,-9
53533,53533,53534,0,6,6
53534,53534,53535,6,0,-6
53535,53535,53536,0,0,0
53536,53536,53537,0,0,0
53537,53537,53538,0,5,5
53538,53538,53539,5,1,-4
53539,53539,53540,1,6,5
53540,53540,53541,6,2,-4
53541,53541,53542,2,3,1
53542,53542,53543,3,6,3
53543,53543,53544,6,9,3
53544,53544,53545,9,3,-6
53545,53545,53546,3,4,1
53546,53546,53547,4,3,-1
53547,53547,53548,3,7,4
53548,53548,53549,7,7,0
53549,53549,53550,7,9,2
53550,53550,53551,9,4,-5
53551,53551,53552,4,5,1
53552,53552,53553,5,6,1
53553,53553,53554,6,3,-3
53554,53554,53555,3,6,3
53555,53555,53556,6,8,2
53556,53556,53557,8,6,-2
53557,53557,53558,6,3,-3
53558,53558,53559,3,4,1
53559,53559,53560,4,3,-1
53560,53560,53561,3,9,6
53561,53561,53562,9,0,-9
53562,53562,53563,0,1,1
53563,53563,53564,1,4,3
53564,53564,53565,4,9,5
53565,53565,53566,9,3,-6
53566,53566,53567,3,5,2
53567,53567,53568,5,5,0
53568,53568,53569,5,8,3
53569,53569,53570,8,3,-5
53570,53570,53571,3,2,-1
53571,53571,53572,2,5,3
53572,53572,53573,5,0,-5
53573,53573,53574,0,8,8
53574,53574,53575,8,0,-8
53575,53575,53576,0,4,4
53576,53576,53577,4,1,-3
53577,53577,53578,1,6,5
53578,53578,53579,6,7,1
53579,53579,53580,7,8,1
53580,53580,53581,8,6,-2
53581,53581,53582,6,4,-2
53582,53582,53583,4,3,-1
53583,53583,53584,3,3,0
53584,53584,53585,3,2,-1
53585,53585,53586,2,3,1
53586,53586,53587,3,1,-2
53587,53587,53588,1,6,5
53588,53588,53589,6,7,1
53589,53589,53590,7,5,-2
53590,53590,53591,5,3,-2
53591,53591,53592,3,9,6
53592,53592,53593,9,1,-8
53593,53593,53594,1,1,0
53594,53594,53595,1,3,2
53595,53595,53596,3,4,1
53596,53596,53597,4,9,5
53597,53597,53598,9,5,-4
53598,53598,53599,5,1,-4
53599,53599,53600,1,7,6
53600,53600,53601,7,7,0
53601,53601,53602,7,4,-3
53602,53602,53603,4,6,2
53603,53603,53604,6,1,-5
53604,53604,53605,1,8,7
53605,53605,53606,8,6,-2
53606,53606,53607,6,4,-2
53607,53607,53608,4,2,-2
53608,53608,53609,2,3,1
53609,53609,53610,3,1,-2
53610,53610,53611,1,1,0
53611,53611,53612,1,7,6
53612,53612,53613,7,4,-3
53613,53613,53614,4,7,3
53614,53614,53615,7,0,-7
53615,53615,53616,0,9,9
53616,53616,53617,9,5,-4
53617,53617,53618,5,4,-1
53618,53618,53619,4,3,-1
53619,53619,53620,3,5,2
53620,53620,53621,5,6,1
53621,53621,53622,6,4,-2
53622,53622,53623,4,9,5
53623,53623,53624,9,7,-2
53624,53624,53625,7,6,-1
53625,53625,53626,6,5,-1
53626,53626,53627,5,1,-4
53627,53627,53628,1,2,1
53628,53628,53629,2,7,5
53629,53629,53630,7,3,-4
53630,53630,53631,3,4,1
53631,53631,53632,4,0,-4
53632,53632,53633,0,4,4
53633,53633,53634,4,5,1
53634,53634,53635,5,7,2
53635,53635,53636,7,8,1
53636,53636,53637,8,2,-6
53637,53637,53638,2,5,3
53638,53638,53639,5,2,-3
53639,53639,53640,2,8,6
53640,53640,53641,8,5,-3
53641,53641,53642,5,5,0
53642,53642,53643,5,7,2
53643,53643,53644,7,2,-5
53644,53644,53645,2,9,7
53645,53645,53646,9,6,-3
53646,53646,53647,6,5,-1
53647,53647,53648,5,8,3
53648,53648,53649,8,4,-4
53649,53649,53650,4,2,-2
53650,53650,53651,2,8,6
53651,53651,53652,8,6,-2
53652,53652,53653,6,8,2
53653,53653,53654,8,4,-4
53654,53654,53655,4,4,0
53655,53655,53656,4,2,-2
53656,53656,53657,2,0,-2
53657,53657,53658,0,2,2
53658,53658,53659,2,8,6
53659,53659,53660,8,8,0
53660,53660,53661,8,9,1
53661,53661,53662,9,1,-8
53662,53662,53663,1,8,7
53663,53663,53664,8,1,-7
53664,53664,53665,1,0,-1
53665,53665,53666,0,7,7
53666,53666,53667,7,1,-6
53667,53667,53668,1,2,1
53668,53668,53669,2,2,0
53669,53669,53670,2,0,-2
53670,53670,53671,0,3,3
53671,53671,53672,3,8,5
53672,53672,53673,8,4,-4
53673,53673,53674,4,4,0
53674,53674,53675,4,5,1
53675,53675,53676,5,9,4
53676,53676,53677,9,6,-3
53677,53677,53678,6,0,-6
53678,53678,53679,0,7,7
53679,53679,53680,7,9,2
53680,53680,53681,9,8,-1
53681,53681,53682,8,9,1
53682,53682,53683,9,9,0
53683,53683,53684,9,0,-9
53684,53684,53685,0,0,0
53685,53685,53686,0,8,8
53686,53686,53687,8,1,-7
53687,53687,53688,1,3,2
53688,53688,53689,3,2,-1
53689,53689,53690,2,5,3
53690,53690,53691,5,3,-2
53691,53691,53692,3,2,-1
53692,53692,53693,2,4,2
53693,53693,53694,4,7,3
53694,53694,53695,7,5,-2
53695,53695,53696,5,5,0
53696,53696,53697,5,6,1
53697,53697,53698,6,9,3
53698,53698,53699,9,7,-2
53699,53699,53700,7,9,2
53700,53700,53701,9,8,-1
53701,53701,53702,8,7,-1
53702,53702,53703,7,9,2
53703,53703,53704,9,3,-6
53704,53704,53705,3,0,-3
53705,53705,53706,0,6,6
53706,53706,53707,6,1,-5
53707,53707,53708,1,2,1
53708,53708,53709,2,2,0
53709,53709,53710,2,4,2
53710,53710,53711,4,3,-1
53711,53711,53712,3,3,0
53712,53712,53713,3,4,1
53713,53713,53714,4,1,-3
53714,53714,53715,1,5,4
53715,53715,53716,5,3,-2
53716,53716,53717,3,6,3
53717,53717,53718,6,5,-1
53718,53718,53719,5,7,2
53719,53719,53720,7,2,-5
53720,53720,53721,2,8,6
53721,53721,53722,8,3,-5
53722,53722,53723,3,9,6
53723,53723,53724,9,3,-6
53724,53724,53725,3,7,4
53725,53725,53726,7,1,-6
53726,53726,53727,1,2,1
53727,53727,53728,2,8,6
53728,53728,53729,8,9,1
53729,53729,53730,9,8,-1
53730,53730,53731,8,4,-4
53731,53731,53732,4,5,1
53732,53732,53733,5,2,-3
53733,53733,53734,2,0,-2
53734,53734,53735,0,9,9
53735,53735,53736,9,9,0
53736,53736,53737,9,8,-1
53737,53737,53738,8,4,-4
53738,53738,53739,4,4,0
53739,53739,53740,4,3,-1
53740,53740,53741,3,5,2
53741,53741,53742,5,2,-3
53742,53742,53743,2,8,6
53743,53743,53744,8,2,-6
53744,53744,53745,2,8,6
53745,53745,53746,8,1,-7
53746,53746,53747,1,0,-1
53747,53747,53748,0,2,2
53748,53748,53749,2,3,1
53749,53749,53750,3,1,-2
53750,53750,53751,1,5,4
53751,53751,53752,5,9,4
53752,53752,53753,9,4,-5
53753,53753,53754,4,6,2
53754,53754,53755,6,3,-3
53755,53755,53756,3,8,5
53756,53756,53757,8,3,-5
53757,53757,53758,3,3,0
53758,53758,53759,3,5,2
53759,53759,53760,5,4,-1
53760,53760,53761,4,1,-3
53761,53761,53762,1,2,1
53762,53762,53763,2,7,5
53763,53763,53764,7,9,2
53764,53764,53765,9,8,-1
53765,53765,53766,8,7,-1
53766,53766,53767,7,4,-3
53767,53767,53768,4,4,0
53768,53768,53769,4,5,1
53769,53769,53770,5,7,2
53770,53770,53771,7,7,0
53771,53771,53772,7,2,-5
53772,53772,53773,2,2,0
53773,53773,53774,2,8,6
53774,53774,53775,8,6,-2
53775,53775,53776,6,4,-2
53776,53776,53777,4,6,2
53777,53777,53778,6,9,3
53778,53778,53779,9,7,-2
53779,53779,53780,7,1,-6
53780,53780,53781,1,7,6
53781,53781,53782,7,8,1
53782,53782,53783,8,7,-1
53783,53783,53784,7,9,2
53784,53784,53785,9,0,-9
53785,53785,53786,0,8,8
53786,53786,53787,8,1,-7
53787,53787,53788,1,0,-1
53788,53788,53789,0,0,0
53789,53789,53790,0,2,2
53790,53790,53791,2,1,-1
53791,53791,53792,1,1,0
53792,53792,53793,1,6,5
53793,53793,53794,6,5,-1
53794,53794,53795,5,5,0
53795,53795,53796,5,5,0
53796,53796,53797,5,5,0
53797,53797,53798,5,6,1
53798,53798,53799,6,2,-4
53799,53799,53800,2,0,-2
53800,53800,53801,0,9,9
53801,53801,53802,9,5,-4
53802,53802,53803,5,3,-2
53803,53803,53804,3,1,-2
53804,53804,53805,1,1,0
53805,53805,53806,1,8,7
53806,53806,53807,8,4,-4
53807,53807,53808,4,4,0
53808,53808,53809,4,8,4
53809,53809,53810,8,9,1
53810,53810,53811,9,8,-1
53811,53811,53812,8,5,-3
53812,53812,53813,5,7,2
53813,53813,53814,7,0,-7
53814,53814,53815,0,3,3
53815,53815,53816,3,1,-2
53816,53816,53817,1,8,7
53817,53817,53818,8,6,-2
53818,53818,53819,6,2,-4
53819,53819,53820,2,4,2
53820,53820,53821,4,9,5
53821,53821,53822,9,5,-4
53822,53822,53823,5,1,-4
53823,53823,53824,1,1,0
53824,53824,53825,1,2,1
53825,53825,53826,2,5,3
53826,53826,53827,5,6,1
53827,53827,53828,6,6,0
53828,53828,53829,6,5,-1
53829,53829,53830,5,6,1
53830,53830,53831,6,9,3
53831,53831,53832,9,7,-2
53832,53832,53833,7,1,-6
53833,53833,53834,1,4,3
53834,53834,53835,4,2,-2
53835,53835,53836,2,7,5
53836,53836,53837,7,2,-5
53837,53837,53838,2,3,1
53838,53838,53839,3,7,4
53839,53839,53840,7,6,-1
53840,53840,53841,6,9,3
53841,53841,53842,9,1,-8
53842,53842,53843,1,7,6
53843,53843,53844,7,5,-2
53844,53844,53845,5,9,4
53845,53845,53846,9,3,-6
53846,53846,53847,3,9,6
53847,53847,53848,9,8,-1
53848,53848,53849,8,1,-7
53849,53849,53850,1,4,3
53850,53850,53851,4,0,-4
53851,53851,53852,0,7,7
53852,53852,53853,7,9,2
53853,53853,53854,9,8,-1
53854,53854,53855,8,7,-1
53855,53855,53856,7,4,-3
53856,53856,53857,4,0,-4
53857,53857,53858,0,7,7
53858,53858,53859,7,5,-2
53859,53859,53860,5,8,3
53860,53860,53861,8,0,-8
53861,53861,53862,0,2,2
53862,53862,53863,2,3,1
53863,53863,53864,3,8,5
53864,53864,53865,8,8,0
53865,53865,53866,8,7,-1
53866,53866,53867,7,4,-3
53867,53867,53868,4,9,5
53868,53868,53869,9,6,-3
53869,53869,53870,6,1,-5
53870,53870,53871,1,1,0
53871,53871,53872,1,8,7
53872,53872,53873,8,4,-4
53873,53873,53874,4,3,-1
53874,53874,53875,3,3,0
53875,53875,53876,3,2,-1
53876,53876,53877,2,6,4
53877,53877,53878,6,2,-4
53878,53878,53879,2,2,0
53879,53879,53880,2,0,-2
53880,53880,53881,0,0,0
53881,53881,53882,0,9,9
53882,53882,53883,9,4,-5
53883,53883,53884,4,2,-2
53884,53884,53885,2,8,6
53885,53885,53886,8,7,-1
53886,53886,53887,7,1,-6
53887,53887,53888,1,4,3
53888,53888,53889,4,3,-1
53889,53889,53890,3,2,-1
53890,53890,53891,2,1,-1
53891,53891,53892,1,6,5
53892,53892,53893,6,0,-6
53893,53893,53894,0,0,0
53894,53894,53895,0,9,9
53895,53895,53896,9,1,-8
53896,53896,53897,1,0,-1
53897,53897,53898,0,4,4
53898,53898,53899,4,1,-3
53899,53899,53900,1,6,5
53900,53900,53901,6,2,-4
53901,53901,53902,2,4,2
53902,53902,53903,4,3,-1
53903,53903,53904,3,1,-2
53904,53904,53905,1,4,3
53905,53905,53906,4,8,4
53906,53906,53907,8,5,-3
53907,53907,53908,5,1,-4
53908,53908,53909,1,6,5
53909,53909,53910,6,2,-4
53910,53910,53911,2,7,5
53911,53911,53912,7,4,-3
53912,53912,53913,4,8,4
53913,53913,53914,8,4,-4
53914,53914,53915,4,9,5
53915,53915,53916,9,0,-9
53916,53916,53917,0,0,0
53917,53917,53918,0,6,6
53918,53918,53919,6,1,-5
53919,53919,53920,1,5,4
53920,53920,53921,5,2,-3
53921,53921,53922,2,5,3
53922,53922,53923,5,3,-2
53923,53923,53924,3,0,-3
53924,53924,53925,0,4,4
53925,53925,53926,4,2,-2
53926,53926,53927,2,5,3
53927,53927,53928,5,0,-5
53928,53928,53929,0,6,6
53929,53929,53930,6,1,-5
53930,53930,53931,1,7,6
53931,53931,53932,7,0,-7
53932,53932,53933,0,8,8
53933,53933,53934,8,0,-8
53934,53934,53935,0,9,9
53935,53935,53936,9,0,-9
53936,53936,53937,0,0,0
53937,53937,53938,0,3,3
53938,53938,53939,3,1,-2
53939,53939,53940,1,0,-1
53940,53940,53941,0,2,2
53941,53941,53942,2,5,3
53942,53942,53943,5,3,-2
53943,53943,53944,3,7,4
53944,53944,53945,7,4,-3
53945,53945,53946,4,5,1
53946,53946,53947,5,5,0
53947,53947,53948,5,9,4
53948,53948,53949,9,6,-3
53949,53949,53950,6,9,3
53950,53950,53951,9,9,0
53951,53951,53952,9,8,-1
53952,53952,53953,8,8,0
53953,53953,53954,8,3,-5
53954,53954,53955,3,4,1
53955,53955,53956,4,7,3
53956,53956,53957,7,0,-7
53957,53957,53958,0,3,3
53958,53958,53959,3,0,-3
53959,53959,53960,0,3,3
53960,53960,53961,3,7,4
53961,53961,53962,7,7,0
53962,53962,53963,7,2,-5
53963,53963,53964,2,9,7
53964,53964,53965,9,4,-5
53965,53965,53966,4,1,-3
53966,53966,53967,1,2,1
53967,53967,53968,2,5,3
53968,53968,53969,5,6,1
53969,53969,53970,6,8,2
53970,53970,53971,8,5,-3
53971,53971,53972,5,2,-3
53972,53972,53973,2,5,3
53973,53973,53974,5,4,-1
53974,53974,53975,4,3,-1
53975,53975,53976,3,9,6
53976,53976,53977,9,7,-2
53977,53977,53978,7,5,-2
53978,53978,53979,5,8,3
53979,53979,53980,8,1,-7
53980,53980,53981,1,6,5
53981,53981,53982,6,0,-6
53982,53982,53983,0,6,6
53983,53983,53984,6,2,-4
53984,53984,53985,2,4,2
53985,53985,53986,4,7,3
53986,53986,53987,7,3,-4
53987,53987,53988,3,4,1
53988,53988,53989,4,2,-2
53989,53989,53990,2,4,2
53990,53990,53991,4,6,2
53991,53991,53992,6,5,-1
53992,53992,53993,5,6,1
53993,53993,53994,6,0,-6
53994,53994,53995,0,3,3
53995,53995,53996,3,8,5
53996,53996,53997,8,8,0
53997,53997,53998,8,9,1
53998,53998,53999,9,8,-1
53999,53999,54000,8,5,-3
54000,54000,54001,5,3,-2
54001,54001,54002,3,5,2
54002,54002,54003,5,0,-5
54003,54003,54004,0,0,0
54004,54004,54005,0,1,1
54005,54005,54006,1,8,7
54006,54006,54007,8,4,-4
54007,54007,54008,4,3,-1
54008,54008,54009,3,4,1
54009,54009,54010,4,0,-4
54010,54010,54011,0,7,7
54011,54011,54012,7,0,-7
54012,54012,54013,0,3,3
54013,54013,54014,3,3,0
54014,54014,54015,3,5,2
54015,54015,54016,5,3,-2
54016,54016,54017,3,4,1
54017,54017,54018,4,6,2
54018,54018,54019,6,1,-5
54019,54019,54020,1,3,2
54020,54020,54021,3,9,6
54021,54021,54022,9,7,-2
54022,54022,54023,7,1,-6
54023,54023,54024,1,5,4
54024,54024,54025,5,2,-3
54025,54025,54026,2,9,7
54026,54026,54027,9,1,-8
54027,54027,54028,1,3,2
54028,54028,54029,3,3,0
54029,54029,54030,3,8,5
54030,54030,54031,8,9,1
54031,54031,54032,9,6,-3
54032,54032,54033,6,2,-4
54033,54033,54034,2,8,6
54034,54034,54035,8,7,-1
54035,54035,54036,7,9,2
54036,54036,54037,9,7,-2
54037,54037,54038,7,9,2
54038,54038,54039,9,9,0
54039,54039,54040,9,8,-1
54040,54040,54041,8,4,-4
54041,54041,54042,4,4,0
54042,54042,54043,4,2,-2
54043,54043,54044,2,5,3
54044,54044,54045,5,5,0
54045,54045,54046,5,4,-1
54046,54046,54047,4,8,4
54047,54047,54048,8,9,1
54048,54048,54049,9,6,-3
54049,54049,54050,6,9,3
54050,54050,54051,9,5,-4
54051,54051,54052,5,2,-3
54052,54052,54053,2,5,3
54053,54053,54054,5,8,3
54054,54054,54055,8,9,1
54055,54055,54056,9,8,-1
54056,54056,54057,8,9,1
54057,54057,54058,9,2,-7
54058,54058,54059,2,1,-1
54059,54059,54060,1,3,2
54060,54060,54061,3,1,-2
54061,54061,54062,1,3,2
54062,54062,54063,3,5,2
54063,54063,54064,5,9,4
54064,54064,54065,9,7,-2
54065,54065,54066,7,7,0
54066,54066,54067,7,6,-1
54067,54067,54068,6,6,0
54068,54068,54069,6,9,3
54069,54069,54070,9,1,-8
54070,54070,54071,1,1,0
54071,54071,54072,1,7,6
54072,54072,54073,7,3,-4
54073,54073,54074,3,3,0
54074,54074,54075,3,2,-1
54075,54075,54076,2,9,7
54076,54076,54077,9,3,-6
54077,54077,54078,3,2,-1
54078,54078,54079,2,1,-1
54079,54079,54080,1,0,-1
54080,54080,54081,0,9,9
54081,54081,54082,9,8,-1
54082,54082,54083,8,0,-8
54083,54083,54084,0,3,3
54084,54084,54085,3,9,6
54085,54085,54086,9,6,-3
54086,54086,54087,6,1,-5
54087,54087,54088,1,3,2
54088,54088,54089,3,0,-3
54089,54089,54090,0,2,2
54090,54090,54091,2,5,3
54091,54091,54092,5,5,0
54092,54092,54093,5,8,3
54093,54093,54094,8,1,-7
54094,54094,54095,1,2,1
54095,54095,54096,2,7,5
54096,54096,54097,7,7,0
54097,54097,54098,7,9,2
54098,54098,54099,9,7,-2
54099,54099,54100,7,7,0
54100,54100,54101,7,0,-7
54101,54101,54102,0,0,0
54102,54102,54103,0,1,1
54103,54103,54104,1,0,-1
54104,54104,54105,0,2,2
54105,54105,54106,2,7,5
54106,54106,54107,7,3,-4
54107,54107,54108,3,0,-3
54108,54108,54109,0,4,4
54109,54109,54110,4,2,-2
54110,54110,54111,2,5,3
54111,54111,54112,5,4,-1
54112,54112,54113,4,6,2
54113,54113,54114,6,7,1
54114,54114,54115,7,7,0
54115,54115,54116,7,4,-3
54116,54116,54117,4,8,4
54117,54117,54118,8,7,-1
54118,54118,54119,7,9,2
54119,54119,54120,9,8,-1
54120,54120,54121,8,0,-8
54121,54121,54122,0,5,5
54122,54122,54123,5,1,-4
54123,54123,54124,1,6,5
54124,54124,54125,6,2,-4
54125,54125,54126,2,3,1
54126,54126,54127,3,3,0
54127,54127,54128,3,2,-1
54128,54128,54129,2,4,2
54129,54129,54130,4,4,0
54130,54130,54131,4,5,1
54131,54131,54132,5,8,3
54132,54132,54133,8,6,-2
54133,54133,54134,6,2,-4
54134,54134,54135,2,7,5
54135,54135,54136,7,8,1
54136,54136,54137,8,8,0
54137,54137,54138,8,9,1
54138,54138,54139,9,9,0
54139,54139,54140,9,3,-6
54140,54140,54141,3,0,-3
54141,54141,54142,0,5,5
54142,54142,54143,5,1,-4
54143,54143,54144,1,9,8
54144,54144,54145,9,2,-7
54145,54145,54146,2,9,7
54146,54146,54147,9,3,-6
54147,54147,54148,3,7,4
54148,54148,54149,7,4,-3
54149,54149,54150,4,6,2
54150,54150,54151,6,5,-1
54151,54151,54152,5,7,2
54152,54152,54153,7,6,-1
54153,54153,54154,6,9,3
54154,54154,54155,9,7,-2
54155,54155,54156,7,4,-3
54156,54156,54157,4,8,4
54157,54157,54158,8,4,-4
54158,54158,54159,4,5,1
54159,54159,54160,5,2,-3
54160,54160,54161,2,2,0
54161,54161,54162,2,8,6
54162,54162,54163,8,8,0
54163,54163,54164,8,1,-7
54164,54164,54165,1,1,0
54165,54165,54166,1,9,8
54166,54166,54167,9,7,-2
54167,54167,54168,7,2,-5
54168,54168,54169,2,2,0
54169,54169,54170,2,9,7
54170,54170,54171,9,4,-5
54171,54171,54172,4,6,2
54172,54172,54173,6,1,-5
54173,54173,54174,1,3,2
54174,54174,54175,3,4,1
54175,54175,54176,4,7,3
54176,54176,54177,7,1,-6
54177,54177,54178,1,8,7
54178,54178,54179,8,4,-4
54179,54179,54180,4,8,4
54180,54180,54181,8,9,1
54181,54181,54182,9,1,-8
54182,54182,54183,1,6,5
54183,54183,54184,6,5,-1
54184,54184,54185,5,8,3
54185,54185,54186,8,7,-1
54186,54186,54187,7,4,-3
54187,54187,54188,4,6,2
54188,54188,54189,6,5,-1
54189,54189,54190,5,8,3
54190,54190,54191,8,3,-5
54191,54191,54192,3,8,5
54192,54192,54193,8,7,-1
54193,54193,54194,7,7,0
54194,54194,54195,7,8,1
54195,54195,54196,8,6,-2
54196,54196,54197,6,4,-2
54197,54197,54198,4,8,4
54198,54198,54199,8,3,-5
54199,54199,54200,3,6,3
54200,54200,54201,6,3,-3
54201,54201,54202,3,5,2
54202,54202,54203,5,5,0
54203,54203,54204,5,6,1
54204,54204,54205,6,6,0
54205,54205,54206,6,6,0
54206,54206,54207,6,7,1
54207,54207,54208,7,3,-4
54208,54208,54209,3,0,-3
54209,54209,54210,0,1,1
54210,54210,54211,1,6,5
54211,54211,54212,6,7,1
54212,54212,54213,7,1,-6
54213,54213,54214,1,0,-1
54214,54214,54215,0,6,6
54215,54215,54216,6,8,2
54216,54216,54217,8,8,0
54217,54217,54218,8,7,-1
54218,54218,54219,7,7,0
54219,54219,54220,7,2,-5
54220,54220,54221,2,0,-2
54221,54221,54222,0,9,9
54222,54222,54223,9,1,-8
54223,54223,54224,1,6,5
54224,54224,54225,6,5,-1
54225,54225,54226,5,8,3
54226,54226,54227,8,6,-2
54227,54227,54228,6,3,-3
54228,54228,54229,3,0,-3
54229,54229,54230,0,5,5
54230,54230,54231,5,8,3
54231,54231,54232,8,0,-8
54232,54232,54233,0,5,5
54233,54233,54234,5,4,-1
54234,54234,54235,4,0,-4
54235,54235,54236,0,1,1
54236,54236,54237,1,6,5
54237,54237,54238,6,2,-4
54238,54238,54239,2,1,-1
54239,54239,54240,1,2,1
54240,54240,54241,2,5,3
54241,54241,54242,5,3,-2
54242,54242,54243,3,8,5
54243,54243,54244,8,9,1
54244,54244,54245,9,4,-5
54245,54245,54246,4,5,1
54246,54246,54247,5,2,-3
54247,54247,54248,2,3,1
54248,54248,54249,3,3,0
54249,54249,54250,3,3,0
54250,54250,54251,3,9,6
54251,54251,54252,9,6,-3
54252,54252,54253,6,7,1
54253,54253,54254,7,1,-6
54254,54254,54255,1,6,5
54255,54255,54256,6,7,1
54256,54256,54257,7,9,2
54257,54257,54258,9,3,-6
54258,54258,54259,3,1,-2
54259,54259,54260,1,5,4
54260,54260,54261,5,9,4
54261,54261,54262,9,2,-7
54262,54262,54263,2,0,-2
54263,54263,54264,0,4,4
54264,54264,54265,4,6,2
54265,54265,54266,6,9,3
54266,54266,54267,9,7,-2
54267,54267,54268,7,8,1
54268,54268,54269,8,1,-7
54269,54269,54270,1,3,2
54270,54270,54271,3,2,-1
54271,54271,54272,2,0,-2
54272,54272,54273,0,3,3
54273,54273,54274,3,7,4
54274,54274,54275,7,9,2
54275,54275,54276,9,4,-5
54276,54276,54277,4,2,-2
54277,54277,54278,2,7,5
54278,54278,54279,7,4,-3
54279,54279,54280,4,8,4
54280,54280,54281,8,5,-3
54281,54281,54282,5,5,0
54282,54282,54283,5,5,0
54283,54283,54284,5,0,-5
54284,54284,54285,0,3,3
54285,54285,54286,3,2,-1
54286,54286,54287,2,7,5
54287,54287,54288,7,6,-1
54288,54288,54289,6,5,-1
54289,54289,54290,5,0,-5
54290,54290,54291,0,3,3
54291,54291,54292,3,2,-1
54292,54292,54293,2,1,-1
54293,54293,54294,1,4,3
54294,54294,54295,4,8,4
54295,54295,54296,8,3,-5
54296,54296,54297,3,2,-1
54297,54297,54298,2,6,4
54298,54298,54299,6,2,-4
54299,54299,54300,2,9,7
54300,54300,54301,9,3,-6
54301,54301,54302,3,5,2
54302,54302,54303,5,0,-5
54303,54303,54304,0,3,3
54304,54304,54305,3,2,-1
54305,54305,54306,2,2,0
54306,54306,54307,2,9,7
54307,54307,54308,9,8,-1
54308,54308,54309,8,4,-4
54309,54309,54310,4,1,-3
54310,54310,54311,1,9,8
54311,54311,54312,9,9,0
54312,54312,54313,9,0,-9
54313,54313,54314,0,2,2
54314,54314,54315,2,2,0
54315,54315,54316,2,6,4
54316,54316,54317,6,7,1
54317,54317,54318,7,2,-5
54318,54318,54319,2,4,2
54319,54319,54320,4,0,-4
54320,54320,54321,0,9,9
54321,54321,54322,9,3,-6
54322,54322,54323,3,9,6
54323,54323,54324,9,4,-5
54324,54324,54325,4,2,-2
54325,54325,54326,2,2,0
54326,54326,54327,2,8,6
54327,54327,54328,8,0,-8
54328,54328,54329,0,1,1
54329,54329,54330,1,2,1
54330,54330,54331,2,5,3
54331,54331,54332,5,6,1
54332,54332,54333,6,6,0
54333,54333,54334,6,9,3
54334,54334,54335,9,9,0
54335,54335,54336,9,8,-1
54336,54336,54337,8,8,0
54337,54337,54338,8,2,-6
54338,54338,54339,2,3,1
54339,54339,54340,3,1,-2
54340,54340,54341,1,8,7
54341,54341,54342,8,1,-7
54342,54342,54343,1,3,2
54343,54343,54344,3,8,5
54344,54344,54345,8,6,-2
54345,54345,54346,6,8,2
54346,54346,54347,8,4,-4
54347,54347,54348,4,6,2
54348,54348,54349,6,0,-6
54349,54349,54350,0,2,2
54350,54350,54351,2,0,-2
54351,54351,54352,0,8,8
54352,54352,54353,8,1,-7
54353,54353,54354,1,0,-1
54354,54354,54355,0,2,2
54355,54355,54356,2,0,-2
54356,54356,54357,0,3,3
54357,54357,54358,3,4,1
54358,54358,54359,4,4,0
54359,54359,54360,4,6,2
54360,54360,54361,6,5,-1
54361,54361,54362,5,8,3
54362,54362,54363,8,6,-2
54363,54363,54364,6,7,1
54364,54364,54365,7,7,0
54365,54365,54366,7,5,-2
54366,54366,54367,5,8,3
54367,54367,54368,8,0,-8
54368,54368,54369,0,9,9
54369,54369,54370,9,6,-3
54370,54370,54371,6,0,-6
54371,54371,54372,0,7,7
54372,54372,54373,7,1,-6
54373,54373,54374,1,4,3
54374,54374,54375,4,2,-2
54375,54375,54376,2,4,2
54376,54376,54377,4,3,-1
54377,54377,54378,3,7,4
54378,54378,54379,7,4,-3
54379,54379,54380,4,1,-3
54380,54380,54381,1,5,4
54381,54381,54382,5,9,4
54382,54382,54383,9,6,-3
54383,54383,54384,6,1,-5
54384,54384,54385,1,7,6
54385,54385,54386,7,9,2
54386,54386,54387,9,8,-1
54387,54387,54388,8,1,-7
54388,54388,54389,1,9,8
54389,54389,54390,9,6,-3
54390,54390,54391,6,0,-6
54391,54391,54392,0,0,0
54392,54392,54393,0,1,1
54393,54393,54394,1,8,7
54394,54394,54395,8,2,-6
54395,54395,54396,2,7,5
54396,54396,54397,7,3,-4
54397,54397,54398,3,3,0
54398,54398,54399,3,4,1
54399,54399,54400,4,5,1
54400,54400,54401,5,5,0
54401,54401,54402,5,3,-2
54402,54402,54403,3,6,3
54403,54403,54404,6,0,-6
54404,54404,54405,0,7,7
54405,54405,54406,7,3,-4
54406,54406,54407,3,8,5
54407,54407,54408,8,2,-6
54408,54408,54409,2,6,4
54409,54409,54410,6,4,-2
54410,54410,54411,4,0,-4
54411,54411,54412,0,4,4
54412,54412,54413,4,3,-1
54413,54413,54414,3,0,-3
54414,54414,54415,0,4,4
54415,54415,54416,4,1,-3
54416,54416,54417,1,1,0
54417,54417,54418,1,1,0
54418,54418,54419,1,4,3
54419,54419,54420,4,6,2
54420,54420,54421,6,0,-6
54421,54421,54422,0,4,4
54422,54422,54423,4,8,4
54423,54423,54424,8,2,-6
54424,54424,54425,2,6,4
54425,54425,54426,6,7,1
54426,54426,54427,7,4,-3
54427,54427,54428,4,1,-3
54428,54428,54429,1,5,4
54429,54429,54430,5,3,-2
54430,54430,54431,3,4,1
54431,54431,54432,4,2,-2
54432,54432,54433,2,0,-2
54433,54433,54434,0,1,1
54434,54434,54435,1,7,6
54435,54435,54436,7,3,-4
54436,54436,54437,3,8,5
54437,54437,54438,8,1,-7
54438,54438,54439,1,7,6
54439,54439,54440,7,2,-5
54440,54440,54441,2,7,5
54441,54441,54442,7,5,-2
54442,54442,54443,5,9,4
54443,54443,54444,9,3,-6
54444,54444,54445,3,0,-3
54445,54445,54446,0,5,5
54446,54446,54447,5,4,-1
54447,54447,54448,4,2,-2
54448,54448,54449,2,9,7
54449,54449,54450,9,8,-1
54450,54450,54451,8,9,1
54451,54451,54452,9,4,-5
54452,54452,54453,4,7,3
54453,54453,54454,7,2,-5
54454,54454,54455,2,4,2
54455,54455,54456,4,2,-2
54456,54456,54457,2,2,0
54457,54457,54458,2,1,-1
54458,54458,54459,1,0,-1
54459,54459,54460,0,3,3
54460,54460,54461,3,5,2
54461,54461,54462,5,6,1
54462,54462,54463,6,8,2
54463,54463,54464,8,0,-8
54464,54464,54465,0,5,5
54465,54465,54466,5,4,-1
54466,54466,54467,4,9,5
54467,54467,54468,9,1,-8
54468,54468,54469,1,8,7
54469,54469,54470,8,5,-3
54470,54470,54471,5,8,3
54471,54471,54472,8,7,-1
54472,54472,54473,7,4,-3
54473,54473,54474,4,0,-4
54474,54474,54475,0,0,0
54475,54475,54476,0,3,3
54476,54476,54477,3,7,4
54477,54477,54478,7,7,0
54478,54478,54479,7,1,-6
54479,54479,54480,1,2,1
54480,54480,54481,2,3,1
54481,54481,54482,3,7,4
54482,54482,54483,7,5,-2
54483,54483,54484,5,2,-3
54484,54484,54485,2,1,-1
54485,54485,54486,1,0,-1
54486,54486,54487,0,3,3
54487,54487,54488,3,8,5
54488,54488,54489,8,1,-7
54489,54489,54490,1,6,5
54490,54490,54491,6,5,-1
54491,54491,54492,5,8,3
54492,54492,54493,8,3,-5
54493,54493,54494,3,7,4
54494,54494,54495,7,8,1
54495,54495,54496,8,6,-2
54496,54496,54497,6,7,1
54497,54497,54498,7,8,1
54498,54498,54499,8,3,-5
54499,54499,54500,3,5,2
54500,54500,54501,5,1,-4
54501,54501,54502,1,0,-1
54502,54502,54503,0,6,6
54503,54503,54504,6,9,3
54504,54504,54505,9,8,-1
54505,54505,54506,8,1,-7
54506,54506,54507,1,5,4
54507,54507,54508,5,9,4
54508,54508,54509,9,9,0
54509,54509,54510,9,5,-4
54510,54510,54511,5,2,-3
54511,54511,54512,2,0,-2
54512,54512,54513,0,2,2
54513,54513,54514,2,0,-2
54514,54514,54515,0,0,0
54515,54515,54516,0,3,3
54516,54516,54517,3,9,6
54517,54517,54518,9,6,-3
54518,54518,54519,6,2,-4
54519,54519,54520,2,9,7
54520,54520,54521,9,4,-5
54521,54521,54522,4,7,3
54522,54522,54523,7,6,-1
54523,54523,54524,6,3,-3
54524,54524,54525,3,5,2
54525,54525,54526,5,3,-2
54526,54526,54527,3,2,-1
54527,54527,54528,2,5,3
54528,54528,54529,5,7,2
54529,54529,54530,7,3,-4
54530,54530,54531,3,3,0
54531,54531,54532,3,7,4
54532,54532,54533,7,1,-6
54533,54533,54534,1,3,2
54534,54534,54535,3,3,0
54535,54535,54536,3,7,4
54536,54536,54537,7,6,-1
54537,54537,54538,6,9,3
54538,54538,54539,9,6,-3
54539,54539,54540,6,7,1
54540,54540,54541,7,2,-5
54541,54541,54542,2,7,5
54542,54542,54543,7,1,-6
54543,54543,54544,1,1,0
54544,54544,54545,1,2,1
54545,54545,54546,2,9,7
54546,54546,54547,9,6,-3
54547,54547,54548,6,9,3
54548,54548,54549,9,0,-9
54549,54549,54550,0,8,8
54550,54550,54551,8,2,-6
54551,54551,54552,2,1,-1
54552,54552,54553,1,2,1
54553,54553,54554,2,8,6
54554,54554,54555,8,7,-1
54555,54555,54556,7,2,-5
54556,54556,54557,2,1,-1
54557,54557,54558,1,7,6
54558,54558,54559,7,3,-4
54559,54559,54560,3,3,0
54560,54560,54561,3,7,4
54561,54561,54562,7,5,-2
54562,54562,54563,5,4,-1
54563,54563,54564,4,8,4
54564,54564,54565,8,7,-1
54565,54565,54566,7,5,-2
54566,54566,54567,5,4,-1
54567,54567,54568,4,3,-1
54568,54568,54569,3,8,5
54569,54569,54570,8,6,-2
54570,54570,54571,6,9,3
54571,54571,54572,9,6,-3
54572,54572,54573,6,2,-4
54573,54573,54574,2,2,0
54574,54574,54575,2,9,7
54575,54575,54576,9,1,-8
54576,54576,54577,1,5,4
54577,54577,54578,5,9,4
54578,54578,54579,9,1,-8
54579,54579,54580,1,1,0
54580,54580,54581,1,5,4
54581,54581,54582,5,4,-1
54582,54582,54583,4,6,2
54583,54583,54584,6,9,3
54584,54584,54585,9,8,-1
54585,54585,54586,8,9,1
54586,54586,54587,9,3,-6
54587,54587,54588,3,4,1
54588,54588,54589,4,5,1
54589,54589,54590,5,8,3
54590,54590,54591,8,6,-2
54591,54591,54592,6,9,3
54592,54592,54593,9,8,-1
54593,54593,54594,8,8,0
54594,54594,54595,8,0,-8
54595,54595,54596,0,8,8
54596,54596,54597,8,0,-8
54597,54597,54598,0,5,5
54598,54598,54599,5,9,4
54599,54599,54600,9,0,-9
54600,54600,54601,0,9,9
54601,54601,54602,9,6,-3
54602,54602,54603,6,3,-3
54603,54603,54604,3,5,2
54604,54604,54605,5,1,-4
54605,54605,54606,1,7,6
54606,54606,54607,7,1,-6
54607,54607,54608,1,0,-1
54608,54608,54609,0,0,0
54609,54609,54610,0,6,6
54610,54610,54611,6,1,-5
54611,54611,54612,1,8,7
54612,54612,54613,8,2,-6
54613,54613,54614,2,1,-1
54614,54614,54615,1,3,2
54615,54615,54616,3,3,0
54616,54616,54617,3,4,1
54617,54617,54618,4,6,2
54618,54618,54619,6,5,-1
54619,54619,54620,5,0,-5
54620,54620,54621,0,6,6
54621,54621,54622,6,3,-3
54622,54622,54623,3,7,4
54623,54623,54624,7,8,1
54624,54624,54625,8,8,0
54625,54625,54626,8,8,0
54626,54626,54627,8,9,1
54627,54627,54628,9,4,-5
54628,54628,54629,4,0,-4
54629,54629,54630,0,6,6
54630,54630,54631,6,1,-5
54631,54631,54632,1,7,6
54632,54632,54633,7,2,-5
54633,54633,54634,2,4,2
54634,54634,54635,4,3,-1
54635,54635,54636,3,8,5
54636,54636,54637,8,4,-4
54637,54637,54638,4,7,3
54638,54638,54639,7,5,-2
54639,54639,54640,5,5,0
54640,54640,54641,5,6,1
54641,54641,54642,6,0,-6
54642,54642,54643,0,7,7
54643,54643,54644,7,7,0
54644,54644,54645,7,8,1
54645,54645,54646,8,6,-2
54646,54646,54647,6,9,3
54647,54647,54648,9,3,-6
54648,54648,54649,3,0,-3
54649,54649,54650,0,4,4
54650,54650,54651,4,1,-3
54651,54651,54652,1,6,5
54652,54652,54653,6,2,-4
54653,54653,54654,2,8,6
54654,54654,54655,8,3,-5
54655,54655,54656,3,8,5
54656,54656,54657,8,4,-4
54657,54657,54658,4,3,-1
54658,54658,54659,3,5,2
54659,54659,54660,5,3,-2
54660,54660,54661,3,6,3
54661,54661,54662,6,6,0
54662,54662,54663,6,7,1
54663,54663,54664,7,1,-6
54664,54664,54665,1,8,7
54665,54665,54666,8,9,1
54666,54666,54667,9,9,0
54667,54667,54668,9,4,-5
54668,54668,54669,4,7,3
54669,54669,54670,7,5,-2
54670,54670,54671,5,5,0
54671,54671,54672,5,4,-1
54672,54672,54673,4,5,1
54673,54673,54674,5,2,-3
54674,54674,54675,2,1,-1
54675,54675,54676,1,2,1
54676,54676,54677,2,9,7
54677,54677,54678,9,7,-2
54678,54678,54679,7,9,2
54679,54679,54680,9,2,-7
54680,54680,54681,2,7,5
54681,54681,54682,7,2,-5
54682,54682,54683,2,1,-1
54683,54683,54684,1,8,7
54684,54684,54685,8,0,-8
54685,54685,54686,0,4,4
54686,54686,54687,4,9,5
54687,54687,54688,9,7,-2
54688,54688,54689,7,0,-7
54689,54689,54690,0,0,0
54690,54690,54691,0,7,7
54691,54691,54692,7,1,-6
54692,54692,54693,1,1,0
54693,54693,54694,1,3,2
54694,54694,54695,3,7,4
54695,54695,54696,7,7,0
54696,54696,54697,7,3,-4
54697,54697,54698,3,9,6
54698,54698,54699,9,6,-3
54699,54699,54700,6,3,-3
54700,54700,54701,3,8,5
54701,54701,54702,8,9,1
54702,54702,54703,9,0,-9
54703,54703,54704,0,3,3
54704,54704,54705,3,8,5
54705,54705,54706,8,3,-5
54706,54706,54707,3,3,0
54707,54707,54708,3,1,-2
54708,54708,54709,1,2,1
54709,54709,54710,2,4,2
54710,54710,54711,4,0,-4
54711,54711,54712,0,8,8
54712,54712,54713,8,9,1
54713,54713,54714,9,2,-7
54714,54714,54715,2,0,-2
54715,54715,54716,0,1,1
54716,54716,54717,1,6,5
54717,54717,54718,6,4,-2
54718,54718,54719,4,1,-3
54719,54719,54720,1,1,0
54720,54720,54721,1,7,6
54721,54721,54722,7,3,-4
54722,54722,54723,3,5,2
54723,54723,54724,5,3,-2
54724,54724,54725,3,8,5
54725,54725,54726,8,8,0
54726,54726,54727,8,3,-5
54727,54727,54728,3,0,-3
54728,54728,54729,0,4,4
54729,54729,54730,4,3,-1
54730,54730,54731,3,7,4
54731,54731,54732,7,7,0
54732,54732,54733,7,6,-1
54733,54733,54734,6,7,1
54734,54734,54735,7,3,-4
54735,54735,54736,3,3,0
54736,54736,54737,3,2,-1
54737,54737,54738,2,9,7
54738,54738,54739,9,3,-6
54739,54739,54740,3,7,4
54740,54740,54741,7,8,1
54741,54741,54742,8,4,-4
54742,54742,54743,4,9,5
54743,54743,54744,9,5,-4
54744,54744,54745,5,4,-1
54745,54745,54746,4,3,-1
54746,54746,54747,3,8,5
54747,54747,54748,8,4,-4
54748,54748,54749,4,8,4
54749,54749,54750,8,5,-3
54750,54750,54751,5,7,2
54751,54751,54752,7,1,-6
54752,54752,54753,1,1,0
54753,54753,54754,1,2,1
54754,54754,54755,2,0,-2
54755,54755,54756,0,2,2
54756,54756,54757,2,8,6
54757,54757,54758,8,2,-6
54758,54758,54759,2,7,5
54759,54759,54760,7,7,0
54760,54760,54761,7,7,0
54761,54761,54762,7,2,-5
54762,54762,54763,2,9,7
54763,54763,54764,9,0,-9
54764,54764,54765,0,2,2
54765,54765,54766,2,9,7
54766,54766,54767,9,3,-6
54767,54767,54768,3,2,-1
54768,54768,54769,2,4,2
54769,54769,54770,4,4,0
54770,54770,54771,4,6,2
54771,54771,54772,6,3,-3
54772,54772,54773,3,1,-2
54773,54773,54774,1,5,4
54774,54774,54775,5,1,-4
54775,54775,54776,1,5,4
54776,54776,54777,5,4,-1
54777,54777,54778,4,4,0
54778,54778,54779,4,5,1
54779,54779,54780,5,3,-2
54780,54780,54781,3,5,2
54781,54781,54782,5,3,-2
54782,54782,54783,3,0,-3
54783,54783,54784,0,1,1
54784,54784,54785,1,4,3
54785,54785,54786,4,1,-3
54786,54786,54787,1,8,7
54787,54787,54788,8,6,-2
54788,54788,54789,6,7,1
54789,54789,54790,7,2,-5
54790,54790,54791,2,4,2
54791,54791,54792,4,7,3
54792,54792,54793,7,9,2
54793,54793,54794,9,2,-7
54794,54794,54795,2,2,0
54795,54795,54796,2,2,0
54796,54796,54797,2,3,1
54797,54797,54798,3,3,0
54798,54798,54799,3,6,3
54799,54799,54800,6,0,-6
54800,54800,54801,0,4,4
54801,54801,54802,4,6,2
54802,54802,54803,6,1,-5
54803,54803,54804,1,0,-1
54804,54804,54805,0,2,2
54805,54805,54806,2,2,0
54806,54806,54807,2,4,2
54807,54807,54808,4,0,-4
54808,54808,54809,0,1,1
54809,54809,54810,1,0,-1
54810,54810,54811,0,5,5
54811,54811,54812,5,0,-5
54812,54812,54813,0,4,4
54813,54813,54814,4,4,0
54814,54814,54815,4,2,-2
54815,54815,54816,2,1,-1
54816,54816,54817,1,0,-1
54817,54817,54818,0,7,7
54818,54818,54819,7,4,-3
54819,54819,54820,4,6,2
54820,54820,54821,6,8,2
54821,54821,54822,8,0,-8
54822,54822,54823,0,6,6
54823,54823,54824,6,1,-5
54824,54824,54825,1,1,0
54825,54825,54826,1,4,3
54826,54826,54827,4,9,5
54827,54827,54828,9,5,-4
54828,54828,54829,5,3,-2
54829,54829,54830,3,6,3
54830,54830,54831,6,2,-4
54831,54831,54832,2,0,-2
54832,54832,54833,0,0,0
54833,54833,54834,0,2,2
54834,54834,54835,2,0,-2
54835,54835,54836,0,0,0
54836,54836,54837,0,2,2
54837,54837,54838,2,2,0
54838,54838,54839,2,5,3
54839,54839,54840,5,2,-3
54840,54840,54841,2,6,4
54841,54841,54842,6,8,2
54842,54842,54843,8,9,1
54843,54843,54844,9,0,-9
54844,54844,54845,0,3,3
54845,54845,54846,3,8,5
54846,54846,54847,8,6,-2
54847,54847,54848,6,2,-4
54848,54848,54849,2,3,1
54849,54849,54850,3,9,6
54850,54850,54851,9,6,-3
54851,54851,54852,6,4,-2
54852,54852,54853,4,0,-4
54853,54853,54854,0,2,2
54854,54854,54855,2,1,-1
54855,54855,54856,1,3,2
54856,54856,54857,3,2,-1
54857,54857,54858,2,3,1
54858,54858,54859,3,3,0
54859,54859,54860,3,9,6
54860,54860,54861,9,4,-5
54861,54861,54862,4,5,1
54862,54862,54863,5,7,2
54863,54863,54864,7,1,-6
54864,54864,54865,1,0,-1
54865,54865,54866,0,2,2
54866,54866,54867,2,3,1
54867,54867,54868,3,5,2
54868,54868,54869,5,4,-1
54869,54869,54870,4,8,4
54870,54870,54871,8,7,-1
54871,54871,54872,7,1,-6
54872,54872,54873,1,0,-1
54873,54873,54874,0,9,9
54874,54874,54875,9,1,-8
54875,54875,54876,1,1,0
54876,54876,54877,1,2,1
54877,54877,54878,2,4,2
54878,54878,54879,4,3,-1
54879,54879,54880,3,5,2
54880,54880,54881,5,4,-1
54881,54881,54882,4,7,3
54882,54882,54883,7,5,-2
54883,54883,54884,5,8,3
54884,54884,54885,8,6,-2
54885,54885,54886,6,1,-5
54886,54886,54887,1,7,6
54887,54887,54888,7,3,-4
54888,54888,54889,3,8,5
54889,54889,54890,8,7,-1
54890,54890,54891,7,7,0
54891,54891,54892,7,3,-4
54892,54892,54893,3,2,-1
54893,54893,54894,2,2,0
54894,54894,54895,2,4,2
54895,54895,54896,4,8,4
54896,54896,54897,8,1,-7
54897,54897,54898,1,3,2
54898,54898,54899,3,4,1
54899,54899,54900,4,0,-4
54900,54900,54901,0,1,1
54901,54901,54902,1,5,4
54902,54902,54903,5,4,-1
54903,54903,54904,4,5,1
54904,54904,54905,5,9,4
54905,54905,54906,9,4,-5
54906,54906,54907,4,6,2
54907,54907,54908,6,2,-4
54908,54908,54909,2,8,6
54909,54909,54910,8,3,-5
54910,54910,54911,3,4,1
54911,54911,54912,4,7,3
54912,54912,54913,7,5,-2
54913,54913,54914,5,5,0
54914,54914,54915,5,3,-2
54915,54915,54916,3,8,5
54916,54916,54917,8,7,-1
54917,54917,54918,7,4,-3
54918,54918,54919,4,8,4
54919,54919,54920,8,8,0
54920,54920,54921,8,4,-4
54921,54921,54922,4,0,-4
54922,54922,54923,0,6,6
54923,54923,54924,6,2,-4
54924,54924,54925,2,7,5
54925,54925,54926,7,8,1
54926,54926,54927,8,0,-8
54927,54927,54928,0,5,5
54928,54928,54929,5,6,1
54929,54929,54930,6,3,-3
54930,54930,54931,3,1,-2
54931,54931,54932,1,5,4
54932,54932,54933,5,6,1
54933,54933,54934,6,5,-1
54934,54934,54935,5,8,3
54935,54935,54936,8,4,-4
54936,54936,54937,4,7,3
54937,54937,54938,7,5,-2
54938,54938,54939,5,0,-5
54939,54939,54940,0,7,7
54940,54940,54941,7,0,-7
54941,54941,54942,0,0,0
54942,54942,54943,0,0,0
54943,54943,54944,0,9,9
54944,54944,54945,9,6,-3
54945,54945,54946,6,1,-5
54946,54946,54947,1,1,0
54947,54947,54948,1,6,5
54948,54948,54949,6,5,-1
54949,54949,54950,5,8,3
54950,54950,54951,8,2,-6
54951,54951,54952,2,3,1
54952,54952,54953,3,3,0
54953,54953,54954,3,8,5
54954,54954,54955,8,9,1
54955,54955,54956,9,2,-7
54956,54956,54957,2,7,5
54957,54957,54958,7,8,1
54958,54958,54959,8,6,-2
54959,54959,54960,6,4,-2
54960,54960,54961,4,9,5
54961,54961,54962,9,9,0
54962,54962,54963,9,1,-8
54963,54963,54964,1,7,6
54964,54964,54965,7,9,2
54965,54965,54966,9,7,-2
54966,54966,54967,7,0,-7
54967,54967,54968,0,1,1
54968,54968,54969,1,6,5
54969,54969,54970,6,5,-1
54970,54970,54971,5,7,2
54971,54971,54972,7,3,-4
54972,54972,54973,3,2,-1
54973,54973,54974,2,1,-1
54974,54974,54975,1,5,4
54975,54975,54976,5,3,-2
54976,54976,54977,3,3,0
54977,54977,54978,3,2,-1
54978,54978,54979,2,1,-1
54979,54979,54980,1,0,-1
54980,54980,54981,0,2,2
54981,54981,54982,2,0,-2
54982,54982,54983,0,3,3
54983,54983,54984,3,9,6
54984,54984,54985,9,0,-9
54985,54985,54986,0,8,8
54986,54986,54987,8,2,-6
54987,54987,54988,2,5,3
54988,54988,54989,5,9,4
54989,54989,54990,9,8,-1
54990,54990,54991,8,4,-4
54991,54991,54992,4,4,0
54992,54992,54993,4,9,5
54993,54993,54994,9,6,-3
54994,54994,54995,6,7,1
54995,54995,54996,7,3,-4
54996,54996,54997,3,0,-3
54997,54997,54998,0,4,4
54998,54998,54999,4,0,-4
54999,54999,55000,0,1,1
55000,55000,55001,1,2,1
55001,55001,55002,2,8,6
55002,55002,55003,8,7,-1
55003,55003,55004,7,4,-3
55004,55004,55005,4,4,0
55005,55005,55006,4,0,-4
55006,55006,55007,0,9,9
55007,55007,55008,9,3,-6
55008,55008,55009,3,9,6
55009,55009,55010,9,5,-4
55010,55010,55011,5,2,-3
55011,55011,55012,2,6,4
55012,55012,55013,6,9,3
55013,55013,55014,9,1,-8
55014,55014,55015,1,8,7
55015,55015,55016,8,6,-2
55016,55016,55017,6,3,-3
55017,55017,55018,3,6,3
55018,55018,55019,6,6,0
55019,55019,55020,6,8,2
55020,55020,55021,8,7,-1
55021,55021,55022,7,8,1
55022,55022,55023,8,0,-8
55023,55023,55024,0,4,4
55024,55024,55025,4,4,0
55025,55025,55026,4,8,4
55026,55026,55027,8,0,-8
55027,55027,55028,0,3,3
55028,55028,55029,3,0,-3
55029,55029,55030,0,0,0
55030,55030,55031,0,1,1
55031,55031,55032,1,2,1
55032,55032,55033,2,2,0
55033,55033,55034,2,7,5
55034,55034,55035,7,3,-4
55035,55035,55036,3,1,-2
55036,55036,55037,1,4,3
55037,55037,55038,4,3,-1
55038,55038,55039,3,6,3
55039,55039,55040,6,2,-4
55040,55040,55041,2,7,5
55041,55041,55042,7,5,-2
55042,55042,55043,5,8,3
55043,55043,55044,8,2,-6
55044,55044,55045,2,0,-2
55045,55045,55046,0,1,1
55046,55046,55047,1,1,0
55047,55047,55048,1,0,-1
55048,55048,55049,0,2,2
55049,55049,55050,2,3,1
55050,55050,55051,3,3,0
55051,55051,55052,3,7,4
55052,55052,55053,7,4,-3
55053,55053,55054,4,3,-1
55054,55054,55055,3,5,2
55055,55055,55056,5,0,-5
55056,55056,55057,0,6,6
55057,55057,55058,6,5,-1
55058,55058,55059,5,7,2
55059,55059,55060,7,5,-2
55060,55060,55061,5,8,3
55061,55061,55062,8,3,-5
55062,55062,55063,3,9,6
55063,55063,55064,9,9,0
55064,55064,55065,9,0,-9
55065,55065,55066,0,6,6
55066,55066,55067,6,1,-5
55067,55067,55068,1,9,8
55068,55068,55069,9,2,-7
55069,55069,55070,2,2,0
55070,55070,55071,2,3,1
55071,55071,55072,3,9,6
55072,55072,55073,9,4,-5
55073,55073,55074,4,4,0
55074,55074,55075,4,5,1
55075,55075,55076,5,5,0
55076,55076,55077,5,6,1
55077,55077,55078,6,7,1
55078,55078,55079,7,7,0
55079,55079,55080,7,1,-6
55080,55080,55081,1,8,7
55081,55081,55082,8,7,-1
55082,55082,55083,7,1,-6
55083,55083,55084,1,7,6
55084,55084,55085,7,4,-3
55085,55085,55086,4,7,3
55086,55086,55087,7,4,-3
55087,55087,55088,4,7,3
55088,55088,55089,7,2,-5
55089,55089,55090,2,7,5
55090,55090,55091,7,3,-4
55091,55091,55092,3,9,6
55092,55092,55093,9,3,-6
55093,55093,55094,3,7,4
55094,55094,55095,7,0,-7
55095,55095,55096,0,6,6
55096,55096,55097,6,9,3
55097,55097,55098,9,4,-5
55098,55098,55099,4,5,1
55099,55099,55100,5,2,-3
55100,55100,55101,2,4,2
55101,55101,55102,4,9,5
55102,55102,55103,9,3,-6
55103,55103,55104,3,3,0
55104,55104,55105,3,0,-3
55105,55105,55106,0,3,3
55106,55106,55107,3,8,5
55107,55107,55108,8,5,-3
55108,55108,55109,5,4,-1
55109,55109,55110,4,0,-4
55110,55110,55111,0,6,6
55111,55111,55112,6,6,0
55112,55112,55113,6,7,1
55113,55113,55114,7,9,2
55114,55114,55115,9,0,-9
55115,55115,55116,0,3,3
55116,55116,55117,3,7,4
55117,55117,55118,7,8,1
55118,55118,55119,8,7,-1
55119,55119,55120,7,9,2
55120,55120,55121,9,1,-8
55121,55121,55122,1,8,7
55122,55122,55123,8,6,-2
55123,55123,55124,6,4,-2
55124,55124,55125,4,9,5
55125,55125,55126,9,9,0
55126,55126,55127,9,1,-8
55127,55127,55128,1,8,7
55128,55128,55129,8,2,-6
55129,55129,55130,2,0,-2
55130,55130,55131,0,9,9
55131,55131,55132,9,8,-1
55132,55132,55133,8,3,-5
55133,55133,55134,3,6,3
55134,55134,55135,6,6,0
55135,55135,55136,6,4,-2
55136,55136,55137,4,2,-2
55137,55137,55138,2,6,4
55138,55138,55139,6,3,-3
55139,55139,55140,3,1,-2
55140,55140,55141,1,4,3
55141,55141,55142,4,1,-3
55142,55142,55143,1,6,5
55143,55143,55144,6,3,-3
55144,55144,55145,3,8,5
55145,55145,55146,8,8,0
55146,55146,55147,8,7,-1
55147,55147,55148,7,5,-2
55148,55148,55149,5,2,-3
55149,55149,55150,2,1,-1
55150,55150,55151,1,3,2
55151,55151,55152,3,0,-3
55152,55152,55153,0,8,8
55153,55153,55154,8,6,-2
55154,55154,55155,6,1,-5
55155,55155,55156,1,8,7
55156,55156,55157,8,2,-6
55157,55157,55158,2,2,0
55158,55158,55159,2,9,7
55159,55159,55160,9,4,-5
55160,55160,55161,4,5,1
55161,55161,55162,5,6,1
55162,55162,55163,6,8,2
55163,55163,55164,8,5,-3
55164,55164,55165,5,8,3
55165,55165,55166,8,6,-2
55166,55166,55167,6,7,1
55167,55167,55168,7,6,-1
55168,55168,55169,6,1,-5
55169,55169,55170,1,2,1
55170,55170,55171,2,7,5
55171,55171,55172,7,2,-5
55172,55172,55173,2,1,-1
55173,55173,55174,1,7,6
55174,55174,55175,7,1,-6
55175,55175,55176,1,2,1
55176,55176,55177,2,0,-2
55177,55177,55178,0,4,4
55178,55178,55179,4,3,-1
55179,55179,55180,3,7,4
55180,55180,55181,7,4,-3
55181,55181,55182,4,8,4
55182,55182,55183,8,2,-6
55183,55183,55184,2,5,3
55184,55184,55185,5,6,1
55185,55185,55186,6,2,-4
55186,55186,55187,2,4,2
55187,55187,55188,4,2,-2
55188,55188,55189,2,7,5
55189,55189,55190,7,3,-4
55190,55190,55191,3,4,1
55191,55191,55192,4,8,4
55192,55192,55193,8,2,-6
55193,55193,55194,2,3,1
55194,55194,55195,3,7,4
55195,55195,55196,7,6,-1
55196,55196,55197,6,4,-2
55197,55197,55198,4,3,-1
55198,55198,55199,3,2,-1
55199,55199,55200,2,9,7
55200,55200,55201,9,9,0
55201,55201,55202,9,2,-7
55202,55202,55203,2,2,0
55203,55203,55204,2,5,3
55204,55204,55205,5,7,2
55205,55205,55206,7,4,-3
55206,55206,55207,4,9,5
55207,55207,55208,9,5,-4
55208,55208,55209,5,2,-3
55209,55209,55210,2,7,5
55210,55210,55211,7,8,1
55211,55211,55212,8,5,-3
55212,55212,55213,5,6,1
55213,55213,55214,6,1,-5
55214,55214,55215,1,1,0
55215,55215,55216,1,7,6
55216,55216,55217,7,0,-7
55217,55217,55218,0,8,8
55218,55218,55219,8,6,-2
55219,55219,55220,6,2,-4
55220,55220,55221,2,8,6
55221,55221,55222,8,1,-7
55222,55222,55223,1,5,4
55223,55223,55224,5,9,4
55224,55224,55225,9,5,-4
55225,55225,55226,5,6,1
55226,55226,55227,6,0,-6
55227,55227,55228,0,2,2
55228,55228,55229,2,5,3
55229,55229,55230,5,6,1
55230,55230,55231,6,3,-3
55231,55231,55232,3,1,-2
55232,55232,55233,1,5,4
55233,55233,55234,5,8,3
55234,55234,55235,8,9,1
55235,55235,55236,9,1,-8
55236,55236,55237,1,7,6
55237,55237,55238,7,7,0
55238,55238,55239,7,4,-3
55239,55239,55240,4,9,5
55240,55240,55241,9,8,-1
55241,55241,55242,8,0,-8
55242,55242,55243,0,9,9
55243,55243,55244,9,7,-2
55244,55244,55245,7,6,-1
55245,55245,55246,6,0,-6
55246,55246,55247,0,9,9
55247,55247,55248,9,5,-4
55248,55248,55249,5,3,-2
55249,55249,55250,3,8,5
55250,55250,55251,8,0,-8
55251,55251,55252,0,6,6
55252,55252,55253,6,0,-6
55253,55253,55254,0,0,0
55254,55254,55255,0,6,6
55255,55255,55256,6,8,2
55256,55256,55257,8,3,-5
55257,55257,55258,3,4,1
55258,55258,55259,4,0,-4
55259,55259,55260,0,5,5
55260,55260,55261,5,5,0
55261,55261,55262,5,1,-4
55262,55262,55263,1,8,7
55263,55263,55264,8,8,0
55264,55264,55265,8,9,1
55265,55265,55266,9,7,-2
55266,55266,55267,7,1,-6
55267,55267,55268,1,8,7
55268,55268,55269,8,8,0
55269,55269,55270,8,7,-1
55270,55270,55271,7,1,-6
55271,55271,55272,1,8,7
55272,55272,55273,8,6,-2
55273,55273,55274,6,6,0
55274,55274,55275,6,0,-6
55275,55275,55276,0,7,7
55276,55276,55277,7,0,-7
55277,55277,55278,0,0,0
55278,55278,55279,0,1,1
55279,55279,55280,1,4,3
55280,55280,55281,4,2,-2
55281,55281,55282,2,4,2
55282,55282,55283,4,3,-1
55283,55283,55284,3,8,5
55284,55284,55285,8,4,-4
55285,55285,55286,4,1,-3
55286,55286,55287,1,5,4
55287,55287,55288,5,0,-5
55288,55288,55289,0,6,6
55289,55289,55290,6,0,-6
55290,55290,55291,0,7,7
55291,55291,55292,7,3,-4
55292,55292,55293,3,8,5
55293,55293,55294,8,4,-4
55294,55294,55295,4,9,5
55295,55295,55296,9,9,0
55296,55296,55297,9,0,-9
55297,55297,55298,0,5,5
55298,55298,55299,5,1,-4
55299,55299,55300,1,2,1
55300,55300,55301,2,3,1
55301,55301,55302,3,0,-3
55302,55302,55303,0,4,4
55303,55303,55304,4,2,-2
55304,55304,55305,2,5,3
55305,55305,55306,5,1,-4
55306,55306,55307,1,6,5
55307,55307,55308,6,2,-4
55308,55308,55309,2,7,5
55309,55309,55310,7,1,-6
55310,55310,55311,1,8,7
55311,55311,55312,8,3,-5
55312,55312,55313,3,9,6
55313,55313,55314,9,6,-3
55314,55314,55315,6,0,-6
55315,55315,55316,0,2,2
55316,55316,55317,2,1,-1
55317,55317,55318,1,4,3
55318,55318,55319,4,2,-2
55319,55319,55320,2,4,2
55320,55320,55321,4,3,-1
55321,55321,55322,3,5,2
55322,55322,55323,5,4,-1
55323,55323,55324,4,1,-3
55324,55324,55325,1,5,4
55325,55325,55326,5,2,-3
55326,55326,55327,2,6,4
55327,55327,55328,6,4,-2
55328,55328,55329,4,7,3
55329,55329,55330,7,8,1
55330,55330,55331,8,8,0
55331,55331,55332,8,4,-4
55332,55332,55333,4,9,5
55333,55333,55334,9,3,-6
55334,55334,55335,3,1,-2
55335,55335,55336,1,3,2
55336,55336,55337,3,4,1
55337,55337,55338,4,1,-3
55338,55338,55339,1,4,3
55339,55339,55340,4,4,0
55340,55340,55341,4,3,-1
55341,55341,55342,3,5,2
55342,55342,55343,5,3,-2
55343,55343,55344,3,7,4
55344,55344,55345,7,0,-7
55345,55345,55346,0,7,7
55346,55346,55347,7,9,2
55347,55347,55348,9,0,-9
55348,55348,55349,0,5,5
55349,55349,55350,5,6,1
55350,55350,55351,6,4,-2
55351,55351,55352,4,2,-2
55352,55352,55353,2,3,1
55353,55353,55354,3,0,-3
55354,55354,55355,0,0,0
55355,55355,55356,0,5,5
55356,55356,55357,5,8,3
55357,55357,55358,8,1,-7
55358,55358,55359,1,4,3
55359,55359,55360,4,2,-2
55360,55360,55361,2,0,-2
55361,55361,55362,0,6,6
55362,55362,55363,6,7,1
55363,55363,55364,7,9,2
55364,55364,55365,9,7,-2
55365,55365,55366,7,0,-7
55366,55366,55367,0,6,6
55367,55367,55368,6,8,2
55368,55368,55369,8,9,1
55369,55369,55370,9,9,0
55370,55370,55371,9,1,-8
55371,55371,55372,1,6,5
55372,55372,55373,6,2,-4
55373,55373,55374,2,7,5
55374,55374,55375,7,9,2
55375,55375,55376,9,5,-4
55376,55376,55377,5,3,-2
55377,55377,55378,3,3,0
55378,55378,55379,3,6,3
55379,55379,55380,6,1,-5
55380,55380,55381,1,2,1
55381,55381,55382,2,6,4
55382,55382,55383,6,3,-3
55383,55383,55384,3,7,4
55384,55384,55385,7,4,-3
55385,55385,55386,4,1,-3
55386,55386,55387,1,6,5
55387,55387,55388,6,5,-1
55388,55388,55389,5,5,0
55389,55389,55390,5,6,1
55390,55390,55391,6,2,-4
55391,55391,55392,2,8,6
55392,55392,55393,8,3,-5
55393,55393,55394,3,5,2
55394,55394,55395,5,8,3
55395,55395,55396,8,5,-3
55396,55396,55397,5,1,-4
55397,55397,55398,1,0,-1
55398,55398,55399,0,2,2
55399,55399,55400,2,0,-2
55400,55400,55401,0,9,9
55401,55401,55402,9,0,-9
55402,55402,55403,0,5,5
55403,55403,55404,5,2,-3
55404,55404,55405,2,8,6
55405,55405,55406,8,9,1
55406,55406,55407,9,8,-1
55407,55407,55408,8,0,-8
55408,55408,55409,0,7,7
55409,55409,55410,7,0,-7
55410,55410,55411,0,1,1
55411,55411,55412,1,1,0
55412,55412,55413,1,7,6
55413,55413,55414,7,5,-2
55414,55414,55415,5,1,-4
55415,55415,55416,1,4,3
55416,55416,55417,4,1,-3
55417,55417,55418,1,4,3
55418,55418,55419,4,3,-1
55419,55419,55420,3,6,3
55420,55420,55421,6,4,-2
55421,55421,55422,4,7,3
55422,55422,55423,7,4,-3
55423,55423,55424,4,4,0
55424,55424,55425,4,7,3
55425,55425,55426,7,7,0
55426,55426,55427,7,4,-3
55427,55427,55428,4,5,1
55428,55428,55429,5,2,-3
55429,55429,55430,2,8,6
55430,55430,55431,8,7,-1
55431,55431,55432,7,3,-4
55432,55432,55433,3,2,-1
55433,55433,55434,2,5,3
55434,55434,55435,5,9,4
55435,55435,55436,9,8,-1
55436,55436,55437,8,2,-6
55437,55437,55438,2,8,6
55438,55438,55439,8,7,-1
55439,55439,55440,7,3,-4
55440,55440,55441,3,9,6
55441,55441,55442,9,5,-4
55442,55442,55443,5,2,-3
55443,55443,55444,2,7,5
55444,55444,55445,7,8,1
55445,55445,55446,8,7,-1
55446,55446,55447,7,6,-1
55447,55447,55448,6,7,1
55448,55448,55449,7,1,-6
55449,55449,55450,1,5,4
55450,55450,55451,5,8,3
55451,55451,55452,8,7,-1
55452,55452,55453,7,5,-2
55453,55453,55454,5,9,4
55454,55454,55455,9,5,-4
55455,55455,55456,5,6,1
55456,55456,55457,6,0,-6
55457,55457,55458,0,6,6
55458,55458,55459,6,5,-1
55459,55459,55460,5,5,0
55460,55460,55461,5,3,-2
55461,55461,55462,3,8,5
55462,55462,55463,8,5,-3
55463,55463,55464,5,9,4
55464,55464,55465,9,9,0
55465,55465,55466,9,7,-2
55466,55466,55467,7,7,0
55467,55467,55468,7,9,2
55468,55468,55469,9,4,-5
55469,55469,55470,4,3,-1
55470,55470,55471,3,8,5
55471,55471,55472,8,3,-5
55472,55472,55473,3,9,6
55473,55473,55474,9,3,-6
55474,55474,55475,3,6,3
55475,55475,55476,6,7,1
55476,55476,55477,7,9,2
55477,55477,55478,9,1,-8
55478,55478,55479,1,0,-1
55479,55479,55480,0,7,7
55480,55480,55481,7,0,-7
55481,55481,55482,0,3,3
55482,55482,55483,3,6,3
55483,55483,55484,6,0,-6
55484,55484,55485,0,3,3
55485,55485,55486,3,7,4
55486,55486,55487,7,0,-7
55487,55487,55488,0,3,3
55488,55488,55489,3,5,2
55489,55489,55490,5,4,-1
55490,55490,55491,4,8,4
55491,55491,55492,8,7,-1
55492,55492,55493,7,9,2
55493,55493,55494,9,7,-2
55494,55494,55495,7,1,-6
55495,55495,55496,1,9,8
55496,55496,55497,9,8,-1
55497,55497,55498,8,5,-3
55498,55498,55499,5,1,-4
55499,55499,55500,1,1,0
55500,55500,55501,1,0,-1
55501,55501,55502,0,1,1
55502,55502,55503,1,0,-1
55503,55503,55504,0,2,2
55504,55504,55505,2,1,-1
55505,55505,55506,1,5,4
55506,55506,55507,5,2,-3
55507,55507,55508,2,2,0
55508,55508,55509,2,3,1
55509,55509,55510,3,9,6
55510,55510,55511,9,4,-5
55511,55511,55512,4,6,2
55512,55512,55513,6,5,-1
55513,55513,55514,5,7,2
55514,55514,55515,7,6,-1
55515,55515,55516,6,4,-2
55516,55516,55517,4,7,3
55517,55517,55518,7,7,0
55518,55518,55519,7,8,1
55519,55519,55520,8,6,-2
55520,55520,55521,6,0,-6
55521,55521,55522,0,4,4
55522,55522,55523,4,1,-3
55523,55523,55524,1,1,0
55524,55524,55525,1,2,1
55525,55525,55526,2,2,0
55526,55526,55527,2,3,1
55527,55527,55528,3,2,-1
55528,55528,55529,2,4,2
55529,55529,55530,4,8,4
55530,55530,55531,8,5,-3
55531,55531,55532,5,4,-1
55532,55532,55533,4,6,2
55533,55533,55534,6,8,2
55534,55534,55535,8,7,-1
55535,55535,55536,7,6,-1
55536,55536,55537,6,8,2
55537,55537,55538,8,4,-4
55538,55538,55539,4,9,5
55539,55539,55540,9,2,-7
55540,55540,55541,2,0,-2
55541,55541,55542,0,2,2
55542,55542,55543,2,1,-1
55543,55543,55544,1,7,6
55544,55544,55545,7,2,-5
55545,55545,55546,2,4,2
55546,55546,55547,4,3,-1
55547,55547,55548,3,3,0
55548,55548,55549,3,4,1
55549,55549,55550,4,3,-1
55550,55550,55551,3,6,3
55551,55551,55552,6,4,-2
55552,55552,55553,4,7,3
55553,55553,55554,7,5,-2
55554,55554,55555,5,8,3
55555,55555,55556,8,0,-8
55556,55556,55557,0,8,8
55557,55557,55558,8,6,-2
55558,55558,55559,6,2,-4
55559,55559,55560,2,7,5
55560,55560,55561,7,6,-1
55561,55561,55562,6,7,1
55562,55562,55563,7,9,2
55563,55563,55564,9,4,-5
55564,55564,55565,4,6,2
55565,55565,55566,6,3,-3
55566,55566,55567,3,1,-2
55567,55567,55568,1,9,8
55568,55568,55569,9,9,0
55569,55569,55570,9,9,0
55570,55570,55571,9,9,0
55571,55571,55572,9,5,-4
55572,55572,55573,5,9,4
55573,55573,55574,9,1,-8
55574,55574,55575,1,4,3
55575,55575,55576,4,0,-4
55576,55576,55577,0,4,4
55577,55577,55578,4,8,4
55578,55578,55579,8,3,-5
55579,55579,55580,3,3,0
55580,55580,55581,3,8,5
55581,55581,55582,8,0,-8
55582,55582,55583,0,1,1
55583,55583,55584,1,6,5
55584,55584,55585,6,4,-2
55585,55585,55586,4,8,4
55586,55586,55587,8,1,-7
55587,55587,55588,1,0,-1
55588,55588,55589,0,2,2
55589,55589,55590,2,6,4
55590,55590,55591,6,5,-1
55591,55591,55592,5,3,-2
55592,55592,55593,3,0,-3
55593,55593,55594,0,1,1
55594,55594,55595,1,9,8
55595,55595,55596,9,1,-8
55596,55596,55597,1,4,3
55597,55597,55598,4,4,0
55598,55598,55599,4,9,5
55599,55599,55600,9,9,0
55600,55600,55601,9,1,-8
55601,55601,55602,1,5,4
55602,55602,55603,5,7,2
55603,55603,55604,7,8,1
55604,55604,55605,8,4,-4
55605,55605,55606,4,8,4
55606,55606,55607,8,4,-4
55607,55607,55608,4,7,3
55608,55608,55609,7,1,-6
55609,55609,55610,1,8,7
55610,55610,55611,8,8,0
55611,55611,55612,8,9,1
55612,55612,55613,9,7,-2
55613,55613,55614,7,8,1
55614,55614,55615,8,6,-2
55615,55615,55616,6,6,0
55616,55616,55617,6,0,-6
55617,55617,55618,0,8,8
55618,55618,55619,8,8,0
55619,55619,55620,8,8,0
55620,55620,55621,8,1,-7
55621,55621,55622,1,0,-1
55622,55622,55623,0,8,8
55623,55623,55624,8,0,-8
55624,55624,55625,0,2,2
55625,55625,55626,2,6,4
55626,55626,55627,6,6,0
55627,55627,55628,6,3,-3
55628,55628,55629,3,2,-1
55629,55629,55630,2,4,2
55630,55630,55631,4,0,-4
55631,55631,55632,0,8,8
55632,55632,55633,8,9,1
55633,55633,55634,9,1,-8
55634,55634,55635,1,1,0
55635,55635,55636,1,9,8
55636,55636,55637,9,2,-7
55637,55637,55638,2,6,4
55638,55638,55639,6,5,-1
55639,55639,55640,5,3,-2
55640,55640,55641,3,4,1
55641,55641,55642,4,9,5
55642,55642,55643,9,5,-4
55643,55643,55644,5,1,-4
55644,55644,55645,1,6,5
55645,55645,55646,6,0,-6
55646,55646,55647,0,7,7
55647,55647,55648,7,9,2
55648,55648,55649,9,3,-6
55649,55649,55650,3,8,5
55650,55650,55651,8,0,-8
55651,55651,55652,0,9,9
55652,55652,55653,9,2,-7
55653,55653,55654,2,4,2
55654,55654,55655,4,2,-2
55655,55655,55656,2,0,-2
55656,55656,55657,0,2,2
55657,55657,55658,2,4,2
55658,55658,55659,4,7,3
55659,55659,55660,7,6,-1
55660,55660,55661,6,5,-1
55661,55661,55662,5,2,-3
55662,55662,55663,2,0,-2
55663,55663,55664,0,0,0
55664,55664,55665,0,3,3
55665,55665,55666,3,0,-3
55666,55666,55667,0,5,5
55667,55667,55668,5,7,2
55668,55668,55669,7,2,-5
55669,55669,55670,2,6,4
55670,55670,55671,6,1,-5
55671,55671,55672,1,5,4
55672,55672,55673,5,4,-1
55673,55673,55674,4,8,4
55674,55674,55675,8,4,-4
55675,55675,55676,4,4,0
55676,55676,55677,4,3,-1
55677,55677,55678,3,2,-1
55678,55678,55679,2,0,-2
55679,55679,55680,0,0,0
55680,55680,55681,0,0,0
55681,55681,55682,0,0,0
55682,55682,55683,0,8,8
55683,55683,55684,8,4,-4
55684,55684,55685,4,5,1
55685,55685,55686,5,1,-4
55686,55686,55687,1,4,3
55687,55687,55688,4,3,-1
55688,55688,55689,3,7,4
55689,55689,55690,7,4,-3
55690,55690,55691,4,9,5
55691,55691,55692,9,2,-7
55692,55692,55693,2,7,5
55693,55693,55694,7,3,-4
55694,55694,55695,3,8,5
55695,55695,55696,8,8,0
55696,55696,55697,8,8,0
55697,55697,55698,8,3,-5
55698,55698,55699,3,7,4
55699,55699,55700,7,7,0
55700,55700,55701,7,9,2
55701,55701,55702,9,9,0
55702,55702,55703,9,6,-3
55703,55703,55704,6,2,-4
55704,55704,55705,2,3,1
55705,55705,55706,3,8,5
55706,55706,55707,8,1,-7
55707,55707,55708,1,5,4
55708,55708,55709,5,7,2
55709,55709,55710,7,1,-6
55710,55710,55711,1,9,8
55711,55711,55712,9,5,-4
55712,55712,55713,5,6,1
55713,55713,55714,6,1,-5
55714,55714,55715,1,3,2
55715,55715,55716,3,1,-2
55716,55716,55717,1,3,2
55717,55717,55718,3,5,2
55718,55718,55719,5,1,-4
55719,55719,55720,1,6,5
55720,55720,55721,6,0,-6
55721,55721,55722,0,5,5
55722,55722,55723,5,2,-3
55723,55723,55724,2,7,5
55724,55724,55725,7,6,-1
55725,55725,55726,6,3,-3
55726,55726,55727,3,0,-3
55727,55727,55728,0,5,5
55728,55728,55729,5,5,0
55729,55729,55730,5,9,4
55730,55730,55731,9,6,-3
55731,55731,55732,6,3,-3
55732,55732,55733,3,8,5
55733,55733,55734,8,5,-3
55734,55734,55735,5,7,2
55735,55735,55736,7,4,-3
55736,55736,55737,4,3,-1
55737,55737,55738,3,6,3
55738,55738,55739,6,5,-1
55739,55739,55740,5,1,-4
55740,55740,55741,1,8,7
55741,55741,55742,8,6,-2
55742,55742,55743,6,3,-3
55743,55743,55744,3,7,4
55744,55744,55745,7,0,-7
55745,55745,55746,0,3,3
55746,55746,55747,3,1,-2
55747,55747,55748,1,5,4
55748,55748,55749,5,2,-3
55749,55749,55750,2,7,5
55750,55750,55751,7,3,-4
55751,55751,55752,3,0,-3
55752,55752,55753,0,4,4
55753,55753,55754,4,6,2
55754,55754,55755,6,5,-1
55755,55755,55756,5,7,2
55756,55756,55757,7,6,-1
55757,55757,55758,6,3,-3
55758,55758,55759,3,7,4
55759,55759,55760,7,6,-1
55760,55760,55761,6,8,2
55761,55761,55762,8,8,0
55762,55762,55763,8,9,1
55763,55763,55764,9,8,-1
55764,55764,55765,8,0,-8
55765,55765,55766,0,8,8
55766,55766,55767,8,1,-7
55767,55767,55768,1,1,0
55768,55768,55769,1,2,1
55769,55769,55770,2,6,4
55770,55770,55771,6,3,-3
55771,55771,55772,3,8,5
55772,55772,55773,8,4,-4
55773,55773,55774,4,4,0
55774,55774,55775,4,5,1
55775,55775,55776,5,4,-1
55776,55776,55777,4,6,2
55777,55777,55778,6,9,3
55778,55778,55779,9,7,-2
55779,55779,55780,7,9,2
55780,55780,55781,9,8,-1
55781,55781,55782,8,2,-6
55782,55782,55783,2,9,7
55783,55783,55784,9,1,-8
55784,55784,55785,1,0,-1
55785,55785,55786,0,1,1
55786,55786,55787,1,1,0
55787,55787,55788,1,4,3
55788,55788,55789,4,2,-2
55789,55789,55790,2,8,6
55790,55790,55791,8,3,-5
55791,55791,55792,3,9,6
55792,55792,55793,9,4,-5
55793,55793,55794,4,5,1
55794,55794,55795,5,5,0
55795,55795,55796,5,3,-2
55796,55796,55797,3,6,3
55797,55797,55798,6,6,0
55798,55798,55799,6,7,1
55799,55799,55800,7,5,-2
55800,55800,55801,5,8,3
55801,55801,55802,8,7,-1
55802,55802,55803,7,9,2
55803,55803,55804,9,5,-4
55804,55804,55805,5,0,-5
55805,55805,55806,0,0,0
55806,55806,55807,0,8,8
55807,55807,55808,8,2,-6
55808,55808,55809,2,7,5
55809,55809,55810,7,4,-3
55810,55810,55811,4,8,4
55811,55811,55812,8,4,-4
55812,55812,55813,4,9,5
55813,55813,55814,9,9,0
55814,55814,55815,9,9,0
55815,55815,55816,9,2,-7
55816,55816,55817,2,0,-2
55817,55817,55818,0,5,5
55818,55818,55819,5,1,-4
55819,55819,55820,1,6,5
55820,55820,55821,6,4,-2
55821,55821,55822,4,0,-4
55822,55822,55823,0,5,5
55823,55823,55824,5,6,1
55824,55824,55825,6,1,-5
55825,55825,55826,1,7,6
55826,55826,55827,7,6,-1
55827,55827,55828,6,4,-2
55828,55828,55829,4,7,3
55829,55829,55830,7,0,-7
55830,55830,55831,0,3,3
55831,55831,55832,3,1,-2
55832,55832,55833,1,2,1
55833,55833,55834,2,9,7
55834,55834,55835,9,9,0
55835,55835,55836,9,2,-7
55836,55836,55837,2,0,-2
55837,55837,55838,0,5,5
55838,55838,55839,5,5,0
55839,55839,55840,5,0,-5
55840,55840,55841,0,6,6
55841,55841,55842,6,7,1
55842,55842,55843,7,7,0
55843,55843,55844,7,3,-4
55844,55844,55845,3,3,0
55845,55845,55846,3,1,-2
55846,55846,55847,1,9,8
55847,55847,55848,9,7,-2
55848,55848,55849,7,9,2
55849,55849,55850,9,9,0
55850,55850,55851,9,3,-6
55851,55851,55852,3,8,5
55852,55852,55853,8,8,0
55853,55853,55854,8,7,-1
55854,55854,55855,7,1,-6
55855,55855,55856,1,9,8
55856,55856,55857,9,2,-7
55857,55857,55858,2,3,1
55858,55858,55859,3,9,6
55859,55859,55860,9,4,-5
55860,55860,55861,4,6,2
55861,55861,55862,6,2,-4
55862,55862,55863,2,7,5
55863,55863,55864,7,3,-4
55864,55864,55865,3,5,2
55865,55865,55866,5,3,-2
55866,55866,55867,3,6,3
55867,55867,55868,6,8,2
55868,55868,55869,8,3,-5
55869,55869,55870,3,1,-2
55870,55870,55871,1,5,4
55871,55871,55872,5,4,-1
55872,55872,55873,4,0,-4
55873,55873,55874,0,3,3
55874,55874,55875,3,5,2
55875,55875,55876,5,3,-2
55876,55876,55877,3,4,1
55877,55877,55878,4,5,1
55878,55878,55879,5,0,-5
55879,55879,55880,0,8,8
55880,55880,55881,8,3,-5
55881,55881,55882,3,7,4
55882,55882,55883,7,4,-3
55883,55883,55884,4,9,5
55884,55884,55885,9,7,-2
55885,55885,55886,7,5,-2
55886,55886,55887,5,7,2
55887,55887,55888,7,1,-6
55888,55888,55889,1,9,8
55889,55889,55890,9,0,-9
55890,55890,55891,0,4,4
55891,55891,55892,4,0,-4
55892,55892,55893,0,3,3
55893,55893,55894,3,5,2
55894,55894,55895,5,7,2
55895,55895,55896,7,7,0
55896,55896,55897,7,6,-1
55897,55897,55898,6,4,-2
55898,55898,55899,4,2,-2
55899,55899,55900,2,6,4
55900,55900,55901,6,1,-5
55901,55901,55902,1,5,4
55902,55902,55903,5,5,0
55903,55903,55904,5,6,1
55904,55904,55905,6,5,-1
55905,55905,55906,5,2,-3
55906,55906,55907,2,0,-2
55907,55907,55908,0,5,5
55908,55908,55909,5,5,0
55909,55909,55910,5,5,0
55910,55910,55911,5,0,-5
55911,55911,55912,0,2,2
55912,55912,55913,2,6,4
55913,55913,55914,6,3,-3
55914,55914,55915,3,7,4
55915,55915,55916,7,7,0
55916,55916,55917,7,0,-7
55917,55917,55918,0,7,7
55918,55918,55919,7,2,-5
55919,55919,55920,2,1,-1
55920,55920,55921,1,9,8
55921,55921,55922,9,0,-9
55922,55922,55923,0,3,3
55923,55923,55924,3,4,1
55924,55924,55925,4,4,0
55925,55925,55926,4,3,-1
55926,55926,55927,3,4,1
55927,55927,55928,4,7,3
55928,55928,55929,7,8,1
55929,55929,55930,8,4,-4
55930,55930,55931,4,1,-3
55931,55931,55932,1,3,2
55932,55932,55933,3,2,-1
55933,55933,55934,2,7,5
55934,55934,55935,7,2,-5
55935,55935,55936,2,6,4
55936,55936,55937,6,3,-3
55937,55937,55938,3,9,6
55938,55938,55939,9,1,-8
55939,55939,55940,1,8,7
55940,55940,55941,8,3,-5
55941,55941,55942,3,6,3
55942,55942,55943,6,6,0
55943,55943,55944,6,4,-2
55944,55944,55945,4,7,3
55945,55945,55946,7,8,1
55946,55946,55947,8,3,-5
55947,55947,55948,3,4,1
55948,55948,55949,4,9,5
55949,55949,55950,9,2,-7
55950,55950,55951,2,6,4
55951,55951,55952,6,2,-4
55952,55952,55953,2,5,3
55953,55953,55954,5,4,-1
55954,55954,55955,4,1,-3
55955,55955,55956,1,6,5
55956,55956,55957,6,9,3
55957,55957,55958,9,5,-4
55958,55958,55959,5,8,3
55959,55959,55960,8,3,-5
55960,55960,55961,3,1,-2
55961,55961,55962,1,3,2
55962,55962,55963,3,1,-2
55963,55963,55964,1,4,3
55964,55964,55965,4,5,1
55965,55965,55966,5,3,-2
55966,55966,55967,3,0,-3
55967,55967,55968,0,8,8
55968,55968,55969,8,2,-6
55969,55969,55970,2,9,7
55970,55970,55971,9,7,-2
55971,55971,55972,7,2,-5
55972,55972,55973,2,8,6
55973,55973,55974,8,3,-5
55974,55974,55975,3,6,3
55975,55975,55976,6,4,-2
55976,55976,55977,4,6,2
55977,55977,55978,6,9,3
55978,55978,55979,9,8,-1
55979,55979,55980,8,5,-3
55980,55980,55981,5,4,-1
55981,55981,55982,4,2,-2
55982,55982,55983,2,4,2
55983,55983,55984,4,6,2
55984,55984,55985,6,2,-4
55985,55985,55986,2,0,-2
55986,55986,55987,0,2,2
55987,55987,55988,2,1,-1
55988,55988,55989,1,8,7
55989,55989,55990,8,4,-4
55990,55990,55991,4,0,-4
55991,55991,55992,0,9,9
55992,55992,55993,9,0,-9
55993,55993,55994,0,6,6
55994,55994,55995,6,1,-5
55995,55995,55996,1,2,1
55996,55996,55997,2,2,0
55997,55997,55998,2,3,1
55998,55998,55999,3,3,0
55999,55999,56000,3,1,-2
56000,56000,56001,1,8,7
56001,56001,56002,8,5,-3
56002,56002,56003,5,9,4
56003,56003,56004,9,8,-1
56004,56004,56005,8,0,-8
56005,56005,56006,0,3,3
56006,56006,56007,3,1,-2
56007,56007,56008,1,3,2
56008,56008,56009,3,2,-1
56009,56009,56010,2,1,-1
56010,56010,56011,1,4,3
56011,56011,56012,4,3,-1
56012,56012,56013,3,5,2
56013,56013,56014,5,5,0
56014,56014,56015,5,6,1
56015,56015,56016,6,1,-5
56016,56016,56017,1,7,6
56017,56017,56018,7,9,2
56018,56018,56019,9,8,-1
56019,56019,56020,8,1,-7
56020,56020,56021,1,9,8
56021,56021,56022,9,6,-3
56022,56022,56023,6,0,-6
56023,56023,56024,0,5,5
56024,56024,56025,5,1,-4
56025,56025,56026,1,8,7
56026,56026,56027,8,2,-6
56027,56027,56028,2,7,5
56028,56028,56029,7,3,-4
56029,56029,56030,3,7,4
56030,56030,56031,7,4,-3
56031,56031,56032,4,5,1
56032,56032,56033,5,5,0
56033,56033,56034,5,7,2
56034,56034,56035,7,6,-1
56035,56035,56036,6,5,-1
56036,56036,56037,5,7,2
56037,56037,56038,7,5,-2
56038,56038,56039,5,8,3
56039,56039,56040,8,2,-6
56040,56040,56041,2,9,7
56041,56041,56042,9,7,-2
56042,56042,56043,7,3,-4
56043,56043,56044,3,6,3
56044,56044,56045,6,5,-1
56045,56045,56046,5,1,-4
56046,56046,56047,1,3,2
56047,56047,56048,3,1,-2
56048,56048,56049,1,2,1
56049,56049,56050,2,0,-2
56050,56050,56051,0,9,9
56051,56051,56052,9,7,-2
56052,56052,56053,7,3,-4
56053,56053,56054,3,5,2
56054,56054,56055,5,2,-3
56055,56055,56056,2,8,6
56056,56056,56057,8,1,-7
56057,56057,56058,1,7,6
56058,56058,56059,7,4,-3
56059,56059,56060,4,4,0
56060,56060,56061,4,5,1
56061,56061,56062,5,9,4
56062,56062,56063,9,5,-4
56063,56063,56064,5,7,2
56064,56064,56065,7,2,-5
56065,56065,56066,2,7,5
56066,56066,56067,7,3,-4
56067,56067,56068,3,8,5
56068,56068,56069,8,2,-6
56069,56069,56070,2,8,6
56070,56070,56071,8,1,-7
56071,56071,56072,1,4,3
56072,56072,56073,4,3,-1
56073,56073,56074,3,7,4
56074,56074,56075,7,9,2
56075,56075,56076,9,7,-2
56076,56076,56077,7,7,0
56077,56077,56078,7,9,2
56078,56078,56079,9,2,-7
56079,56079,56080,2,4,2
56080,56080,56081,4,1,-3
56081,56081,56082,1,8,7
56082,56082,56083,8,2,-6
56083,56083,56084,2,4,2
56084,56084,56085,4,8,4
56085,56085,56086,8,7,-1
56086,56086,56087,7,9,2
56087,56087,56088,9,2,-7
56088,56088,56089,2,1,-1
56089,56089,56090,1,9,8
56090,56090,56091,9,8,-1
56091,56091,56092,8,9,1
56092,56092,56093,9,8,-1
56093,56093,56094,8,4,-4
56094,56094,56095,4,7,3
56095,56095,56096,7,7,0
56096,56096,56097,7,8,1
56097,56097,56098,8,6,-2
56098,56098,56099,6,1,-5
56099,56099,56100,1,2,1
56100,56100,56101,2,0,-2
56101,56101,56102,0,9,9
56102,56102,56103,9,0,-9
56103,56103,56104,0,2,2
56104,56104,56105,2,6,4
56105,56105,56106,6,4,-2
56106,56106,56107,4,7,3
56107,56107,56108,7,5,-2
56108,56108,56109,5,7,2
56109,56109,56110,7,1,-6
56110,56110,56111,1,7,6
56111,56111,56112,7,7,0
56112,56112,56113,7,5,-2
56113,56113,56114,5,1,-4
56114,56114,56115,1,6,5
56115,56115,56116,6,5,-1
56116,56116,56117,5,1,-4
56117,56117,56118,1,9,8
56118,56118,56119,9,5,-4
56119,56119,56120,5,2,-3
56120,56120,56121,2,7,5
56121,56121,56122,7,4,-3
56122,56122,56123,4,1,-3
56123,56123,56124,1,0,-1
56124,56124,56125,0,2,2
56125,56125,56126,2,8,6
56126,56126,56127,8,5,-3
56127,56127,56128,5,5,0
56128,56128,56129,5,0,-5
56129,56129,56130,0,6,6
56130,56130,56131,6,7,1
56131,56131,56132,7,7,0
56132,56132,56133,7,9,2
56133,56133,56134,9,3,-6
56134,56134,56135,3,9,6
56135,56135,56136,9,3,-6
56136,56136,56137,3,0,-3
56137,56137,56138,0,1,1
56138,56138,56139,1,3,2
56139,56139,56140,3,0,-3
56140,56140,56141,0,8,8
56141,56141,56142,8,4,-4
56142,56142,56143,4,4,0
56143,56143,56144,4,6,2
56144,56144,56145,6,8,2
56145,56145,56146,8,4,-4
56146,56146,56147,4,4,0
56147,56147,56148,4,6,2
56148,56148,56149,6,1,-5
56149,56149,56150,1,4,3
56150,56150,56151,4,8,4
56151,56151,56152,8,9,1
56152,56152,56153,9,6,-3
56153,56153,56154,6,2,-4
56154,56154,56155,2,5,3
56155,56155,56156,5,9,4
56156,56156,56157,9,9,0
56157,56157,56158,9,0,-9
56158,56158,56159,0,0,0
56159,56159,56160,0,7,7
56160,56160,56161,7,0,-7
56161,56161,56162,0,6,6
56162,56162,56163,6,0,-6
56163,56163,56164,0,3,3
56164,56164,56165,3,3,0
56165,56165,56166,3,9,6
56166,56166,56167,9,7,-2
56167,56167,56168,7,2,-5
56168,56168,56169,2,1,-1
56169,56169,56170,1,8,7
56170,56170,56171,8,6,-2
56171,56171,56172,6,6,0
56172,56172,56173,6,4,-2
56173,56173,56174,4,0,-4
56174,56174,56175,0,2,2
56175,56175,56176,2,0,-2
56176,56176,56177,0,6,6
56177,56177,56178,6,9,3
56178,56178,56179,9,6,-3
56179,56179,56180,6,8,2
56180,56180,56181,8,0,-8
56181,56181,56182,0,6,6
56182,56182,56183,6,4,-2
56183,56183,56184,4,4,0
56184,56184,56185,4,5,1
56185,56185,56186,5,6,1
56186,56186,56187,6,4,-2
56187,56187,56188,4,2,-2
56188,56188,56189,2,1,-1
56189,56189,56190,1,4,3
56190,56190,56191,4,3,-1
56191,56191,56192,3,1,-2
56192,56192,56193,1,8,7
56193,56193,56194,8,8,0
56194,56194,56195,8,6,-2
56195,56195,56196,6,7,1
56196,56196,56197,7,3,-4
56197,56197,56198,3,3,0
56198,56198,56199,3,9,6
56199,56199,56200,9,5,-4
56200,56200,56201,5,9,4
56201,56201,56202,9,5,-4
56202,56202,56203,5,5,0
56203,56203,56204,5,3,-2
56204,56204,56205,3,9,6
56205,56205,56206,9,5,-4
56206,56206,56207,5,3,-2
56207,56207,56208,3,1,-2
56208,56208,56209,1,7,6
56209,56209,56210,7,6,-1
56210,56210,56211,6,6,0
56211,56211,56212,6,9,3
56212,56212,56213,9,2,-7
56213,56213,56214,2,5,3
56214,56214,56215,5,2,-3
56215,56215,56216,2,9,7
56216,56216,56217,9,0,-9
56217,56217,56218,0,7,7
56218,56218,56219,7,0,-7
56219,56219,56220,0,7,7
56220,56220,56221,7,1,-6
56221,56221,56222,1,2,1
56222,56222,56223,2,2,0
56223,56223,56224,2,5,3
56224,56224,56225,5,3,-2
56225,56225,56226,3,1,-2
56226,56226,56227,1,4,3
56227,56227,56228,4,3,-1
56228,56228,56229,3,5,2
56229,56229,56230,5,9,4
56230,56230,56231,9,6,-3
56231,56231,56232,6,6,0
56232,56232,56233,6,7,1
56233,56233,56234,7,3,-4
56234,56234,56235,3,8,5
56235,56235,56236,8,0,-8
56236,56236,56237,0,9,9
56237,56237,56238,9,9,0
56238,56238,56239,9,0,-9
56239,56239,56240,0,6,6
56240,56240,56241,6,1,-5
56241,56241,56242,1,9,8
56242,56242,56243,9,2,-7
56243,56243,56244,2,4,2
56244,56244,56245,4,3,-1
56245,56245,56246,3,5,2
56246,56246,56247,5,4,-1
56247,56247,56248,4,0,-4
56248,56248,56249,0,5,5
56249,56249,56250,5,8,3
56250,56250,56251,8,6,-2
56251,56251,56252,6,1,-5
56252,56252,56253,1,7,6
56253,56253,56254,7,8,1
56254,56254,56255,8,8,0
56255,56255,56256,8,0,-8
56256,56256,56257,0,9,9
56257,56257,56258,9,4,-5
56258,56258,56259,4,0,-4
56259,56259,56260,0,3,3
56260,56260,56261,3,1,-2
56261,56261,56262,1,5,4
56262,56262,56263,5,2,-3
56263,56263,56264,2,2,0
56264,56264,56265,2,3,1
56265,56265,56266,3,7,4
56266,56266,56267,7,4,-3
56267,56267,56268,4,4,0
56268,56268,56269,4,5,1
56269,56269,56270,5,9,4
56270,56270,56271,9,9,0
56271,56271,56272,9,7,-2
56272,56272,56273,7,1,-6
56273,56273,56274,1,7,6
56274,56274,56275,7,3,-4
56275,56275,56276,3,4,1
56276,56276,56277,4,5,1
56277,56277,56278,5,1,-4
56278,56278,56279,1,9,8
56279,56279,56280,9,4,-5
56280,56280,56281,4,4,0
56281,56281,56282,4,2,-2
56282,56282,56283,2,1,-1
56283,56283,56284,1,8,7
56284,56284,56285,8,7,-1
56285,56285,56286,7,8,1
56286,56286,56287,8,7,-1
56287,56287,56288,7,3,-4
56288,56288,56289,3,2,-1
56289,56289,56290,2,8,6
56290,56290,56291,8,1,-7
56291,56291,56292,1,9,8
56292,56292,56293,9,4,-5
56293,56293,56294,4,7,3
56294,56294,56295,7,8,1
56295,56295,56296,8,8,0
56296,56296,56297,8,3,-5
56297,56297,56298,3,2,-1
56298,56298,56299,2,8,6
56299,56299,56300,8,9,1
56300,56300,56301,9,2,-7
56301,56301,56302,2,4,2
56302,56302,56303,4,9,5
56303,56303,56304,9,9,0
56304,56304,56305,9,3,-6
56305,56305,56306,3,5,2
56306,56306,56307,5,8,3
56307,56307,56308,8,1,-7
56308,56308,56309,1,5,4
56309,56309,56310,5,5,0
56310,56310,56311,5,4,-1
56311,56311,56312,4,2,-2
56312,56312,56313,2,8,6
56313,56313,56314,8,5,-3
56314,56314,56315,5,8,3
56315,56315,56316,8,4,-4
56316,56316,56317,4,9,5
56317,56317,56318,9,0,-9
56318,56318,56319,0,4,4
56319,56319,56320,4,4,0
56320,56320,56321,4,3,-1
56321,56321,56322,3,8,5
56322,56322,56323,8,9,1
56323,56323,56324,9,3,-6
56324,56324,56325,3,2,-1
56325,56325,56326,2,1,-1
56326,56326,56327,1,5,4
56327,56327,56328,5,1,-4
56328,56328,56329,1,7,6
56329,56329,56330,7,4,-3
56330,56330,56331,4,4,0
56331,56331,56332,4,0,-4
56332,56332,56333,0,1,1
56333,56333,56334,1,4,3
56334,56334,56335,4,2,-2
56335,56335,56336,2,1,-1
56336,56336,56337,1,3,2
56337,56337,56338,3,1,-2
56338,56338,56339,1,5,4
56339,56339,56340,5,2,-3
56340,56340,56341,2,9,7
56341,56341,56342,9,6,-3
56342,56342,56343,6,1,-5
56343,56343,56344,1,5,4
56344,56344,56345,5,6,1
56345,56345,56346,6,7,1
56346,56346,56347,7,0,-7
56347,56347,56348,0,9,9
56348,56348,56349,9,1,-8
56349,56349,56350,1,4,3
56350,56350,56351,4,0,-4
56351,56351,56352,0,0,0
56352,56352,56353,0,0,0
56353,56353,56354,0,7,7
56354,56354,56355,7,2,-5
56355,56355,56356,2,7,5
56356,56356,56357,7,8,1
56357,56357,56358,8,6,-2
56358,56358,56359,6,7,1
56359,56359,56360,7,5,-2
56360,56360,56361,5,2,-3
56361,56361,56362,2,0,-2
56362,56362,56363,0,5,5
56363,56363,56364,5,4,-1
56364,56364,56365,4,1,-3
56365,56365,56366,1,5,4
56366,56366,56367,5,1,-4
56367,56367,56368,1,5,4
56368,56368,56369,5,8,3
56369,56369,56370,8,5,-3
56370,56370,56371,5,5,0
56371,56371,56372,5,2,-3
56372,56372,56373,2,6,4
56373,56373,56374,6,1,-5
56374,56374,56375,1,4,3
56375,56375,56376,4,4,0
56376,56376,56377,4,0,-4
56377,56377,56378,0,8,8
56378,56378,56379,8,4,-4
56379,56379,56380,4,4,0
56380,56380,56381,4,7,3
56381,56381,56382,7,7,0
56382,56382,56383,7,3,-4
56383,56383,56384,3,1,-2
56384,56384,56385,1,6,5
56385,56385,56386,6,8,2
56386,56386,56387,8,8,0
56387,56387,56388,8,0,-8
56388,56388,56389,0,0,0
56389,56389,56390,0,7,7
56390,56390,56391,7,3,-4
56391,56391,56392,3,7,4
56392,56392,56393,7,7,0
56393,56393,56394,7,2,-5
56394,56394,56395,2,4,2
56395,56395,56396,4,8,4
56396,56396,56397,8,0,-8
56397,56397,56398,0,3,3
56398,56398,56399,3,6,3
56399,56399,56400,6,4,-2
56400,56400,56401,4,9,5
56401,56401,56402,9,8,-1
56402,56402,56403,8,2,-6
56403,56403,56404,2,0,-2
56404,56404,56405,0,6,6
56405,56405,56406,6,4,-2
56406,56406,56407,4,5,1
56407,56407,56408,5,9,4
56408,56408,56409,9,8,-1
56409,56409,56410,8,7,-1
56410,56410,56411,7,6,-1
56411,56411,56412,6,8,2
56412,56412,56413,8,9,1
56413,56413,56414,9,9,0
56414,56414,56415,9,0,-9
56415,56415,56416,0,7,7
56416,56416,56417,7,4,-3
56417,56417,56418,4,7,3
56418,56418,56419,7,0,-7
56419,56419,56420,0,3,3
56420,56420,56421,3,6,3
56421,56421,56422,6,4,-2
56422,56422,56423,4,1,-3
56423,56423,56424,1,0,-1
56424,56424,56425,0,9,9
56425,56425,56426,9,7,-2
56426,56426,56427,7,2,-5
56427,56427,56428,2,8,6
56428,56428,56429,8,0,-8
56429,56429,56430,0,8,8
56430,56430,56431,8,9,1
56431,56431,56432,9,7,-2
56432,56432,56433,7,5,-2
56433,56433,56434,5,3,-2
56434,56434,56435,3,1,-2
56435,56435,56436,1,0,-1
56436,56436,56437,0,3,3
56437,56437,56438,3,7,4
56438,56438,56439,7,7,0
56439,56439,56440,7,4,-3
56440,56440,56441,4,6,2
56441,56441,56442,6,9,3
56442,56442,56443,9,9,0
56443,56443,56444,9,0,-9
56444,56444,56445,0,4,4
56445,56445,56446,4,6,2
56446,56446,56447,6,8,2
56447,56447,56448,8,3,-5
56448,56448,56449,3,3,0
56449,56449,56450,3,0,-3
56450,56450,56451,0,7,7
56451,56451,56452,7,4,-3
56452,56452,56453,4,7,3
56453,56453,56454,7,0,-7
56454,56454,56455,0,6,6
56455,56455,56456,6,1,-5
56456,56456,56457,1,3,2
56457,56457,56458,3,9,6
56458,56458,56459,9,0,-9
56459,56459,56460,0,0,0
56460,56460,56461,0,5,5
56461,56461,56462,5,7,2
56462,56462,56463,7,6,-1
56463,56463,56464,6,9,3
56464,56464,56465,9,2,-7
56465,56465,56466,2,9,7
56466,56466,56467,9,2,-7
56467,56467,56468,2,5,3
56468,56468,56469,5,0,-5
56469,56469,56470,0,1,1
56470,56470,56471,1,1,0
56471,56471,56472,1,7,6
56472,56472,56473,7,2,-5
56473,56473,56474,2,3,1
56474,56474,56475,3,3,0
56475,56475,56476,3,5,2
56476,56476,56477,5,4,-1
56477,56477,56478,4,9,5
56478,56478,56479,9,5,-4
56479,56479,56480,5,9,4
56480,56480,56481,9,6,-3
56481,56481,56482,6,7,1
56482,56482,56483,7,7,0
56483,56483,56484,7,4,-3
56484,56484,56485,4,8,4
56485,56485,56486,8,9,1
56486,56486,56487,9,9,0
56487,56487,56488,9,3,-6
56488,56488,56489,3,0,-3
56489,56489,56490,0,1,1
56490,56490,56491,1,1,0
56491,56491,56492,1,3,2
56492,56492,56493,3,2,-1
56493,56493,56494,2,9,7
56494,56494,56495,9,3,-6
56495,56495,56496,3,4,1
56496,56496,56497,4,4,0
56497,56497,56498,4,2,-2
56498,56498,56499,2,5,3
56499,56499,56500,5,7,2
56500,56500,56501,7,6,-1
56501,56501,56502,6,8,2
56502,56502,56503,8,7,-1
56503,56503,56504,7,3,-4
56504,56504,56505,3,8,5
56505,56505,56506,8,1,-7
56506,56506,56507,1,9,8
56507,56507,56508,9,2,-7
56508,56508,56509,2,0,-2
56509,56509,56510,0,7,7
56510,56510,56511,7,1,-6
56511,56511,56512,1,0,-1
56512,56512,56513,0,2,2
56513,56513,56514,2,2,0
56514,56514,56515,2,3,1
56515,56515,56516,3,4,1
56516,56516,56517,4,5,1
56517,56517,56518,5,7,2
56518,56518,56519,7,6,-1
56519,56519,56520,6,6,0
56520,56520,56521,6,7,1
56521,56521,56522,7,0,-7
56522,56522,56523,0,8,8
56523,56523,56524,8,3,-5
56524,56524,56525,3,8,5
56525,56525,56526,8,6,-2
56526,56526,56527,6,9,3
56527,56527,56528,9,3,-6
56528,56528,56529,3,5,2
56529,56529,56530,5,0,-5
56530,56530,56531,0,7,7
56531,56531,56532,7,4,-3
56532,56532,56533,4,0,-4
56533,56533,56534,0,7,7
56534,56534,56535,7,3,-4
56535,56535,56536,3,8,5
56536,56536,56537,8,1,-7
56537,56537,56538,1,1,0
56538,56538,56539,1,4,3
56539,56539,56540,4,2,-2
56540,56540,56541,2,1,-1
56541,56541,56542,1,7,6
56542,56542,56543,7,7,0
56543,56543,56544,7,8,1
56544,56544,56545,8,6,-2
56545,56545,56546,6,7,1
56546,56546,56547,7,5,-2
56547,56547,56548,5,6,1
56548,56548,56549,6,6,0
56549,56549,56550,6,4,-2
56550,56550,56551,4,4,0
56551,56551,56552,4,6,2
56552,56552,56553,6,2,-4
56553,56553,56554,2,5,3
56554,56554,56555,5,7,2
56555,56555,56556,7,0,-7
56556,56556,56557,0,8,8
56557,56557,56558,8,2,-6
56558,56558,56559,2,1,-1
56559,56559,56560,1,8,7
56560,56560,56561,8,3,-5
56561,56561,56562,3,6,3
56562,56562,56563,6,4,-2
56563,56563,56564,4,4,0
56564,56564,56565,4,3,-1
56565,56565,56566,3,5,2
56566,56566,56567,5,7,2
56567,56567,56568,7,6,-1
56568,56568,56569,6,2,-4
56569,56569,56570,2,0,-2
56570,56570,56571,0,5,5
56571,56571,56572,5,1,-4
56572,56572,56573,1,0,-1
56573,56573,56574,0,3,3
56574,56574,56575,3,1,-2
56575,56575,56576,1,1,0
56576,56576,56577,1,9,8
56577,56577,56578,9,3,-6
56578,56578,56579,3,2,-1
56579,56579,56580,2,9,7
56580,56580,56581,9,3,-6
56581,56581,56582,3,6,3
56582,56582,56583,6,2,-4
56583,56583,56584,2,1,-1
56584,56584,56585,1,3,2
56585,56585,56586,3,5,2
56586,56586,56587,5,5,0
56587,56587,56588,5,7,2
56588,56588,56589,7,5,-2
56589,56589,56590,5,2,-3
56590,56590,56591,2,7,5
56591,56591,56592,7,6,-1
56592,56592,56593,6,8,2
56593,56593,56594,8,8,0
56594,56594,56595,8,4,-4
56595,56595,56596,4,4,0
56596,56596,56597,4,9,5
56597,56597,56598,9,2,-7
56598,56598,56599,2,9,7
56599,56599,56600,9,8,-1
56600,56600,56601,8,7,-1
56601,56601,56602,7,1,-6
56602,56602,56603,1,1,0
56603,56603,56604,1,7,6
56604,56604,56605,7,1,-6
56605,56605,56606,1,0,-1
56606,56606,56607,0,9,9
56607,56607,56608,9,0,-9
56608,56608,56609,0,0,0
56609,56609,56610,0,1,1
56610,56610,56611,1,7,6
56611,56611,56612,7,2,-5
56612,56612,56613,2,8,6
56613,56613,56614,8,2,-6
56614,56614,56615,2,3,1
56615,56615,56616,3,3,0
56616,56616,56617,3,8,5
56617,56617,56618,8,9,1
56618,56618,56619,9,6,-3
56619,56619,56620,6,4,-2
56620,56620,56621,4,3,-1
56621,56621,56622,3,9,6
56622,56622,56623,9,8,-1
56623,56623,56624,8,3,-5
56624,56624,56625,3,0,-3
56625,56625,56626,0,0,0
56626,56626,56627,0,9,9
56627,56627,56628,9,8,-1
56628,56628,56629,8,6,-2
56629,56629,56630,6,5,-1
56630,56630,56631,5,2,-3
56631,56631,56632,2,6,4
56632,56632,56633,6,1,-5
56633,56633,56634,1,9,8
56634,56634,56635,9,0,-9
56635,56635,56636,0,8,8
56636,56636,56637,8,1,-7
56637,56637,56638,1,7,6
56638,56638,56639,7,0,-7
56639,56639,56640,0,7,7
56640,56640,56641,7,6,-1
56641,56641,56642,6,4,-2
56642,56642,56643,4,2,-2
56643,56643,56644,2,1,-1
56644,56644,56645,1,3,2
56645,56645,56646,3,4,1
56646,56646,56647,4,8,4
56647,56647,56648,8,4,-4
56648,56648,56649,4,9,5
56649,56649,56650,9,7,-2
56650,56650,56651,7,0,-7
56651,56651,56652,0,7,7
56652,56652,56653,7,7,0
56653,56653,56654,7,3,-4
56654,56654,56655,3,2,-1
56655,56655,56656,2,1,-1
56656,56656,56657,1,3,2
56657,56657,56658,3,5,2
56658,56658,56659,5,4,-1
56659,56659,56660,4,1,-3
56660,56660,56661,1,5,4
56661,56661,56662,5,0,-5
56662,56662,56663,0,5,5
56663,56663,56664,5,2,-3
56664,56664,56665,2,2,0
56665,56665,56666,2,5,3
56666,56666,56667,5,8,3
56667,56667,56668,8,1,-7
56668,56668,56669,1,5,4
56669,56669,56670,5,7,2
56670,56670,56671,7,4,-3
56671,56671,56672,4,8,4
56672,56672,56673,8,6,-2
56673,56673,56674,6,0,-6
56674,56674,56675,0,6,6
56675,56675,56676,6,4,-2
56676,56676,56677,4,6,2
56677,56677,56678,6,6,0
56678,56678,56679,6,7,1
56679,56679,56680,7,7,0
56680,56680,56681,7,9,2
56681,56681,56682,9,2,-7
56682,56682,56683,2,1,-1
56683,56683,56684,1,9,8
56684,56684,56685,9,8,-1
56685,56685,56686,8,0,-8
56686,56686,56687,0,2,2
56687,56687,56688,2,1,-1
56688,56688,56689,1,1,0
56689,56689,56690,1,9,8
56690,56690,56691,9,2,-7
56691,56691,56692,2,6,4
56692,56692,56693,6,6,0
56693,56693,56694,6,7,1
56694,56694,56695,7,5,-2
56695,56695,56696,5,1,-4
56696,56696,56697,1,3,2
56697,56697,56698,3,4,1
56698,56698,56699,4,4,0
56699,56699,56700,4,4,0
56700,56700,56701,4,7,3
56701,56701,56702,7,9,2
56702,56702,56703,9,9,0
56703,56703,56704,9,0,-9
56704,56704,56705,0,4,4
56705,56705,56706,4,6,2
56706,56706,56707,6,0,-6
56707,56707,56708,0,9,9
56708,56708,56709,9,0,-9
56709,56709,56710,0,8,8
56710,56710,56711,8,5,-3
56711,56711,56712,5,5,0
56712,56712,56713,5,9,4
56713,56713,56714,9,1,-8
56714,56714,56715,1,0,-1
56715,56715,56716,0,8,8
56716,56716,56717,8,1,-7
56717,56717,56718,1,6,5
56718,56718,56719,6,2,-4
56719,56719,56720,2,5,3
56720,56720,56721,5,3,-2
56721,56721,56722,3,7,4
56722,56722,56723,7,4,-3
56723,56723,56724,4,0,-4
56724,56724,56725,0,5,5
56725,56725,56726,5,9,4
56726,56726,56727,9,6,-3
56727,56727,56728,6,1,-5
56728,56728,56729,1,7,6
56729,56729,56730,7,3,-4
56730,56730,56731,3,8,5
56731,56731,56732,8,5,-3
56732,56732,56733,5,9,4
56733,56733,56734,9,1,-8
56734,56734,56735,1,0,-1
56735,56735,56736,0,6,6
56736,56736,56737,6,1,-5
56737,56737,56738,1,3,2
56738,56738,56739,3,2,-1
56739,56739,56740,2,4,2
56740,56740,56741,4,3,-1
56741,56741,56742,3,9,6
56742,56742,56743,9,4,-5
56743,56743,56744,4,1,-3
56744,56744,56745,1,5,4
56745,56745,56746,5,6,1
56746,56746,56747,6,6,0
56747,56747,56748,6,5,-1
56748,56748,56749,5,7,2
56749,56749,56750,7,1,-6
56750,56750,56751,1,8,7
56751,56751,56752,8,2,-6
56752,56752,56753,2,9,7
56753,56753,56754,9,3,-6
56754,56754,56755,3,0,-3
56755,56755,56756,0,7,7
56756,56756,56757,7,1,-6
56757,56757,56758,1,4,3
56758,56758,56759,4,2,-2
56759,56759,56760,2,9,7
56760,56760,56761,9,3,-6
56761,56761,56762,3,2,-1
56762,56762,56763,2,4,2
56763,56763,56764,4,1,-3
56764,56764,56765,1,5,4
56765,56765,56766,5,0,-5
56766,56766,56767,0,6,6
56767,56767,56768,6,1,-5
56768,56768,56769,1,7,6
56769,56769,56770,7,4,-3
56770,56770,56771,4,8,4
56771,56771,56772,8,1,-7
56772,56772,56773,1,9,8
56773,56773,56774,9,9,0
56774,56774,56775,9,0,-9
56775,56775,56776,0,3,3
56776,56776,56777,3,0,-3
56777,56777,56778,0,0,0
56778,56778,56779,0,1,1
56779,56779,56780,1,7,6
56780,56780,56781,7,0,-7
56781,56781,56782,0,5,5
56782,56782,56783,5,1,-4
56783,56783,56784,1,4,3
56784,56784,56785,4,2,-2
56785,56785,56786,2,5,3
56786,56786,56787,5,7,2
56787,56787,56788,7,9,2
56788,56788,56789,9,5,-4
56789,56789,56790,5,6,1
56790,56790,56791,6,3,-3
56791,56791,56792,3,9,6
56792,56792,56793,9,4,-5
56793,56793,56794,4,7,3
56794,56794,56795,7,2,-5
56795,56795,56796,2,6,4
56796,56796,56797,6,4,-2
56797,56797,56798,4,7,3
56798,56798,56799,7,4,-3
56799,56799,56800,4,9,5
56800,56800,56801,9,0,-9
56801,56801,56802,0,4,4
56802,56802,56803,4,0,-4
56803,56803,56804,0,5,5
56804,56804,56805,5,6,1
56805,56805,56806,6,7,1
56806,56806,56807,7,9,2
56807,56807,56808,9,4,-5
56808,56808,56809,4,6,2
56809,56809,56810,6,1,-5
56810,56810,56811,1,6,5
56811,56811,56812,6,5,-1
56812,56812,56813,5,5,0
56813,56813,56814,5,7,2
56814,56814,56815,7,7,0
56815,56815,56816,7,7,0
56816,56816,56817,7,3,-4
56817,56817,56818,3,4,1
56818,56818,56819,4,2,-2
56819,56819,56820,2,3,1
56820,56820,56821,3,2,-1
56821,56821,56822,2,7,5
56822,56822,56823,7,3,-4
56823,56823,56824,3,2,-1
56824,56824,56825,2,4,2
56825,56825,56826,4,4,0
56826,56826,56827,4,4,0
56827,56827,56828,4,7,3
56828,56828,56829,7,9,2
56829,56829,56830,9,6,-3
56830,56830,56831,6,1,-5
56831,56831,56832,1,7,6
56832,56832,56833,7,4,-3
56833,56833,56834,4,1,-3
56834,56834,56835,1,0,-1
56835,56835,56836,0,1,1
56836,56836,56837,1,7,6
56837,56837,56838,7,5,-2
56838,56838,56839,5,9,4
56839,56839,56840,9,6,-3
56840,56840,56841,6,7,1
56841,56841,56842,7,8,1
56842,56842,56843,8,5,-3
56843,56843,56844,5,7,2
56844,56844,56845,7,6,-1
56845,56845,56846,6,7,1
56846,56846,56847,7,2,-5
56847,56847,56848,2,2,0
56848,56848,56849,2,3,1
56849,56849,56850,3,7,4
56850,56850,56851,7,1,-6
56851,56851,56852,1,5,4
56852,56852,56853,5,4,-1
56853,56853,56854,4,6,2
56854,56854,56855,6,4,-2
56855,56855,56856,4,4,0
56856,56856,56857,4,0,-4
56857,56857,56858,0,8,8
56858,56858,56859,8,9,1
56859,56859,56860,9,5,-4
56860,56860,56861,5,9,4
56861,56861,56862,9,6,-3
56862,56862,56863,6,6,0
56863,56863,56864,6,2,-4
56864,56864,56865,2,1,-1
56865,56865,56866,1,8,7
56866,56866,56867,8,8,0
56867,56867,56868,8,0,-8
56868,56868,56869,0,3,3
56869,56869,56870,3,1,-2
56870,56870,56871,1,3,2
56871,56871,56872,3,8,5
56872,56872,56873,8,7,-1
56873,56873,56874,7,8,1
56874,56874,56875,8,3,-5
56875,56875,56876,3,2,-1
56876,56876,56877,2,9,7
56877,56877,56878,9,6,-3
56878,56878,56879,6,8,2
56879,56879,56880,8,7,-1
56880,56880,56881,7,8,1
56881,56881,56882,8,1,-7
56882,56882,56883,1,9,8
56883,56883,56884,9,9,0
56884,56884,56885,9,6,-3
56885,56885,56886,6,4,-2
56886,56886,56887,4,8,4
56887,56887,56888,8,7,-1
56888,56888,56889,7,8,1
56889,56889,56890,8,5,-3
56890,56890,56891,5,8,3
56891,56891,56892,8,7,-1
56892,56892,56893,7,4,-3
56893,56893,56894,4,8,4
56894,56894,56895,8,7,-1
56895,56895,56896,7,9,2
56896,56896,56897,9,7,-2
56897,56897,56898,7,5,-2
56898,56898,56899,5,6,1
56899,56899,56900,6,7,1
56900,56900,56901,7,2,-5
56901,56901,56902,2,1,-1
56902,56902,56903,1,1,0
56903,56903,56904,1,6,5
56904,56904,56905,6,9,3
56905,56905,56906,9,9,0
56906,56906,56907,9,8,-1
56907,56907,56908,8,0,-8
56908,56908,56909,0,7,7
56909,56909,56910,7,1,-6
56910,56910,56911,1,8,7
56911,56911,56912,8,1,-7
56912,56912,56913,1,8,7
56913,56913,56914,8,0,-8
56914,56914,56915,0,7,7
56915,56915,56916,7,6,-1
56916,56916,56917,6,2,-4
56917,56917,56918,2,6,4
56918,56918,56919,6,2,-4
56919,56919,56920,2,7,5
56920,56920,56921,7,3,-4
56921,56921,56922,3,2,-1
56922,56922,56923,2,9,7
56923,56923,56924,9,7,-2
56924,56924,56925,7,3,-4
56925,56925,56926,3,2,-1
56926,56926,56927,2,3,1
56927,56927,56928,3,5,2
56928,56928,56929,5,0,-5
56929,56929,56930,0,9,9
56930,56930,56931,9,7,-2
56931,56931,56932,7,7,0
56932,56932,56933,7,9,2
56933,56933,56934,9,3,-6
56934,56934,56935,3,5,2
56935,56935,56936,5,6,1
56936,56936,56937,6,6,0
56937,56937,56938,6,5,-1
56938,56938,56939,5,5,0
56939,56939,56940,5,0,-5
56940,56940,56941,0,0,0
56941,56941,56942,0,0,0
56942,56942,56943,0,6,6
56943,56943,56944,6,9,3
56944,56944,56945,9,1,-8
56945,56945,56946,1,4,3
56946,56946,56947,4,5,1
56947,56947,56948,5,9,4
56948,56948,56949,9,0,-9
56949,56949,56950,0,0,0
56950,56950,56951,0,4,4
56951,56951,56952,4,8,4
56952,56952,56953,8,1,-7
56953,56953,56954,1,0,-1
56954,56954,56955,0,1,1
56955,56955,56956,1,8,7
56956,56956,56957,8,2,-6
56957,56957,56958,2,4,2
56958,56958,56959,4,8,4
56959,56959,56960,8,1,-7
56960,56960,56961,1,2,1
56961,56961,56962,2,5,3
56962,56962,56963,5,6,1
56963,56963,56964,6,6,0
56964,56964,56965,6,1,-5
56965,56965,56966,1,3,2
56966,56966,56967,3,5,2
56967,56967,56968,5,0,-5
56968,56968,56969,0,0,0
56969,56969,56970,0,4,4
56970,56970,56971,4,1,-3
56971,56971,56972,1,6,5
56972,56972,56973,6,2,-4
56973,56973,56974,2,3,1
56974,56974,56975,3,3,0
56975,56975,56976,3,8,5
56976,56976,56977,8,4,-4
56977,56977,56978,4,8,4
56978,56978,56979,8,5,-3
56979,56979,56980,5,1,-4
56980,56980,56981,1,6,5
56981,56981,56982,6,5,-1
56982,56982,56983,5,7,2
56983,56983,56984,7,0,-7
56984,56984,56985,0,8,8
56985,56985,56986,8,1,-7
56986,56986,56987,1,9,8
56987,56987,56988,9,6,-3
56988,56988,56989,6,0,-6
56989,56989,56990,0,5,5
56990,56990,56991,5,1,-4
56991,56991,56992,1,7,6
56992,56992,56993,7,2,-5
56993,56993,56994,2,3,1
56994,56994,56995,3,3,0
56995,56995,56996,3,9,6
56996,56996,56997,9,4,-5
56997,56997,56998,4,2,-2
56998,56998,56999,2,5,3
56999,56999,57000,5,0,-5
57000,57000,57001,0,8,8
57001,57001,57002,8,4,-4
57002,57002,57003,4,0,-4
57003,57003,57004,0,3,3
57004,57004,57005,3,1,-2
57005,57005,57006,1,9,8
57006,57006,57007,9,2,-7
57007,57007,57008,2,9,7
57008,57008,57009,9,3,-6
57009,57009,57010,3,6,3
57010,57010,57011,6,4,-2
57011,57011,57012,4,6,2
57012,57012,57013,6,5,-1
57013,57013,57014,5,1,-4
57014,57014,57015,1,6,5
57015,57015,57016,6,3,-3
57016,57016,57017,3,7,4
57017,57017,57018,7,9,2
57018,57018,57019,9,8,-1
57019,57019,57020,8,0,-8
57020,57020,57021,0,8,8
57021,57021,57022,8,1,-7
57022,57022,57023,1,6,5
57023,57023,57024,6,9,3
57024,57024,57025,9,5,-4
57025,57025,57026,5,4,-1
57026,57026,57027,4,0,-4
57027,57027,57028,0,5,5
57028,57028,57029,5,6,1
57029,57029,57030,6,8,2
57030,57030,57031,8,8,0
57031,57031,57032,8,7,-1
57032,57032,57033,7,9,2
57033,57033,57034,9,0,-9
57034,57034,57035,0,4,4
57035,57035,57036,4,6,2
57036,57036,57037,6,1,-5
57037,57037,57038,1,8,7
57038,57038,57039,8,9,1
57039,57039,57040,9,3,-6
57040,57040,57041,3,0,-3
57041,57041,57042,0,8,8
57042,57042,57043,8,4,-4
57043,57043,57044,4,7,3
57044,57044,57045,7,8,1
57045,57045,57046,8,1,-7
57046,57046,57047,1,9,8
57047,57047,57048,9,7,-2
57048,57048,57049,7,1,-6
57049,57049,57050,1,9,8
57050,57050,57051,9,4,-5
57051,57051,57052,4,9,5
57052,57052,57053,9,0,-9
57053,57053,57054,0,8,8
57054,57054,57055,8,5,-3
57055,57055,57056,5,3,-2
57056,57056,57057,3,1,-2
57057,57057,57058,1,1,0
57058,57058,57059,1,4,3
57059,57059,57060,4,8,4
57060,57060,57061,8,0,-8
57061,57061,57062,0,8,8
57062,57062,57063,8,7,-1
57063,57063,57064,7,0,-7
57064,57064,57065,0,6,6
57065,57065,57066,6,7,1
57066,57066,57067,7,0,-7
57067,57067,57068,0,0,0
57068,57068,57069,0,1,1
57069,57069,57070,1,8,7
57070,57070,57071,8,7,-1
57071,57071,57072,7,9,2
57072,57072,57073,9,0,-9
57073,57073,57074,0,7,7
57074,57074,57075,7,6,-1
57075,57075,57076,6,4,-2
57076,57076,57077,4,8,4
57077,57077,57078,8,7,-1
57078,57078,57079,7,9,2
57079,57079,57080,9,8,-1
57080,57080,57081,8,5,-3
57081,57081,57082,5,4,-1
57082,57082,57083,4,7,3
57083,57083,57084,7,8,1
57084,57084,57085,8,9,1
57085,57085,57086,9,2,-7
57086,57086,57087,2,8,6
57087,57087,57088,8,5,-3
57088,57088,57089,5,6,1
57089,57089,57090,6,8,2
57090,57090,57091,8,0,-8
57091,57091,57092,0,0,0
57092,57092,57093,0,8,8
57093,57093,57094,8,1,-7
57094,57094,57095,1,1,0
57095,57095,57096,1,2,1
57096,57096,57097,2,7,5
57097,57097,57098,7,7,0
57098,57098,57099,7,7,0
57099,57099,57100,7,9,2
57100,57100,57101,9,1,-8
57101,57101,57102,1,4,3
57102,57102,57103,4,3,-1
57103,57103,57104,3,2,-1
57104,57104,57105,2,2,0
57105,57105,57106,2,5,3
57106,57106,57107,5,3,-2
57107,57107,57108,3,8,5
57108,57108,57109,8,1,-7
57109,57109,57110,1,7,6
57110,57110,57111,7,4,-3
57111,57111,57112,4,2,-2
57112,57112,57113,2,2,0
57113,57113,57114,2,4,2
57114,57114,57115,4,0,-4
57115,57115,57116,0,8,8
57116,57116,57117,8,0,-8
57117,57117,57118,0,8,8
57118,57118,57119,8,7,-1
57119,57119,57120,7,0,-7
57120,57120,57121,0,8,8
57121,57121,57122,8,6,-2
57122,57122,57123,6,4,-2
57123,57123,57124,4,5,1
57124,57124,57125,5,6,1
57125,57125,57126,6,4,-2
57126,57126,57127,4,4,0
57127,57127,57128,4,5,1
57128,57128,57129,5,9,4
57129,57129,57130,9,2,-7
57130,57130,57131,2,3,1
57131,57131,57132,3,5,2
57132,57132,57133,5,8,3
57133,57133,57134,8,7,-1
57134,57134,57135,7,4,-3
57135,57135,57136,4,5,1
57136,57136,57137,5,7,2
57137,57137,57138,7,6,-1
57138,57138,57139,6,2,-4
57139,57139,57140,2,6,4
57140,57140,57141,6,3,-3
57141,57141,57142,3,2,-1
57142,57142,57143,2,6,4
57143,57143,57144,6,4,-2
57144,57144,57145,4,9,5
57145,57145,57146,9,4,-5
57146,57146,57147,4,6,2
57147,57147,57148,6,9,3
57148,57148,57149,9,3,-6
57149,57149,57150,3,7,4
57150,57150,57151,7,2,-5
57151,57151,57152,2,9,7
57152,57152,57153,9,2,-7
57153,57153,57154,2,0,-2
57154,57154,57155,0,4,4
57155,57155,57156,4,5,1
57156,57156,57157,5,6,1
57157,57157,57158,6,6,0
57158,57158,57159,6,9,3
57159,57159,57160,9,1,-8
57160,57160,57161,1,0,-1
57161,57161,57162,0,0,0
57162,57162,57163,0,2,2
57163,57163,57164,2,8,6
57164,57164,57165,8,5,-3
57165,57165,57166,5,3,-2
57166,57166,57167,3,5,2
57167,57167,57168,5,5,0
57168,57168,57169,5,1,-4
57169,57169,57170,1,1,0
57170,57170,57171,1,3,2
57171,57171,57172,3,3,0
57172,57172,57173,3,3,0
57173,57173,57174,3,8,5
57174,57174,57175,8,9,1
57175,57175,57176,9,0,-9
57176,57176,57177,0,7,7
57177,57177,57178,7,7,0
57178,57178,57179,7,8,1
57179,57179,57180,8,5,-3
57180,57180,57181,5,7,2
57181,57181,57182,7,5,-2
57182,57182,57183,5,2,-3
57183,57183,57184,2,4,2
57184,57184,57185,4,2,-2
57185,57185,57186,2,0,-2
57186,57186,57187,0,9,9
57187,57187,57188,9,7,-2
57188,57188,57189,7,8,1
57189,57189,57190,8,1,-7
57190,57190,57191,1,2,1
57191,57191,57192,2,1,-1
57192,57192,57193,1,1,0
57193,57193,57194,1,3,2
57194,57194,57195,3,3,0
57195,57195,57196,3,7,4
57196,57196,57197,7,1,-6
57197,57197,57198,1,6,5
57198,57198,57199,6,3,-3
57199,57199,57200,3,8,5
57200,57200,57201,8,0,-8
57201,57201,57202,0,0,0
57202,57202,57203,0,1,1
57203,57203,57204,1,7,6
57204,57204,57205,7,2,-5
57205,57205,57206,2,9,7
57206,57206,57207,9,3,-6
57207,57207,57208,3,4,1
57208,57208,57209,4,4,0
57209,57209,57210,4,8,4
57210,57210,57211,8,5,-3
57211,57211,57212,5,8,3
57212,57212,57213,8,6,-2
57213,57213,57214,6,0,-6
57214,57214,57215,0,7,7
57215,57215,57216,7,8,1
57216,57216,57217,8,8,0
57217,57217,57218,8,6,-2
57218,57218,57219,6,9,3
57219,57219,57220,9,1,-8
57220,57220,57221,1,0,-1
57221,57221,57222,0,1,1
57222,57222,57223,1,1,0
57223,57223,57224,1,4,3
57224,57224,57225,4,2,-2
57225,57225,57226,2,6,4
57226,57226,57227,6,3,-3
57227,57227,57228,3,4,1
57228,57228,57229,4,4,0
57229,57229,57230,4,7,3
57230,57230,57231,7,5,-2
57231,57231,57232,5,5,0
57232,57232,57233,5,6,1
57233,57233,57234,6,5,-1
57234,57234,57235,5,7,2
57235,57235,57236,7,9,2
57236,57236,57237,9,8,-1
57237,57237,57238,8,8,0
57238,57238,57239,8,9,1
57239,57239,57240,9,5,-4
57240,57240,57241,5,0,-5
57241,57241,57242,0,5,5
57242,57242,57243,5,1,-4
57243,57243,57244,1,8,7
57244,57244,57245,8,2,-6
57245,57245,57246,2,9,7
57246,57246,57247,9,3,-6
57247,57247,57248,3,5,2
57248,57248,57249,5,4,-1
57249,57249,57250,4,1,-3
57250,57250,57251,1,5,4
57251,57251,57252,5,0,-5
57252,57252,57253,0,6,6
57253,57253,57254,6,6,0
57254,57254,57255,6,7,1
57255,57255,57256,7,5,-2
57256,57256,57257,5,8,3
57257,57257,57258,8,9,1
57258,57258,57259,9,9,0
57259,57259,57260,9,6,-3
57260,57260,57261,6,0,-6
57261,57261,57262,0,2,2
57262,57262,57263,2,8,6
57263,57263,57264,8,3,-5
57264,57264,57265,3,3,0
57265,57265,57266,3,1,-2
57266,57266,57267,1,9,8
57267,57267,57268,9,1,-8
57268,57268,57269,1,5,4
57269,57269,57270,5,2,-3
57270,57270,57271,2,5,3
57271,57271,57272,5,1,-4
57272,57272,57273,1,2,1
57273,57273,57274,2,9,7
57274,57274,57275,9,6,-3
57275,57275,57276,6,8,2
57276,57276,57277,8,8,0
57277,57277,57278,8,3,-5
57278,57278,57279,3,4,1
57279,57279,57280,4,7,3
57280,57280,57281,7,9,2
57281,57281,57282,9,7,-2
57282,57282,57283,7,1,-6
57283,57283,57284,1,2,1
57284,57284,57285,2,7,5
57285,57285,57286,7,7,0
57286,57286,57287,7,1,-6
57287,57287,57288,1,0,-1
57288,57288,57289,0,2,2
57289,57289,57290,2,9,7
57290,57290,57291,9,3,-6
57291,57291,57292,3,7,4
57292,57292,57293,7,5,-2
57293,57293,57294,5,9,4
57294,57294,57295,9,9,0
57295,57295,57296,9,0,-9
57296,57296,57297,0,6,6
57297,57297,57298,6,0,-6
57298,57298,57299,0,9,9
57299,57299,57300,9,3,-6
57300,57300,57301,3,1,-2
57301,57301,57302,1,5,4
57302,57302,57303,5,1,-4
57303,57303,57304,1,8,7
57304,57304,57305,8,1,-7
57305,57305,57306,1,3,2
57306,57306,57307,3,2,-1
57307,57307,57308,2,3,1
57308,57308,57309,3,9,6
57309,57309,57310,9,1,-8
57310,57310,57311,1,5,4
57311,57311,57312,5,3,-2
57312,57312,57313,3,6,3
57313,57313,57314,6,6,0
57314,57314,57315,6,8,2
57315,57315,57316,8,8,0
57316,57316,57317,8,1,-7
57317,57317,57318,1,8,7
57318,57318,57319,8,2,-6
57319,57319,57320,2,5,3
57320,57320,57321,5,0,-5
57321,57321,57322,0,1,1
57322,57322,57323,1,7,6
57323,57323,57324,7,8,1
57324,57324,57325,8,7,-1
57325,57325,57326,7,0,-7
57326,57326,57327,0,5,5
57327,57327,57328,5,4,-1
57328,57328,57329,4,8,4
57329,57329,57330,8,5,-3
57330,57330,57331,5,2,-3
57331,57331,57332,2,8,6
57332,57332,57333,8,9,1
57333,57333,57334,9,7,-2
57334,57334,57335,7,8,1
57335,57335,57336,8,3,-5
57336,57336,57337,3,7,4
57337,57337,57338,7,2,-5
57338,57338,57339,2,1,-1
57339,57339,57340,1,1,0
57340,57340,57341,1,3,2
57341,57341,57342,3,2,-1
57342,57342,57343,2,4,2
57343,57343,57344,4,7,3
57344,57344,57345,7,5,-2
57345,57345,57346,5,6,1
57346,57346,57347,6,6,0
57347,57347,57348,6,8,2
57348,57348,57349,8,0,-8
57349,57349,57350,0,7,7
57350,57350,57351,7,3,-4
57351,57351,57352,3,8,5
57352,57352,57353,8,6,-2
57353,57353,57354,6,4,-2
57354,57354,57355,4,8,4
57355,57355,57356,8,0,-8
57356,57356,57357,0,7,7
57357,57357,57358,7,2,-5
57358,57358,57359,2,0,-2
57359,57359,57360,0,6,6
57360,57360,57361,6,4,-2
57361,57361,57362,4,1,-3
57362,57362,57363,1,2,1
57363,57363,57364,2,0,-2
57364,57364,57365,0,7,7
57365,57365,57366,7,2,-5
57366,57366,57367,2,7,5
57367,57367,57368,7,4,-3
57368,57368,57369,4,5,1
57369,57369,57370,5,4,-1
57370,57370,57371,4,4,0
57371,57371,57372,4,7,3
57372,57372,57373,7,3,-4
57373,57373,57374,3,9,6
57374,57374,57375,9,4,-5
57375,57375,57376,4,7,3
57376,57376,57377,7,2,-5
57377,57377,57378,2,1,-1
57378,57378,57379,1,8,7
57379,57379,57380,8,7,-1
57380,57380,57381,7,1,-6
57381,57381,57382,1,4,3
57382,57382,57383,4,5,1
57383,57383,57384,5,0,-5
57384,57384,57385,0,1,1
57385,57385,57386,1,7,6
57386,57386,57387,7,2,-5
57387,57387,57388,2,2,0
57388,57388,57389,2,4,2
57389,57389,57390,4,0,-4
57390,57390,57391,0,3,3
57391,57391,57392,3,8,5
57392,57392,57393,8,0,-8
57393,57393,57394,0,2,2
57394,57394,57395,2,0,-2
57395,57395,57396,0,3,3
57396,57396,57397,3,0,-3
57397,57397,57398,0,2,2
57398,57398,57399,2,3,1
57399,57399,57400,3,1,-2
57400,57400,57401,1,3,2
57401,57401,57402,3,3,0
57402,57402,57403,3,5,2
57403,57403,57404,5,8,3
57404,57404,57405,8,7,-1
57405,57405,57406,7,9,2
57406,57406,57407,9,0,-9
57407,57407,57408,0,0,0
57408,57408,57409,0,6,6
57409,57409,57410,6,1,-5
57410,57410,57411,1,8,7
57411,57411,57412,8,1,-7
57412,57412,57413,1,6,5
57413,57413,57414,6,7,1
57414,57414,57415,7,3,-4
57415,57415,57416,3,2,-1
57416,57416,57417,2,4,2
57417,57417,57418,4,1,-3
57418,57418,57419,1,6,5
57419,57419,57420,6,0,-6
57420,57420,57421,0,9,9
57421,57421,57422,9,4,-5
57422,57422,57423,4,9,5
57423,57423,57424,9,3,-6
57424,57424,57425,3,8,5
57425,57425,57426,8,3,-5
57426,57426,57427,3,2,-1
57427,57427,57428,2,9,7
57428,57428,57429,9,7,-2
57429,57429,57430,7,1,-6
57430,57430,57431,1,7,6
57431,57431,57432,7,9,2
57432,57432,57433,9,1,-8
57433,57433,57434,1,8,7
57434,57434,57435,8,0,-8
57435,57435,57436,0,1,1
57436,57436,57437,1,1,0
57437,57437,57438,1,6,5
57438,57438,57439,6,2,-4
57439,57439,57440,2,1,-1
57440,57440,57441,1,3,2
57441,57441,57442,3,2,-1
57442,57442,57443,2,4,2
57443,57443,57444,4,9,5
57444,57444,57445,9,7,-2
57445,57445,57446,7,2,-5
57446,57446,57447,2,8,6
57447,57447,57448,8,2,-6
57448,57448,57449,2,9,7
57449,57449,57450,9,8,-1
57450,57450,57451,8,0,-8
57451,57451,57452,0,9,9
57452,57452,57453,9,1,-8
57453,57453,57454,1,1,0
57454,57454,57455,1,2,1
57455,57455,57456,2,6,4
57456,57456,57457,6,3,-3
57457,57457,57458,3,7,4
57458,57458,57459,7,4,-3
57459,57459,57460,4,1,-3
57460,57460,57461,1,5,4
57461,57461,57462,5,5,0
57462,57462,57463,5,6,1
57463,57463,57464,6,1,-5
57464,57464,57465,1,7,6
57465,57465,57466,7,4,-3
57466,57466,57467,4,8,4
57467,57467,57468,8,3,-5
57468,57468,57469,3,9,6
57469,57469,57470,9,5,-4
57470,57470,57471,5,0,-5
57471,57471,57472,0,3,3
57472,57472,57473,3,1,-2
57473,57473,57474,1,3,2
57474,57474,57475,3,2,-1
57475,57475,57476,2,9,7
57476,57476,57477,9,3,-6
57477,57477,57478,3,2,-1
57478,57478,57479,2,7,5
57479,57479,57480,7,5,-2
57480,57480,57481,5,8,3
57481,57481,57482,8,4,-4
57482,57482,57483,4,9,5
57483,57483,57484,9,8,-1
57484,57484,57485,8,7,-1
57485,57485,57486,7,0,-7
57486,57486,57487,0,9,9
57487,57487,57488,9,3,-6
57488,57488,57489,3,5,2
57489,57489,57490,5,6,1
57490,57490,57491,6,0,-6
57491,57491,57492,0,3,3
57492,57492,57493,3,8,5
57493,57493,57494,8,0,-8
57494,57494,57495,0,3,3
57495,57495,57496,3,2,-1
57496,57496,57497,2,5,3
57497,57497,57498,5,6,1
57498,57498,57499,6,4,-2
57499,57499,57500,4,2,-2
57500,57500,57501,2,8,6
57501,57501,57502,8,7,-1
57502,57502,57503,7,2,-5
57503,57503,57504,2,7,5
57504,57504,57505,7,1,-6
57505,57505,57506,1,2,1
57506,57506,57507,2,0,-2
57507,57507,57508,0,6,6
57508,57508,57509,6,2,-4
57509,57509,57510,2,5,3
57510,57510,57511,5,5,0
57511,57511,57512,5,7,2
57512,57512,57513,7,8,1
57513,57513,57514,8,6,-2
57514,57514,57515,6,8,2
57515,57515,57516,8,1,-7
57516,57516,57517,1,1,0
57517,57517,57518,1,6,5
57518,57518,57519,6,6,0
57519,57519,57520,6,2,-4
57520,57520,57521,2,1,-1
57521,57521,57522,1,3,2
57522,57522,57523,3,3,0
57523,57523,57524,3,4,1
57524,57524,57525,4,0,-4
57525,57525,57526,0,7,7
57526,57526,57527,7,3,-4
57527,57527,57528,3,5,2
57528,57528,57529,5,6,1
57529,57529,57530,6,4,-2
57530,57530,57531,4,9,5
57531,57531,57532,9,8,-1
57532,57532,57533,8,3,-5
57533,57533,57534,3,7,4
57534,57534,57535,7,7,0
57535,57535,57536,7,0,-7
57536,57536,57537,0,4,4
57537,57537,57538,4,4,0
57538,57538,57539,4,9,5
57539,57539,57540,9,7,-2
57540,57540,57541,7,7,0
57541,57541,57542,7,0,-7
57542,57542,57543,0,0,0
57543,57543,57544,0,4,4
57544,57544,57545,4,9,5
57545,57545,57546,9,7,-2
57546,57546,57547,7,7,0
57547,57547,57548,7,4,-3
57548,57548,57549,4,7,3
57549,57549,57550,7,7,0
57550,57550,57551,7,9,2
57551,57551,57552,9,1,-8
57552,57552,57553,1,5,4
57553,57553,57554,5,6,1
57554,57554,57555,6,7,1
57555,57555,57556,7,7,0
57556,57556,57557,7,6,-1
57557,57557,57558,6,0,-6
57558,57558,57559,0,4,4
57559,57559,57560,4,7,3
57560,57560,57561,7,8,1
57561,57561,57562,8,8,0
57562,57562,57563,8,9,1
57563,57563,57564,9,7,-2
57564,57564,57565,7,6,-1
57565,57565,57566,6,5,-1
57566,57566,57567,5,9,4
57567,57567,57568,9,3,-6
57568,57568,57569,3,4,1
57569,57569,57570,4,7,3
57570,57570,57571,7,1,-6
57571,57571,57572,1,7,6
57572,57572,57573,7,2,-5
57573,57573,57574,2,2,0
57574,57574,57575,2,0,-2
57575,57575,57576,0,7,7
57576,57576,57577,7,6,-1
57577,57577,57578,6,6,0
57578,57578,57579,6,1,-5
57579,57579,57580,1,8,7
57580,57580,57581,8,7,-1
57581,57581,57582,7,4,-3
57582,57582,57583,4,2,-2
57583,57583,57584,2,3,1
57584,57584,57585,3,4,1
57585,57585,57586,4,0,-4
57586,57586,57587,0,6,6
57587,57587,57588,6,2,-4
57588,57588,57589,2,4,2
57589,57589,57590,4,9,5
57590,57590,57591,9,6,-3
57591,57591,57592,6,2,-4
57592,57592,57593,2,5,3
57593,57593,57594,5,3,-2
57594,57594,57595,3,0,-3
57595,57595,57596,0,8,8
57596,57596,57597,8,2,-6
57597,57597,57598,2,3,1
57598,57598,57599,3,1,-2
57599,57599,57600,1,7,6
57600,57600,57601,7,0,-7
57601,57601,57602,0,8,8
57602,57602,57603,8,1,-7
57603,57603,57604,1,2,1
57604,57604,57605,2,2,0
57605,57605,57606,2,2,0
57606,57606,57607,2,1,-1
57607,57607,57608,1,3,2
57608,57608,57609,3,7,4
57609,57609,57610,7,5,-2
57610,57610,57611,5,8,3
57611,57611,57612,8,3,-5
57612,57612,57613,3,1,-2
57613,57613,57614,1,1,0
57614,57614,57615,1,2,1
57615,57615,57616,2,8,6
57616,57616,57617,8,8,0
57617,57617,57618,8,8,0
57618,57618,57619,8,2,-6
57619,57619,57620,2,2,0
57620,57620,57621,2,7,5
57621,57621,57622,7,6,-1
57622,57622,57623,6,9,3
57623,57623,57624,9,2,-7
57624,57624,57625,2,3,1
57625,57625,57626,3,2,-1
57626,57626,57627,2,9,7
57627,57627,57628,9,2,-7
57628,57628,57629,2,0,-2
57629,57629,57630,0,4,4
57630,57630,57631,4,1,-3
57631,57631,57632,1,2,1
57632,57632,57633,2,2,0
57633,57633,57634,2,0,-2
57634,57634,57635,0,3,3
57635,57635,57636,3,9,6
57636,57636,57637,9,4,-5
57637,57637,57638,4,9,5
57638,57638,57639,9,5,-4
57639,57639,57640,5,8,3
57640,57640,57641,8,6,-2
57641,57641,57642,6,0,-6
57642,57642,57643,0,7,7
57643,57643,57644,7,1,-6
57644,57644,57645,1,0,-1
57645,57645,57646,0,7,7
57646,57646,57647,7,1,-6
57647,57647,57648,1,8,7
57648,57648,57649,8,2,-6
57649,57649,57650,2,0,-2
57650,57650,57651,0,3,3
57651,57651,57652,3,7,4
57652,57652,57653,7,7,0
57653,57653,57654,7,2,-5
57654,57654,57655,2,8,6
57655,57655,57656,8,6,-2
57656,57656,57657,6,9,3
57657,57657,57658,9,2,-7
57658,57658,57659,2,0,-2
57659,57659,57660,0,3,3
57660,57660,57661,3,1,-2
57661,57661,57662,1,5,4
57662,57662,57663,5,7,2
57663,57663,57664,7,8,1
57664,57664,57665,8,8,0
57665,57665,57666,8,8,0
57666,57666,57667,8,9,1
57667,57667,57668,9,8,-1
57668,57668,57669,8,2,-6
57669,57669,57670,2,9,7
57670,57670,57671,9,5,-4
57671,57671,57672,5,7,2
57672,57672,57673,7,1,-6
57673,57673,57674,1,9,8
57674,57674,57675,9,6,-3
57675,57675,57676,6,7,1
57676,57676,57677,7,4,-3
57677,57677,57678,4,8,4
57678,57678,57679,8,3,-5
57679,57679,57680,3,3,0
57680,57680,57681,3,9,6
57681,57681,57682,9,0,-9
57682,57682,57683,0,9,9
57683,57683,57684,9,1,-8
57684,57684,57685,1,0,-1
57685,57685,57686,0,0,0
57686,57686,57687,0,4,4
57687,57687,57688,4,9,5
57688,57688,57689,9,3,-6
57689,57689,57690,3,4,1
57690,57690,57691,4,6,2
57691,57691,57692,6,7,1
57692,57692,57693,7,0,-7
57693,57693,57694,0,2,2
57694,57694,57695,2,0,-2
57695,57695,57696,0,8,8
57696,57696,57697,8,8,0
57697,57697,57698,8,3,-5
57698,57698,57699,3,9,6
57699,57699,57700,9,0,-9
57700,57700,57701,0,8,8
57701,57701,57702,8,7,-1
57702,57702,57703,7,7,0
57703,57703,57704,7,4,-3
57704,57704,57705,4,0,-4
57705,57705,57706,0,4,4
57706,57706,57707,4,0,-4
57707,57707,57708,0,4,4
57708,57708,57709,4,4,0
57709,57709,57710,4,5,1
57710,57710,57711,5,1,-4
57711,57711,57712,1,4,3
57712,57712,57713,4,4,0
57713,57713,57714,4,1,-3
57714,57714,57715,1,1,0
57715,57715,57716,1,2,1
57716,57716,57717,2,3,1
57717,57717,57718,3,7,4
57718,57718,57719,7,6,-1
57719,57719,57720,6,0,-6
57720,57720,57721,0,4,4
57721,57721,57722,4,1,-3
57722,57722,57723,1,7,6
57723,57723,57724,7,4,-3
57724,57724,57725,4,7,3
57725,57725,57726,7,2,-5
57726,57726,57727,2,0,-2
57727,57727,57728,0,9,9
57728,57728,57729,9,9,0
57729,57729,57730,9,0,-9
57730,57730,57731,0,8,8
57731,57731,57732,8,9,1
57732,57732,57733,9,4,-5
57733,57733,57734,4,3,-1
57734,57734,57735,3,3,0
57735,57735,57736,3,8,5
57736,57736,57737,8,8,0
57737,57737,57738,8,1,-7
57738,57738,57739,1,3,2
57739,57739,57740,3,1,-2
57740,57740,57741,1,8,7
57741,57741,57742,8,6,-2
57742,57742,57743,6,5,-1
57743,57743,57744,5,9,4
57744,57744,57745,9,8,-1
57745,57745,57746,8,0,-8
57746,57746,57747,0,4,4
57747,57747,57748,4,7,3
57748,57748,57749,7,1,-6
57749,57749,57750,1,3,2
57750,57750,57751,3,7,4
57751,57751,57752,7,2,-5
57752,57752,57753,2,9,7
57753,57753,57754,9,6,-3
57754,57754,57755,6,2,-4
57755,57755,57756,2,6,4
57756,57756,57757,6,0,-6
57757,57757,57758,0,6,6
57758,57758,57759,6,9,3
57759,57759,57760,9,0,-9
57760,57760,57761,0,1,1
57761,57761,57762,1,3,2
57762,57762,57763,3,7,4
57763,57763,57764,7,6,-1
57764,57764,57765,6,3,-3
57765,57765,57766,3,3,0
57766,57766,57767,3,8,5
57767,57767,57768,8,5,-3
57768,57768,57769,5,0,-5
57769,57769,57770,0,6,6
57770,57770,57771,6,3,-3
57771,57771,57772,3,8,5
57772,57772,57773,8,8,0
57773,57773,57774,8,7,-1
57774,57774,57775,7,1,-6
57775,57775,57776,1,9,8
57776,57776,57777,9,6,-3
57777,57777,57778,6,1,-5
57778,57778,57779,1,4,3
57779,57779,57780,4,1,-3
57780,57780,57781,1,3,2
57781,57781,57782,3,9,6
57782,57782,57783,9,6,-3
57783,57783,57784,6,0,-6
57784,57784,57785,0,1,1
57785,57785,57786,1,9,8
57786,57786,57787,9,5,-4
57787,57787,57788,5,3,-2
57788,57788,57789,3,5,2
57789,57789,57790,5,2,-3
57790,57790,57791,2,6,4
57791,57791,57792,6,7,1
57792,57792,57793,7,5,-2
57793,57793,57794,5,9,4
57794,57794,57795,9,0,-9
57795,57795,57796,0,9,9
57796,57796,57797,9,1,-8
57797,57797,57798,1,0,-1
57798,57798,57799,0,2,2
57799,57799,57800,2,8,6
57800,57800,57801,8,3,-5
57801,57801,57802,3,6,3
57802,57802,57803,6,4,-2
57803,57803,57804,4,3,-1
57804,57804,57805,3,5,2
57805,57805,57806,5,3,-2
57806,57806,57807,3,6,3
57807,57807,57808,6,2,-4
57808,57808,57809,2,7,5
57809,57809,57810,7,0,-7
57810,57810,57811,0,0,0
57811,57811,57812,0,5,5
57812,57812,57813,5,1,-4
57813,57813,57814,1,5,4
57814,57814,57815,5,2,-3
57815,57815,57816,2,1,-1
57816,57816,57817,1,3,2
57817,57817,57818,3,5,2
57818,57818,57819,5,4,-1
57819,57819,57820,4,3,-1
57820,57820,57821,3,5,2
57821,57821,57822,5,0,-5
57822,57822,57823,0,6,6
57823,57823,57824,6,5,-1
57824,57824,57825,5,7,2
57825,57825,57826,7,8,1
57826,57826,57827,8,0,-8
57827,57827,57828,0,7,7
57828,57828,57829,7,1,-6
57829,57829,57830,1,1,0
57830,57830,57831,1,2,1
57831,57831,57832,2,8,6
57832,57832,57833,8,3,-5
57833,57833,57834,3,1,-2
57834,57834,57835,1,4,3
57835,57835,57836,4,7,3
57836,57836,57837,7,5,-2
57837,57837,57838,5,2,-3
57838,57838,57839,2,7,5
57839,57839,57840,7,4,-3
57840,57840,57841,4,4,0
57841,57841,57842,4,6,2
57842,57842,57843,6,0,-6
57843,57843,57844,0,4,4
57844,57844,57845,4,4,0
57845,57845,57846,4,6,2
57846,57846,57847,6,0,-6
57847,57847,57848,0,5,5
57848,57848,57849,5,1,-4
57849,57849,57850,1,6,5
57850,57850,57851,6,7,1
57851,57851,57852,7,5,-2
57852,57852,57853,5,5,0
57853,57853,57854,5,9,4
57854,57854,57855,9,1,-8
57855,57855,57856,1,3,2
57856,57856,57857,3,4,1
57857,57857,57858,4,7,3
57858,57858,57859,7,2,-5
57859,57859,57860,2,6,4
57860,57860,57861,6,4,-2
57861,57861,57862,4,4,0
57862,57862,57863,4,3,-1
57863,57863,57864,3,3,0
57864,57864,57865,3,1,-2
57865,57865,57866,1,7,6
57866,57866,57867,7,7,0
57867,57867,57868,7,3,-4
57868,57868,57869,3,8,5
57869,57869,57870,8,8,0
57870,57870,57871,8,2,-6
57871,57871,57872,2,3,1
57872,57872,57873,3,4,1
57873,57873,57874,4,9,5
57874,57874,57875,9,4,-5
57875,57875,57876,4,2,-2
57876,57876,57877,2,3,1
57877,57877,57878,3,2,-1
57878,57878,57879,2,3,1
57879,57879,57880,3,9,6
57880,57880,57881,9,6,-3
57881,57881,57882,6,0,-6
57882,57882,57883,0,6,6
57883,57883,57884,6,7,1
57884,57884,57885,7,7,0
57885,57885,57886,7,3,-4
57886,57886,57887,3,0,-3
57887,57887,57888,0,1,1
57888,57888,57889,1,2,1
57889,57889,57890,2,2,0
57890,57890,57891,2,6,4
57891,57891,57892,6,4,-2
57892,57892,57893,4,3,-1
57893,57893,57894,3,2,-1
57894,57894,57895,2,9,7
57895,57895,57896,9,9,0
57896,57896,57897,9,3,-6
57897,57897,57898,3,8,5
57898,57898,57899,8,2,-6
57899,57899,57900,2,5,3
57900,57900,57901,5,8,3
57901,57901,57902,8,5,-3
57902,57902,57903,5,1,-4
57903,57903,57904,1,2,1
57904,57904,57905,2,7,5
57905,57905,57906,7,1,-6
57906,57906,57907,1,0,-1
57907,57907,57908,0,2,2
57908,57908,57909,2,3,1
57909,57909,57910,3,2,-1
57910,57910,57911,2,2,0
57911,57911,57912,2,0,-2
57912,57912,57913,0,9,9
57913,57913,57914,9,3,-6
57914,57914,57915,3,4,1
57915,57915,57916,4,0,-4
57916,57916,57917,0,0,0
57917,57917,57918,0,8,8
57918,57918,57919,8,3,-5
57919,57919,57920,3,3,0
57920,57920,57921,3,7,4
57921,57921,57922,7,8,1
57922,57922,57923,8,7,-1
57923,57923,57924,7,0,-7
57924,57924,57925,0,7,7
57925,57925,57926,7,5,-2
57926,57926,57927,5,7,2
57927,57927,57928,7,2,-5
57928,57928,57929,2,1,-1
57929,57929,57930,1,2,1
57930,57930,57931,2,1,-1
57931,57931,57932,1,3,2
57932,57932,57933,3,2,-1
57933,57933,57934,2,4,2
57934,57934,57935,4,6,2
57935,57935,57936,6,2,-4
57936,57936,57937,2,4,2
57937,57937,57938,4,4,0
57938,57938,57939,4,2,-2
57939,57939,57940,2,4,2
57940,57940,57941,4,3,-1
57941,57941,57942,3,5,2
57942,57942,57943,5,6,1
57943,57943,57944,6,5,-1
57944,57944,57945,5,6,1
57945,57945,57946,6,4,-2
57946,57946,57947,4,5,1
57947,57947,57948,5,1,-4
57948,57948,57949,1,7,6
57949,57949,57950,7,4,-3
57950,57950,57951,4,5,1
57951,57951,57952,5,3,-2
57952,57952,57953,3,2,-1
57953,57953,57954,2,6,4
57954,57954,57955,6,8,2
57955,57955,57956,8,2,-6
57956,57956,57957,2,1,-1
57957,57957,57958,1,7,6
57958,57958,57959,7,6,-1
57959,57959,57960,6,1,-5
57960,57960,57961,1,1,0
57961,57961,57962,1,0,-1
57962,57962,57963,0,0,0
57963,57963,57964,0,2,2
57964,57964,57965,2,4,2
57965,57965,57966,4,2,-2
57966,57966,57967,2,3,1
57967,57967,57968,3,1,-2
57968,57968,57969,1,1,0
57969,57969,57970,1,7,6
57970,57970,57971,7,6,-1
57971,57971,57972,6,4,-2
57972,57972,57973,4,1,-3
57973,57973,57974,1,3,2
57974,57974,57975,3,9,6
57975,57975,57976,9,2,-7
57976,57976,57977,2,0,-2
57977,57977,57978,0,7,7
57978,57978,57979,7,1,-6
57979,57979,57980,1,7,6
57980,57980,57981,7,2,-5
57981,57981,57982,2,5,3
57982,57982,57983,5,3,-2
57983,57983,57984,3,8,5
57984,57984,57985,8,4,-4
57985,57985,57986,4,9,5
57986,57986,57987,9,5,-4
57987,57987,57988,5,8,3
57988,57988,57989,8,6,-2
57989,57989,57990,6,3,-3
57990,57990,57991,3,7,4
57991,57991,57992,7,2,-5
57992,57992,57993,2,8,6
57993,57993,57994,8,6,-2
57994,57994,57995,6,0,-6
57995,57995,57996,0,7,7
57996,57996,57997,7,1,-6
57997,57997,57998,1,1,0
57998,57998,57999,1,2,1
57999,57999,58000,2,2,0
58000,58000,58001,2,3,1
58001,58001,58002,3,0,-3
58002,58002,58003,0,4,4
58003,58003,58004,4,9,5
58004,58004,58005,9,5,-4
58005,58005,58006,5,9,4
58006,58006,58007,9,6,-3
58007,58007,58008,6,1,-5
58008,58008,58009,1,7,6
58009,58009,58010,7,6,-1
58010,58010,58011,6,8,2
58011,58011,58012,8,0,-8
58012,58012,58013,0,9,9
58013,58013,58014,9,0,-9
58014,58014,58015,0,0,0
58015,58015,58016,0,6,6
58016,58016,58017,6,1,-5
58017,58017,58018,1,4,3
58018,58018,58019,4,2,-2
58019,58019,58020,2,8,6
58020,58020,58021,8,3,-5
58021,58021,58022,3,1,-2
58022,58022,58023,1,4,3
58023,58023,58024,4,8,4
58024,58024,58025,8,5,-3
58025,58025,58026,5,2,-3
58026,58026,58027,2,6,4
58027,58027,58028,6,8,2
58028,58028,58029,8,7,-1
58029,58029,58030,7,2,-5
58030,58030,58031,2,8,6
58031,58031,58032,8,2,-6
58032,58032,58033,2,1,-1
58033,58033,58034,1,9,8
58034,58034,58035,9,0,-9
58035,58035,58036,0,0,0
58036,58036,58037,0,4,4
58037,58037,58038,4,0,-4
58038,58038,58039,0,5,5
58039,58039,58040,5,5,0
58040,58040,58041,5,6,1
58041,58041,58042,6,7,1
58042,58042,58043,7,6,-1
58043,58043,58044,6,2,-4
58044,58044,58045,2,3,1
58045,58045,58046,3,8,5
58046,58046,58047,8,4,-4
58047,58047,58048,4,3,-1
58048,58048,58049,3,4,1
58049,58049,58050,4,6,2
58050,58050,58051,6,1,-5
58051,58051,58052,1,1,0
58052,58052,58053,1,0,-1
58053,58053,58054,0,9,9
58054,58054,58055,9,6,-3
58055,58055,58056,6,1,-5
58056,58056,58057,1,4,3
58057,58057,58058,4,8,4
58058,58058,58059,8,9,1
58059,58059,58060,9,2,-7
58060,58060,58061,2,7,5
58061,58061,58062,7,0,-7
58062,58062,58063,0,2,2
58063,58063,58064,2,3,1
58064,58064,58065,3,3,0
58065,58065,58066,3,4,1
58066,58066,58067,4,3,-1
58067,58067,58068,3,2,-1
58068,58068,58069,2,9,7
58069,58069,58070,9,8,-1
58070,58070,58071,8,2,-6
58071,58071,58072,2,1,-1
58072,58072,58073,1,0,-1
58073,58073,58074,0,0,0
58074,58074,58075,0,9,9
58075,58075,58076,9,9,0
58076,58076,58077,9,3,-6
58077,58077,58078,3,7,4
58078,58078,58079,7,3,-4
58079,58079,58080,3,3,0
58080,58080,58081,3,9,6
58081,58081,58082,9,1,-8
58082,58082,58083,1,1,0
58083,58083,58084,1,3,2
58084,58084,58085,3,5,2
58085,58085,58086,5,3,-2
58086,58086,58087,3,2,-1
58087,58087,58088,2,9,7
58088,58088,58089,9,3,-6
58089,58089,58090,3,7,4
58090,58090,58091,7,1,-6
58091,58091,58092,1,7,6
58092,58092,58093,7,6,-1
58093,58093,58094,6,7,1
58094,58094,58095,7,7,0
58095,58095,58096,7,9,2
58096,58096,58097,9,3,-6
58097,58097,58098,3,2,-1
58098,58098,58099,2,7,5
58099,58099,58100,7,8,1
58100,58100,58101,8,4,-4
58101,58101,58102,4,0,-4
58102,58102,58103,0,2,2
58103,58103,58104,2,2,0
58104,58104,58105,2,4,2
58105,58105,58106,4,7,3
58106,58106,58107,7,8,1
58107,58107,58108,8,0,-8
58108,58108,58109,0,7,7
58109,58109,58110,7,0,-7
58110,58110,58111,0,6,6
58111,58111,58112,6,9,3
58112,58112,58113,9,3,-6
58113,58113,58114,3,2,-1
58114,58114,58115,2,6,4
58115,58115,58116,6,0,-6
58116,58116,58117,0,5,5
58117,58117,58118,5,7,2
58118,58118,58119,7,5,-2
58119,58119,58120,5,1,-4
58120,58120,58121,1,0,-1
58121,58121,58122,0,8,8
58122,58122,58123,8,1,-7
58123,58123,58124,1,6,5
58124,58124,58125,6,7,1
58125,58125,58126,7,2,-5
58126,58126,58127,2,9,7
58127,58127,58128,9,7,-2
58128,58128,58129,7,9,2
58129,58129,58130,9,5,-4
58130,58130,58131,5,8,3
58131,58131,58132,8,9,1
58132,58132,58133,9,6,-3
58133,58133,58134,6,5,-1
58134,58134,58135,5,2,-3
58135,58135,58136,2,6,4
58136,58136,58137,6,2,-4
58137,58137,58138,2,8,6
58138,58138,58139,8,1,-7
58139,58139,58140,1,7,6
58140,58140,58141,7,5,-2
58141,58141,58142,5,5,0
58142,58142,58143,5,7,2
58143,58143,58144,7,3,-4
58144,58144,58145,3,5,2
58145,58145,58146,5,0,-5
58146,58146,58147,0,1,1
58147,58147,58148,1,1,0
58148,58148,58149,1,3,2
58149,58149,58150,3,8,5
58150,58150,58151,8,4,-4
58151,58151,58152,4,9,5
58152,58152,58153,9,4,-5
58153,58153,58154,4,5,1
58154,58154,58155,5,1,-4
58155,58155,58156,1,8,7
58156,58156,58157,8,6,-2
58157,58157,58158,6,8,2
58158,58158,58159,8,9,1
58159,58159,58160,9,0,-9
58160,58160,58161,0,1,1
58161,58161,58162,1,2,1
58162,58162,58163,2,3,1
58163,58163,58164,3,4,1
58164,58164,58165,4,5,1
58165,58165,58166,5,6,1
58166,58166,58167,6,7,1
58167,58167,58168,7,8,1
58168,58168,58169,8,9,1
58169,58169,58170,9,0,-9
58170,58170,58171,0,1,1
58171,58171,58172,1,2,1
58172,58172,58173,2,3,1
58173,58173,58174,3,4,1
58174,58174,58175,4,5,1
58175,58175,58176,5,6,1
58176,58176,58177,6,7,1
58177,58177,58178,7,8,1
58178,58178,58179,8,9,1
58179,58179,58180,9,0,-9
58180,58180,58181,0,1,1
58181,58181,58182,1,2,1
58182,58182,58183,2,3,1
58183,58183,58184,3,4,1
58184,58184,58185,4,7,3
58185,58185,58186,7,8,1
58186,58186,58187,8,9,1
58187,58187,58188,9,7,-2
58188,58188,58189,7,1,-6
58189,58189,58190,1,5,4
58190,58190,58191,5,6,1
58191,58191,58192,6,2,-4
58192,58192,58193,2,5,3
58193,58193,58194,5,4,-1
58194,58194,58195,4,8,4
58195,58195,58196,8,1,-7
58196,58196,58197,1,7,6
58197,58197,58198,7,1,-6
58198,58198,58199,1,8,7
58199,58199,58200,8,3,-5
58200,58200,58201,3,8,5
58201,58201,58202,8,7,-1
58202,58202,58203,7,1,-6
58203,58203,58204,1,7,6
58204,58204,58205,7,7,0
58205,58205,58206,7,0,-7
58206,58206,58207,0,1,1
58207,58207,58208,1,4,3
58208,58208,58209,4,4,0
58209,58209,58210,4,4,0
58210,58210,58211,4,4,0
58211,58211,58212,4,4,0
58212,58212,58213,4,9,5
58213,58213,58214,9,7,-2
58214,58214,58215,7,2,-5
58215,58215,58216,2,6,4
58216,58216,58217,6,5,-1
58217,58217,58218,5,4,-1
58218,58218,58219,4,3,-1
58219,58219,58220,3,8,5
58220,58220,58221,8,7,-1
58221,58221,58222,7,9,2
58222,58222,58223,9,0,-9
58223,58223,58224,0,6,6
58224,58224,58225,6,4,-2
58225,58225,58226,4,6,2
58226,58226,58227,6,3,-3
58227,58227,58228,3,7,4
58228,58228,58229,7,0,-7
58229,58229,58230,0,1,1
58230,58230,58231,1,4,3
58231,58231,58232,4,8,4
58232,58232,58233,8,8,0
58233,58233,58234,8,1,-7
58234,58234,58235,1,2,1
58235,58235,58236,2,9,7
58236,58236,58237,9,3,-6
58237,58237,58238,3,1,-2
58238,58238,58239,1,8,7
58239,58239,58240,8,4,-4
58240,58240,58241,4,2,-2
58241,58241,58242,2,9,7
58242,58242,58243,9,9,0
58243,58243,58244,9,2,-7
58244,58244,58245,2,9,7
58245,58245,58246,9,6,-3
58246,58246,58247,6,0,-6
58247,58247,58248,0,5,5
58248,58248,58249,5,3,-2
58249,58249,58250,3,3,0
58250,58250,58251,3,6,3
58251,58251,58252,6,3,-3
58252,58252,58253,3,1,-2
58253,58253,58254,1,2,1
58254,58254,58255,2,5,3
58255,58255,58256,5,0,-5
58256,58256,58257,0,3,3
58257,58257,58258,3,7,4
58258,58258,58259,7,6,-1
58259,58259,58260,6,1,-5
58260,58260,58261,1,5,4
58261,58261,58262,5,5,0
58262,58262,58263,5,9,4
58263,58263,58264,9,9,0
58264,58264,58265,9,0,-9
58265,58265,58266,0,1,1
58266,58266,58267,1,2,1
58267,58267,58268,2,3,1
58268,58268,58269,3,4,1
58269,58269,58270,4,5,1
58270,58270,58271,5,6,1
58271,58271,58272,6,7,1
58272,58272,58273,7,8,1
58273,58273,58274,8,9,1
58274,58274,58275,9,0,-9
58275,58275,58276,0,1,1
58276,58276,58277,1,2,1
58277,58277,58278,2,3,1
58278,58278,58279,3,4,1
58279,58279,58280,4,5,1
58280,58280,58281,5,6,1
58281,58281,58282,6,7,1
58282,58282,58283,7,8,1
58283,58283,58284,8,9,1
58284,58284,58285,9,0,-9
58285,58285,58286,0,1,1
58286,58286,58287,1,2,1
58287,58287,58288,2,3,1
58288,58288,58289,3,4,1
58289,58289,58290,4,5,1
58290,58290,58291,5,6,1
58291,58291,58292,6,7,1
58292,58292,58293,7,8,1
58293,58293,58294,8,9,1
58294,58294,58295,9,6,-3
58295,58295,58296,6,8,2
58296,58296,58297,8,2,-6
58297,58297,58298,2,3,1
58298,58298,58299,3,7,4
58299,58299,58300,7,4,-3
58300,58300,58301,4,6,2
58301,58301,58302,6,8,2
58302,58302,58303,8,6,-2
58303,58303,58304,6,6,0
58304,58304,58305,6,8,2
58305,58305,58306,8,0,-8
58306,58306,58307,0,1,1
58307,58307,58308,1,7,6
58308,58308,58309,7,1,-6
58309,58309,58310,1,7,6
58310,58310,58311,7,3,-4
58311,58311,58312,3,5,2
58312,58312,58313,5,0,-5
58313,58313,58314,0,2,2
58314,58314,58315,2,2,0
58315,58315,58316,2,0,-2
58316,58316,58317,0,2,2
58317,58317,58318,2,5,3
58318,58318,58319,5,4,-1
58319,58319,58320,4,1,-3
58320,58320,58321,1,5,4
58321,58321,58322,5,1,-4
58322,58322,58323,1,2,1
58323,58323,58324,2,3,1
58324,58324,58325,3,4,1
58325,58325,58326,4,8,4
58326,58326,58327,8,3,-5
58327,58327,58328,3,3,0
58328,58328,58329,3,6,3
58329,58329,58330,6,5,-1
58330,58330,58331,5,9,4
58331,58331,58332,9,9,0
58332,58332,58333,9,3,-6
58333,58333,58334,3,8,5
58334,58334,58335,8,1,-7
58335,58335,58336,1,3,2
58336,58336,58337,3,7,4
58337,58337,58338,7,9,2
58338,58338,58339,9,3,-6
58339,58339,58340,3,4,1
58340,58340,58341,4,1,-3
58341,58341,58342,1,7,6
58342,58342,58343,7,3,-4
58343,58343,58344,3,9,6
58344,58344,58345,9,6,-3
58345,58345,58346,6,7,1
58346,58346,58347,7,4,-3
58347,58347,58348,4,9,5
58348,58348,58349,9,7,-2
58349,58349,58350,7,0,-7
58350,58350,58351,0,9,9
58351,58351,58352,9,6,-3
58352,58352,58353,6,0,-6
58353,58353,58354,0,6,6
58354,58354,58355,6,1,-5
58355,58355,58356,1,0,-1
58356,58356,58357,0,5,5
58357,58357,58358,5,8,3
58358,58358,58359,8,5,-3
58359,58359,58360,5,0,-5
58360,58360,58361,0,1,1
58361,58361,58362,1,0,-1
58362,58362,58363,0,9,9
58363,58363,58364,9,4,-5
58364,58364,58365,4,5,1
58365,58365,58366,5,9,4
58366,58366,58367,9,7,-2
58367,58367,58368,7,1,-6
58368,58368,58369,1,9,8
58369,58369,58370,9,6,-3
58370,58370,58371,6,8,2
58371,58371,58372,8,9,1
58372,58372,58373,9,2,-7
58373,58373,58374,2,8,6
58374,58374,58375,8,5,-3
58375,58375,58376,5,0,-5
58376,58376,58377,0,1,1
58377,58377,58378,1,2,1
58378,58378,58379,2,3,1
58379,58379,58380,3,4,1
58380,58380,58381,4,5,1
58381,58381,58382,5,6,1
58382,58382,58383,6,7,1
58383,58383,58384,7,8,1
58384,58384,58385,8,9,1
58385,58385,58386,9,0,-9
58386,58386,58387,0,1,1
58387,58387,58388,1,2,1
58388,58388,58389,2,3,1
58389,58389,58390,3,4,1
58390,58390,58391,4,5,1
58391,58391,58392,5,6,1
58392,58392,58393,6,7,1
58393,58393,58394,7,8,1
58394,58394,58395,8,9,1
58395,58395,58396,9,0,-9
58396,58396,58397,0,1,1
58397,58397,58398,1,2,1
58398,58398,58399,2,3,1
58399,58399,58400,3,4,1
58400,58400,58401,4,9,5
58401,58401,58402,9,0,-9
58402,58402,58403,0,5,5
58403,58403,58404,5,6,1
58404,58404,58405,6,8,2
58405,58405,58406,8,3,-5
58406,58406,58407,3,9,6
58407,58407,58408,9,0,-9
58408,58408,58409,0,2,2
58409,58409,58410,2,3,1
58410,58410,58411,3,3,0
58411,58411,58412,3,3,0
58412,58412,58413,3,9,6
58413,58413,58414,9,5,-4
58414,58414,58415,5,6,1
58415,58415,58416,6,4,-2
58416,58416,58417,4,4,0
58417,58417,58418,4,2,-2
58418,58418,58419,2,5,3
58419,58419,58420,5,4,-1
58420,58420,58421,4,3,-1
58421,58421,58422,3,9,6
58422,58422,58423,9,6,-3
58423,58423,58424,6,8,2
58424,58424,58425,8,7,-1
58425,58425,58426,7,9,2
58426,58426,58427,9,1,-8
58427,58427,58428,1,5,4
58428,58428,58429,5,2,-3
58429,58429,58430,2,6,4
58430,58430,58431,6,3,-3
58431,58431,58432,3,4,1
58432,58432,58433,4,4,0
58433,58433,58434,4,1,-3
58434,58434,58435,1,6,5
58435,58435,58436,6,4,-2
58436,58436,58437,4,9,5
58437,58437,58438,9,6,-3
58438,58438,58439,6,5,-1
58439,58439,58440,5,1,-4
58440,58440,58441,1,2,1
58441,58441,58442,2,6,4
58442,58442,58443,6,6,0
58443,58443,58444,6,7,1
58444,58444,58445,7,8,1
58445,58445,58446,8,8,0
58446,58446,58447,8,1,-7
58447,58447,58448,1,8,7
58448,58448,58449,8,3,-5
58449,58449,58450,3,7,4
58450,58450,58451,7,1,-6
58451,58451,58452,1,2,1
58452,58452,58453,2,7,5
58453,58453,58454,7,0,-7
58454,58454,58455,0,7,7
58455,58455,58456,7,5,-2
58456,58456,58457,5,0,-5
58457,58457,58458,0,0,0
58458,58458,58459,0,1,1
58459,58459,58460,1,5,4
58460,58460,58461,5,0,-5
58461,58461,58462,0,0,0
58462,58462,58463,0,4,4
58463,58463,58464,4,8,4
58464,58464,58465,8,3,-5
58465,58465,58466,3,1,-2
58466,58466,58467,1,8,7
58467,58467,58468,8,2,-6
58468,58468,58469,2,9,7
58469,58469,58470,9,9,0
58470,58470,58471,9,5,-4
58471,58471,58472,5,2,-3
58472,58472,58473,2,6,4
58473,58473,58474,6,4,-2
58474,58474,58475,4,8,4
58475,58475,58476,8,2,-6
58476,58476,58477,2,5,3
58477,58477,58478,5,4,-1
58478,58478,58479,4,1,-3
58479,58479,58480,1,7,6
58480,58480,58481,7,1,-6
58481,58481,58482,1,4,3
58482,58482,58483,4,3,-1
58483,58483,58484,3,9,6
58484,58484,58485,9,7,-2
58485,58485,58486,7,1,-6
58486,58486,58487,1,2,1
58487,58487,58488,2,6,4
58488,58488,58489,6,0,-6
58489,58489,58490,0,7,7
58490,58490,58491,7,3,-4
58491,58491,58492,3,0,-3
58492,58492,58493,0,1,1
58493,58493,58494,1,2,1
58494,58494,58495,2,3,1
58495,58495,58496,3,4,1
58496,58496,58497,4,7,3
58497,58497,58498,7,8,1
58498,58498,58499,8,9,1
58499,58499,58500,9,0,-9
58500,58500,58501,0,1,1
58501,58501,58502,1,2,1
58502,58502,58503,2,3,1
58503,58503,58504,3,4,1
58504,58504,58505,4,5,1
58505,58505,58506,5,6,1
58506,58506,58507,6,7,1
58507,58507,58508,7,8,1
58508,58508,58509,8,9,1
58509,58509,58510,9,0,-9
58510,58510,58511,0,1,1
58511,58511,58512,1,2,1
58512,58512,58513,2,3,1
58513,58513,58514,3,4,1
58514,58514,58515,4,5,1
58515,58515,58516,5,6,1
58516,58516,58517,6,7,1
58517,58517,58518,7,8,1
58518,58518,58519,8,9,1
58519,58519,58520,9,7,-2
58520,58520,58521,7,0,-7
58521,58521,58522,0,6,6
58522,58522,58523,6,0,-6
58523,58523,58524,0,7,7
58524,58524,58525,7,3,-4
58525,58525,58526,3,7,4
58526,58526,58527,7,3,-4
58527,58527,58528,3,7,4
58528,58528,58529,7,9,2
58529,58529,58530,9,7,-2
58530,58530,58531,7,4,-3
58531,58531,58532,4,0,-4
58532,58532,58533,0,2,2
58533,58533,58534,2,6,4
58534,58534,58535,6,5,-1
58535,58535,58536,5,6,1
58536,58536,58537,6,5,-1
58537,58537,58538,5,2,-3
58538,58538,58539,2,9,7
58539,58539,58540,9,5,-4
58540,58540,58541,5,3,-2
58541,58541,58542,3,9,6
58542,58542,58543,9,8,-1
58543,58543,58544,8,3,-5
58544,58544,58545,3,4,1
58545,58545,58546,4,0,-4
58546,58546,58547,0,5,5
58547,58547,58548,5,4,-1
58548,58548,58549,4,6,2
58549,58549,58550,6,3,-3
58550,58550,58551,3,4,1
58551,58551,58552,4,8,4
58552,58552,58553,8,0,-8
58553,58553,58554,0,6,6
58554,58554,58555,6,4,-2
58555,58555,58556,4,8,4
58556,58556,58557,8,1,-7
58557,58557,58558,1,3,2
58558,58558,58559,3,4,1
58559,58559,58560,4,0,-4
58560,58560,58561,0,1,1
58561,58561,58562,1,9,8
58562,58562,58563,9,2,-7
58563,58563,58564,2,3,1
58564,58564,58565,3,7,4
58565,58565,58566,7,9,2
58566,58566,58567,9,1,-8
58567,58567,58568,1,2,1
58568,58568,58569,2,5,3
58569,58569,58570,5,1,-4
58570,58570,58571,1,7,6
58571,58571,58572,7,2,-5
58572,58572,58573,2,8,6
58573,58573,58574,8,7,-1
58574,58574,58575,7,0,-7
58575,58575,58576,0,1,1
58576,58576,58577,1,9,8
58577,58577,58578,9,6,-3
58578,58578,58579,6,4,-2
58579,58579,58580,4,1,-3
58580,58580,58581,1,2,1
58581,58581,58582,2,3,1
58582,58582,58583,3,7,4
58583,58583,58584,7,0,-7
58584,58584,58585,0,2,2
58585,58585,58586,2,1,-1
58586,58586,58587,1,3,2
58587,58587,58588,3,1,-2
58588,58588,58589,1,7,6
58589,58589,58590,7,2,-5
58590,58590,58591,2,1,-1
58591,58591,58592,1,6,5
58592,58592,58593,6,8,2
58593,58593,58594,8,0,-8
58594,58594,58595,0,8,8
58595,58595,58596,8,9,1
58596,58596,58597,9,1,-8
58597,58597,58598,1,6,5
58598,58598,58599,6,0,-6
58599,58599,58600,0,1,1
58600,58600,58601,1,2,1
58601,58601,58602,2,3,1
58602,58602,58603,3,4,1
58603,58603,58604,4,5,1
58604,58604,58605,5,6,1
58605,58605,58606,6,7,1
58606,58606,58607,7,8,1
58607,58607,58608,8,9,1
58608,58608,58609,9,0,-9
58609,58609,58610,0,1,1
58610,58610,58611,1,2,1
58611,58611,58612,2,3,1
58612,58612,58613,3,4,1
58613,58613,58614,4,7,3
58614,58614,58615,7,8,1
58615,58615,58616,8,9,1
58616,58616,58617,9,0,-9
58617,58617,58618,0,1,1
58618,58618,58619,1,2,1
58619,58619,58620,2,3,1
58620,58620,58621,3,4,1
58621,58621,58622,4,5,1
58622,58622,58623,5,6,1
58623,58623,58624,6,7,1
58624,58624,58625,7,8,1
58625,58625,58626,8,6,-2
58626,58626,58627,6,4,-2
58627,58627,58628,4,2,-2
58628,58628,58629,2,6,4
58629,58629,58630,6,4,-2
58630,58630,58631,4,7,3
58631,58631,58632,7,5,-2
58632,58632,58633,5,5,0
58633,58633,58634,5,4,-1
58634,58634,58635,4,7,3
58635,58635,58636,7,8,1
58636,58636,58637,8,9,1
58637,58637,58638,9,2,-7
58638,58638,58639,2,9,7
58639,58639,58640,9,3,-6
58640,58640,58641,3,9,6
58641,58641,58642,9,3,-6
58642,58642,58643,3,8,5
58643,58643,58644,8,2,-6
58644,58644,58645,2,0,-2
58645,58645,58646,0,5,5
58646,58646,58647,5,0,-5
58647,58647,58648,0,7,7
58648,58648,58649,7,0,-7
58649,58649,58650,0,4,4
58650,58650,58651,4,2,-2
58651,58651,58652,2,6,4
58652,58652,58653,6,5,-1
58653,58653,58654,5,3,-2
58654,58654,58655,3,5,2
58655,58655,58656,5,3,-2
58656,58656,58657,3,8,5
58657,58657,58658,8,0,-8
58658,58658,58659,0,0,0
58659,58659,58660,0,3,3
58660,58660,58661,3,4,1
58661,58661,58662,4,1,-3
58662,58662,58663,1,5,4
58663,58663,58664,5,3,-2
58664,58664,58665,3,0,-3
58665,58665,58666,0,8,8
58666,58666,58667,8,3,-5
58667,58667,58668,3,0,-3
58668,58668,58669,0,6,6
58669,58669,58670,6,2,-4
58670,58670,58671,2,7,5
58671,58671,58672,7,1,-6
58672,58672,58673,1,1,0
58673,58673,58674,1,8,7
58674,58674,58675,8,1,-7
58675,58675,58676,1,7,6
58676,58676,58677,7,1,-6
58677,58677,58678,1,3,2
58678,58678,58679,3,8,5
58679,58679,58680,8,9,1
58680,58680,58681,9,7,-2
58681,58681,58682,7,6,-1
58682,58682,58683,6,7,1
58683,58683,58684,7,4,-3
58684,58684,58685,4,1,-3
58685,58685,58686,1,6,5
58686,58686,58687,6,7,1
58687,58687,58688,7,5,-2
58688,58688,58689,5,1,-4
58689,58689,58690,1,7,6
58690,58690,58691,7,1,-6
58691,58691,58692,1,9,8
58692,58692,58693,9,8,-1
58693,58693,58694,8,0,-8
58694,58694,58695,0,6,6
58695,58695,58696,6,9,3
58696,58696,58697,9,4,-5
58697,58697,58698,4,9,5
58698,58698,58699,9,9,0
58699,58699,58700,9,3,-6
58700,58700,58701,3,7,4
58701,58701,58702,7,1,-6
58702,58702,58703,1,9,8
58703,58703,58704,9,2,-7
58704,58704,58705,2,2,0
58705,58705,58706,2,5,3
58706,58706,58707,5,3,-2
58707,58707,58708,3,7,4
58708,58708,58709,7,8,1
58709,58709,58710,8,2,-6
58710,58710,58711,2,3,1
58711,58711,58712,3,4,1
58712,58712,58713,4,5,1
58713,58713,58714,5,6,1
58714,58714,58715,6,7,1
58715,58715,58716,7,8,1
58716,58716,58717,8,9,1
58717,58717,58718,9,0,-9
58718,58718,58719,0,1,1
58719,58719,58720,1,2,1
58720,58720,58721,2,3,1
58721,58721,58722,3,4,1
58722,58722,58723,4,5,1
58723,58723,58724,5,6,1
58724,58724,58725,6,7,1
58725,58725,58726,7,0,-7
58726,58726,58727,0,1,1
58727,58727,58728,1,2,1
58728,58728,58729,2,3,1
58729,58729,58730,3,4,1
58730,58730,58731,4,5,1
58731,58731,58732,5,6,1
58732,58732,58733,6,7,1
58733,58733,58734,7,8,1
58734,58734,58735,8,9,1
58735,58735,58736,9,8,-1
58736,58736,58737,8,1,-7
58737,58737,58738,1,0,-1
58738,58738,58739,0,5,5
58739,58739,58740,5,5,0
58740,58740,58741,5,1,-4
58741,58741,58742,1,9,8
58742,58742,58743,9,0,-9
58743,58743,58744,0,4,4
58744,58744,58745,4,1,-3
58745,58745,58746,1,9,8
58746,58746,58747,9,3,-6
58747,58747,58748,3,8,5
58748,58748,58749,8,4,-4
58749,58749,58750,4,7,3
58750,58750,58751,7,7,0
58751,58751,58752,7,8,1
58752,58752,58753,8,5,-3
58753,58753,58754,5,0,-5
58754,58754,58755,0,6,6
58755,58755,58756,6,5,-1
58756,58756,58757,5,5,0
58757,58757,58758,5,3,-2
58758,58758,58759,3,3,0
58759,58759,58760,3,3,0
58760,58760,58761,3,9,6
58761,58761,58762,9,8,-1
58762,58762,58763,8,1,-7
58763,58763,58764,1,4,3
58764,58764,58765,4,0,-4
58765,58765,58766,0,6,6
58766,58766,58767,6,1,-5
58767,58767,58768,1,0,-1
58768,58768,58769,0,0,0
58769,58769,58770,0,6,6
58770,58770,58771,6,2,-4
58771,58771,58772,2,1,-1
58772,58772,58773,1,1,0
58773,58773,58774,1,3,2
58774,58774,58775,3,2,-1
58775,58775,58776,2,8,6
58776,58776,58777,8,8,0
58777,58777,58778,8,7,-1
58778,58778,58779,7,8,1
58779,58779,58780,8,4,-4
58780,58780,58781,4,6,2
58781,58781,58782,6,0,-6
58782,58782,58783,0,2,2
58783,58783,58784,2,0,-2
58784,58784,58785,0,3,3
58785,58785,58786,3,6,3
58786,58786,58787,6,8,2
58787,58787,58788,8,7,-1
58788,58788,58789,7,1,-6
58789,58789,58790,1,5,4
58790,58790,58791,5,9,4
58791,58791,58792,9,9,0
58792,58792,58793,9,3,-6
58793,58793,58794,3,2,-1
58794,58794,58795,2,4,2
58795,58795,58796,4,9,5
58796,58796,58797,9,4,-5
58797,58797,58798,4,6,2
58798,58798,58799,6,5,-1
58799,58799,58800,5,3,-2
58800,58800,58801,3,2,-1
58801,58801,58802,2,5,3
58802,58802,58803,5,5,0
58803,58803,58804,5,9,4
58804,58804,58805,9,4,-5
58805,58805,58806,4,1,-3
58806,58806,58807,1,6,5
58807,58807,58808,6,5,-1
58808,58808,58809,5,0,-5
58809,58809,58810,0,1,1
58810,58810,58811,1,2,1
58811,58811,58812,2,3,1
58812,58812,58813,3,4,1
58813,58813,58814,4,5,1
58814,58814,58815,5,6,1
58815,58815,58816,6,7,1
58816,58816,58817,7,8,1
58817,58817,58818,8,9,1
58818,58818,58819,9,0,-9
58819,58819,58820,0,1,1
58820,58820,58821,1,2,1
58821,58821,58822,2,3,1
58822,58822,58823,3,4,1
58823,58823,58824,4,5,1
58824,58824,58825,5,6,1
58825,58825,58826,6,7,1
58826,58826,58827,7,8,1
58827,58827,58828,8,9,1
58828,58828,58829,9,0,-9
58829,58829,58830,0,1,1
58830,58830,58831,1,2,1
58831,58831,58832,2,3,1
58832,58832,58833,3,4,1
58833,58833,58834,4,5,1
58834,58834,58835,5,6,1
58835,58835,58836,6,7,1
58836,58836,58837,7,8,1
58837,58837,58838,8,9,1
58838,58838,58839,9,6,-3
58839,58839,58840,6,4,-2
58840,58840,58841,4,2,-2
58841,58841,58842,2,6,4
58842,58842,58843,6,4,-2
58843,58843,58844,4,7,3
58844,58844,58845,7,5,-2
58845,58845,58846,5,5,0
58846,58846,58847,5,4,-1
58847,58847,58848,4,7,3
58848,58848,58849,7,8,1
58849,58849,58850,8,9,1
58850,58850,58851,9,2,-7
58851,58851,58852,2,9,7
58852,58852,58853,9,3,-6
58853,58853,58854,3,9,6
58854,58854,58855,9,3,-6
58855,58855,58856,3,8,5
58856,58856,58857,8,2,-6
58857,58857,58858,2,0,-2
58858,58858,58859,0,9,9
58859,58859,58860,9,8,-1
58860,58860,58861,8,0,-8
58861,58861,58862,0,5,5
58862,58862,58863,5,6,1
58863,58863,58864,6,0,-6
58864,58864,58865,0,1,1
58865,58865,58866,1,0,-1
58866,58866,58867,0,4,4
58867,58867,58868,4,2,-2
58868,58868,58869,2,6,4
58869,58869,58870,6,5,-1
58870,58870,58871,5,5,0
58871,58871,58872,5,5,0
58872,58872,58873,5,4,-1
58873,58873,58874,4,3,-1
58874,58874,58875,3,4,1
58875,58875,58876,4,1,-3
58876,58876,58877,1,5,4
58877,58877,58878,5,3,-2
58878,58878,58879,3,0,-3
58879,58879,58880,0,8,8
58880,58880,58881,8,3,-5
58881,58881,58882,3,0,-3
58882,58882,58883,0,6,6
58883,58883,58884,6,2,-4
58884,58884,58885,2,7,5
58885,58885,58886,7,1,-6
58886,58886,58887,1,1,0
58887,58887,58888,1,8,7
58888,58888,58889,8,1,-7
58889,58889,58890,1,7,6
58890,58890,58891,7,1,-6
58891,58891,58892,1,3,2
58892,58892,58893,3,8,5
58893,58893,58894,8,5,-3
58894,58894,58895,5,4,-1
58895,58895,58896,4,2,-2
58896,58896,58897,2,0,-2
58897,58897,58898,0,9,9
58898,58898,58899,9,7,-2
58899,58899,58900,7,6,-1
58900,58900,58901,6,7,1
58901,58901,58902,7,4,-3
58902,58902,58903,4,1,-3
58903,58903,58904,1,6,5
58904,58904,58905,6,8,2
58905,58905,58906,8,4,-4
58906,58906,58907,4,7,3
58907,58907,58908,7,5,-2
58908,58908,58909,5,1,-4
58909,58909,58910,1,2,1
58910,58910,58911,2,6,4
58911,58911,58912,6,7,1
58912,58912,58913,7,1,-6
58913,58913,58914,1,9,8
58914,58914,58915,9,8,-1
58915,58915,58916,8,0,-8
58916,58916,58917,0,6,6
58917,58917,58918,6,9,3
58918,58918,58919,9,4,-5
58919,58919,58920,4,9,5
58920,58920,58921,9,9,0
58921,58921,58922,9,6,-3
58922,58922,58923,6,2,-4
58923,58923,58924,2,3,1
58924,58924,58925,3,7,4
58925,58925,58926,7,1,-6
58926,58926,58927,1,9,8
58927,58927,58928,9,2,-7
58928,58928,58929,2,2,0
58929,58929,58930,2,5,3
58930,58930,58931,5,3,-2
58931,58931,58932,3,7,4
58932,58932,58933,7,8,1
58933,58933,58934,8,0,-8
58934,58934,58935,0,1,1
58935,58935,58936,1,2,1
58936,58936,58937,2,3,1
58937,58937,58938,3,4,1
58938,58938,58939,4,5,1
58939,58939,58940,5,6,1
58940,58940,58941,6,7,1
58941,58941,58942,7,8,1
58942,58942,58943,8,0,-8
58943,58943,58944,0,1,1
58944,58944,58945,1,2,1
58945,58945,58946,2,3,1
58946,58946,58947,3,4,1
58947,58947,58948,4,5,1
58948,58948,58949,5,6,1
58949,58949,58950,6,7,1
58950,58950,58951,7,8,1
58951,58951,58952,8,0,-8
58952,58952,58953,0,1,1
58953,58953,58954,1,2,1
58954,58954,58955,2,3,1
58955,58955,58956,3,4,1
58956,58956,58957,4,5,1
58957,58957,58958,5,6,1
58958,58958,58959,6,7,1
58959,58959,58960,7,8,1
58960,58960,58961,8,9,1
58961,58961,58962,9,2,-7
58962,58962,58963,2,1,-1
58963,58963,58964,1,2,1
58964,58964,58965,2,1,-1
58965,58965,58966,1,3,2
58966,58966,58967,3,9,6
58967,58967,58968,9,9,0
58968,58968,58969,9,8,-1
58969,58969,58970,8,5,-3
58970,58970,58971,5,3,-2
58971,58971,58972,3,7,4
58972,58972,58973,7,0,-7
58973,58973,58974,0,7,7
58974,58974,58975,7,7,0
58975,58975,58976,7,5,-2
58976,58976,58977,5,7,2
58977,58977,58978,7,9,2
58978,58978,58979,9,9,0
58979,58979,58980,9,4,-5
58980,58980,58981,4,7,3
58981,58981,58982,7,0,-7
58982,58982,58983,0,3,3
58983,58983,58984,3,4,1
58984,58984,58985,4,1,-3
58985,58985,58986,1,4,3
58986,58986,58987,4,4,0
58987,58987,58988,4,7,3
58988,58988,58989,7,5,-2
58989,58989,58990,5,8,3
58990,58990,58991,8,1,-7
58991,58991,58992,1,4,3
58992,58992,58993,4,8,4
58993,58993,58994,8,4,-4
58994,58994,58995,4,1,-3
58995,58995,58996,1,8,7
58996,58996,58997,8,6,-2
58997,58997,58998,6,6,0
58998,58998,58999,6,4,-2
58999,58999,59000,4,6,2
59000,59000,59001,6,3,-3
59001,59001,59002,3,5,2
59002,59002,59003,5,7,2
59003,59003,59004,7,2,-5
59004,59004,59005,2,5,3
59005,59005,59006,5,9,4
59006,59006,59007,9,2,-7
59007,59007,59008,2,6,4
59008,59008,59009,6,2,-4
59009,59009,59010,2,1,-1
59010,59010,59011,1,2,1
59011,59011,59012,2,0,-2
59012,59012,59013,0,8,8
59013,59013,59014,8,3,-5
59014,59014,59015,3,8,5
59015,59015,59016,8,3,-5
59016,59016,59017,3,0,-3
59017,59017,59018,0,8,8
59018,59018,59019,8,7,-1
59019,59019,59020,7,4,-3
59020,59020,59021,4,9,5
59021,59021,59022,9,5,-4
59022,59022,59023,5,0,-5
59023,59023,59024,0,9,9
59024,59024,59025,9,7,-2
59025,59025,59026,7,4,-3
59026,59026,59027,4,9,5
59027,59027,59028,9,1,-8
59028,59028,59029,1,6,5
59029,59029,59030,6,2,-4
59030,59030,59031,2,7,5
59031,59031,59032,7,6,-1
59032,59032,59033,6,1,-5
59033,59033,59034,1,8,7
59034,59034,59035,8,6,-2
59035,59035,59036,6,1,-5
59036,59036,59037,1,0,-1
59037,59037,59038,0,3,3
59038,59038,59039,3,6,3
59039,59039,59040,6,2,-4
59040,59040,59041,2,1,-1
59041,59041,59042,1,4,3
59042,59042,59043,4,0,-4
59043,59043,59044,0,1,1
59044,59044,59045,1,2,1
59045,59045,59046,2,3,1
59046,59046,59047,3,4,1
59047,59047,59048,4,7,3
59048,59048,59049,7,8,1
59049,59049,59050,8,9,1
59050,59050,59051,9,0,-9
59051,59051,59052,0,1,1
59052,59052,59053,1,2,1
59053,59053,59054,2,3,1
59054,59054,59055,3,4,1
59055,59055,59056,4,7,3
59056,59056,59057,7,8,1
59057,59057,59058,8,9,1
59058,59058,59059,9,0,-9
59059,59059,59060,0,1,1
59060,59060,59061,1,2,1
59061,59061,59062,2,3,1
59062,59062,59063,3,4,1
59063,59063,59064,4,5,1
59064,59064,59065,5,6,1
59065,59065,59066,6,7,1
59066,59066,59067,7,8,1
59067,59067,59068,8,7,-1
59068,59068,59069,7,4,-3
59069,59069,59070,4,3,-1
59070,59070,59071,3,1,-2
59071,59071,59072,1,8,7
59072,59072,59073,8,6,-2
59073,59073,59074,6,1,-5
59074,59074,59075,1,9,8
59075,59075,59076,9,2,-7
59076,59076,59077,2,4,2
59077,59077,59078,4,0,-4
59078,59078,59079,0,9,9
59079,59079,59080,9,9,0
59080,59080,59081,9,3,-6
59081,59081,59082,3,7,4
59082,59082,59083,7,7,0
59083,59083,59084,7,9,2
59084,59084,59085,9,1,-8
59085,59085,59086,1,8,7
59086,59086,59087,8,4,-4
59087,59087,59088,4,7,3
59088,59088,59089,7,5,-2
59089,59089,59090,5,8,3
59090,59090,59091,8,5,-3
59091,59091,59092,5,3,-2
59092,59092,59093,3,2,-1
59093,59093,59094,2,2,0
59094,59094,59095,2,0,-2
59095,59095,59096,0,5,5
59096,59096,59097,5,8,3
59097,59097,59098,8,6,-2
59098,59098,59099,6,0,-6
59099,59099,59100,0,3,3
59100,59100,59101,3,8,5
59101,59101,59102,8,1,-7
59102,59102,59103,1,0,-1
59103,59103,59104,0,3,3
59104,59104,59105,3,0,-3
59105,59105,59106,0,4,4
59106,59106,59107,4,7,3
59107,59107,59108,7,4,-3
59108,59108,59109,4,9,5
59109,59109,59110,9,2,-7
59110,59110,59111,2,9,7
59111,59111,59112,9,1,-8
59112,59112,59113,1,2,1
59113,59113,59114,2,1,-1
59114,59114,59115,1,7,6
59115,59115,59116,7,1,-6
59116,59116,59117,1,6,5
59117,59117,59118,6,7,1
59118,59118,59119,7,3,-4
59119,59119,59120,3,3,0
59120,59120,59121,3,6,3
59121,59121,59122,6,2,-4
59122,59122,59123,2,8,6
59123,59123,59124,8,7,-1
59124,59124,59125,7,6,-1
59125,59125,59126,6,4,-2
59126,59126,59127,4,9,5
59127,59127,59128,9,8,-1
59128,59128,59129,8,8,0
59129,59129,59130,8,2,-6
59130,59130,59131,2,9,7
59131,59131,59132,9,6,-3
59132,59132,59133,6,5,-1
59133,59133,59134,5,5,0
59134,59134,59135,5,9,4
59135,59135,59136,9,5,-4
59136,59136,59137,5,3,-2
59137,59137,59138,3,7,4
59138,59138,59139,7,4,-3
59139,59139,59140,4,7,3
59140,59140,59141,7,6,-1
59141,59141,59142,6,0,-6
59142,59142,59143,0,0,0
59143,59143,59144,0,4,4
59144,59144,59145,4,6,2
59145,59145,59146,6,6,0
59146,59146,59147,6,9,3
59147,59147,59148,9,0,-9
59148,59148,59149,0,1,1
59149,59149,59150,1,1,0
59150,59150,59151,1,3,2
59151,59151,59152,3,2,-1
59152,59152,59153,2,1,-1
59153,59153,59154,1,0,-1
59154,59154,59155,0,0,0
59155,59155,59156,0,1,1
59156,59156,59157,1,2,1
59157,59157,59158,2,3,1
59158,59158,59159,3,4,1
59159,59159,59160,4,5,1
59160,59160,59161,5,6,1
59161,59161,59162,6,7,1
59162,59162,59163,7,8,1
59163,59163,59164,8,9,1
59164,59164,59165,9,0,-9
59165,59165,59166,0,1,1
59166,59166,59167,1,2,1
59167,59167,59168,2,3,1
59168,59168,59169,3,4,1
59169,59169,59170,4,5,1
59170,59170,59171,5,6,1
59171,59171,59172,6,7,1
59172,59172,59173,7,8,1
59173,59173,59174,8,9,1
59174,59174,59175,9,0,-9
59175,59175,59176,0,1,1
59176,59176,59177,1,2,1
59177,59177,59178,2,3,1
59178,59178,59179,3,4,1
59179,59179,59180,4,5,1
59180,59180,59181,5,6,1
59181,59181,59182,6,7,1
59182,59182,59183,7,8,1
59183,59183,59184,8,9,1
59184,59184,59185,9,4,-5
59185,59185,59186,4,2,-2
59186,59186,59187,2,0,-2
59187,59187,59188,0,2,2
59188,59188,59189,2,1,-1
59189,59189,59190,1,5,4
59190,59190,59191,5,9,4
59191,59191,59192,9,6,-3
59192,59192,59193,6,5,-1
59193,59193,59194,5,9,4
59194,59194,59195,9,3,-6
59195,59195,59196,3,5,2
59196,59196,59197,5,0,-5
59197,59197,59198,0,7,7
59198,59198,59199,7,1,-6
59199,59199,59200,1,1,0
59200,59200,59201,1,5,4
59201,59201,59202,5,3,-2
59202,59202,59203,3,0,-3
59203,59203,59204,0,7,7
59204,59204,59205,7,9,2
59205,59205,59206,9,6,-3
59206,59206,59207,6,1,-5
59207,59207,59208,1,6,5
59208,59208,59209,6,7,1
59209,59209,59210,7,4,-3
59210,59210,59211,4,9,5
59211,59211,59212,9,5,-4
59212,59212,59213,5,7,2
59213,59213,59214,7,9,2
59214,59214,59215,9,8,-1
59215,59215,59216,8,5,-3
59216,59216,59217,5,6,1
59217,59217,59218,6,2,-4
59218,59218,59219,2,4,2
59219,59219,59220,4,8,4
59220,59220,59221,8,9,1
59221,59221,59222,9,2,-7
59222,59222,59223,2,2,0
59223,59223,59224,2,8,6
59224,59224,59225,8,0,-8
59225,59225,59226,0,6,6
59226,59226,59227,6,4,-2
59227,59227,59228,4,3,-1
59228,59228,59229,3,3,0
59229,59229,59230,3,1,-2
59230,59230,59231,1,2,1
59231,59231,59232,2,4,2
59232,59232,59233,4,1,-3
59233,59233,59234,1,5,4
59234,59234,59235,5,8,3
59235,59235,59236,8,9,1
59236,59236,59237,9,6,-3
59237,59237,59238,6,9,3
59238,59238,59239,9,3,-6
59239,59239,59240,3,4,1
59240,59240,59241,4,0,-4
59241,59241,59242,0,3,3
59242,59242,59243,3,9,6
59243,59243,59244,9,0,-9
59244,59244,59245,0,2,2
59245,59245,59246,2,7,5
59246,59246,59247,7,1,-6
59247,59247,59248,1,1,0
59248,59248,59249,1,0,-1
59249,59249,59250,0,7,7
59250,59250,59251,7,6,-1
59251,59251,59252,6,2,-4
59252,59252,59253,2,2,0
59253,59253,59254,2,7,5
59254,59254,59255,7,6,-1
59255,59255,59256,6,0,-6
59256,59256,59257,0,6,6
59257,59257,59258,6,9,3
59258,59258,59259,9,4,-5
59259,59259,59260,4,8,4
59260,59260,59261,8,4,-4
59261,59261,59262,4,3,-1
59262,59262,59263,3,3,0
59263,59263,59264,3,7,4
59264,59264,59265,7,8,1
59265,59265,59266,8,1,-7
59266,59266,59267,1,0,-1
59267,59267,59268,0,4,4
59268,59268,59269,4,5,1
59269,59269,59270,5,8,3
59270,59270,59271,8,3,-5
59271,59271,59272,3,0,-3
59272,59272,59273,0,6,6
59273,59273,59274,6,8,2
59274,59274,59275,8,3,-5
59275,59275,59276,3,7,4
59276,59276,59277,7,8,1
59277,59277,59278,8,5,-3
59278,59278,59279,5,7,2
59279,59279,59280,7,8,1
59280,59280,59281,8,2,-6
59281,59281,59282,2,3,1
59282,59282,59283,3,4,1
59283,59283,59284,4,6,2
59284,59284,59285,6,7,1
59285,59285,59286,7,8,1
59286,59286,59287,8,9,1
59287,59287,59288,9,0,-9
59288,59288,59289,0,1,1
59289,59289,59290,1,2,1
59290,59290,59291,2,5,3
59291,59291,59292,5,6,1
59292,59292,59293,6,7,1
59293,59293,59294,7,8,1
59294,59294,59295,8,9,1
59295,59295,59296,9,0,-9
59296,59296,59297,0,1,1
59297,59297,59298,1,2,1
59298,59298,59299,2,3,1
59299,59299,59300,3,4,1
59300,59300,59301,4,5,1
59301,59301,59302,5,6,1
59302,59302,59303,6,8,2
59303,59303,59304,8,7,-1
59304,59304,59305,7,5,-2
59305,59305,59306,5,7,2
59306,59306,59307,7,3,-4
59307,59307,59308,3,3,0
59308,59308,59309,3,8,5
59309,59309,59310,8,6,-2
59310,59310,59311,6,5,-1
59311,59311,59312,5,4,-1
59312,59312,59313,4,0,-4
59313,59313,59314,0,9,9
59314,59314,59315,9,3,-6
59315,59315,59316,3,2,-1
59316,59316,59317,2,2,0
59317,59317,59318,2,3,1
59318,59318,59319,3,0,-3
59319,59319,59320,0,6,6
59320,59320,59321,6,4,-2
59321,59321,59322,4,3,-1
59322,59322,59323,3,7,4
59323,59323,59324,7,6,-1
59324,59324,59325,6,9,3
59325,59325,59326,9,2,-7
59326,59326,59327,2,2,0
59327,59327,59328,2,3,1
59328,59328,59329,3,5,2
59329,59329,59330,5,5,0
59330,59330,59331,5,0,-5
59331,59331,59332,0,7,7
59332,59332,59333,7,2,-5
59333,59333,59334,2,3,1
59334,59334,59335,3,4,1
59335,59335,59336,4,0,-4
59336,59336,59337,0,0,0
59337,59337,59338,0,5,5
59338,59338,59339,5,1,-4
59339,59339,59340,1,8,7
59340,59340,59341,8,9,1
59341,59341,59342,9,0,-9
59342,59342,59343,0,8,8
59343,59343,59344,8,9,1
59344,59344,59345,9,6,-3
59345,59345,59346,6,5,-1
59346,59346,59347,5,6,1
59347,59347,59348,6,7,1
59348,59348,59349,7,5,-2
59349,59349,59350,5,3,-2
59350,59350,59351,3,5,2
59351,59351,59352,5,3,-2
59352,59352,59353,3,0,-3
59353,59353,59354,0,1,1
59354,59354,59355,1,2,1
59355,59355,59356,2,3,1
59356,59356,59357,3,4,1
59357,59357,59358,4,5,1
59358,59358,59359,5,6,1
59359,59359,59360,6,7,1
59360,59360,59361,7,8,1
59361,59361,59362,8,9,1
59362,59362,59363,9,0,-9
59363,59363,59364,0,1,1
59364,59364,59365,1,2,1
59365,59365,59366,2,3,1
59366,59366,59367,3,4,1
59367,59367,59368,4,5,1
59368,59368,59369,5,6,1
59369,59369,59370,6,7,1
59370,59370,59371,7,9,2
59371,59371,59372,9,0,-9
59372,59372,59373,0,1,1
59373,59373,59374,1,2,1
59374,59374,59375,2,3,1
59375,59375,59376,3,4,1
59376,59376,59377,4,5,1
59377,59377,59378,5,6,1
59378,59378,59379,6,7,1
59379,59379,59380,7,8,1
59380,59380,59381,8,9,1
59381,59381,59382,9,1,-8
59382,59382,59383,1,3,2
59383,59383,59384,3,5,2
59384,59384,59385,5,9,4
59385,59385,59386,9,4,-5
59386,59386,59387,4,1,-3
59387,59387,59388,1,7,6
59388,59388,59389,7,7,0
59389,59389,59390,7,2,-5
59390,59390,59391,2,1,-1
59391,59391,59392,1,4,3
59392,59392,59393,4,8,4
59393,59393,59394,8,3,-5
59394,59394,59395,3,8,5
59395,59395,59396,8,2,-6
59396,59396,59397,2,9,7
59397,59397,59398,9,3,-6
59398,59398,59399,3,8,5
59399,59399,59400,8,5,-3
59400,59400,59401,5,4,-1
59401,59401,59402,4,8,4
59402,59402,59403,8,8,0
59403,59403,59404,8,9,1
59404,59404,59405,9,7,-2
59405,59405,59406,7,5,-2
59406,59406,59407,5,4,-1
59407,59407,59408,4,3,-1
59408,59408,59409,3,9,6
59409,59409,59410,9,2,-7
59410,59410,59411,2,5,3
59411,59411,59412,5,7,2
59412,59412,59413,7,4,-3
59413,59413,59414,4,1,-3
59414,59414,59415,1,2,1
59415,59415,59416,2,3,1
59416,59416,59417,3,6,3
59417,59417,59418,6,0,-6
59418,59418,59419,0,1,1
59419,59419,59420,1,0,-1
59420,59420,59421,0,0,0
59421,59421,59422,0,2,2
59422,59422,59423,2,8,6
59423,59423,59424,8,7,-1
59424,59424,59425,7,2,-5
59425,59425,59426,2,5,3
59426,59426,59427,5,1,-4
59427,59427,59428,1,1,0
59428,59428,59429,1,8,7
59429,59429,59430,8,5,-3
59430,59430,59431,5,6,1
59431,59431,59432,6,4,-2
59432,59432,59433,4,0,-4
59433,59433,59434,0,4,4
59434,59434,59435,4,7,3
59435,59435,59436,7,3,-4
59436,59436,59437,3,6,3
59437,59437,59438,6,8,2
59438,59438,59439,8,0,-8
59439,59439,59440,0,3,3
59440,59440,59441,3,7,4
59441,59441,59442,7,6,-1
59442,59442,59443,6,9,3
59443,59443,59444,9,2,-7
59444,59444,59445,2,6,4
59445,59445,59446,6,5,-1
59446,59446,59447,5,8,3
59447,59447,59448,8,6,-2
59448,59448,59449,6,9,3
59449,59449,59450,9,0,-9
59450,59450,59451,0,4,4
59451,59451,59452,4,0,-4
59452,59452,59453,0,6,6
59453,59453,59454,6,1,-5
59454,59454,59455,1,9,8
59455,59455,59456,9,2,-7
59456,59456,59457,2,0,-2
59457,59457,59458,0,9,9
59458,59458,59459,9,5,-4
59459,59459,59460,5,1,-4
59460,59460,59461,1,3,2
59461,59461,59462,3,7,4
59462,59462,59463,7,6,-1
59463,59463,59464,6,9,3
59464,59464,59465,9,4,-5
59465,59465,59466,4,8,4
59466,59466,59467,8,3,-5
59467,59467,59468,3,7,4
59468,59468,59469,7,7,0
59469,59469,59470,7,6,-1
59470,59470,59471,6,3,-3
59471,59471,59472,3,0,-3
59472,59472,59473,0,5,5
59473,59473,59474,5,6,1
59474,59474,59475,6,2,-4
59475,59475,59476,2,2,0
59476,59476,59477,2,0,-2
59477,59477,59478,0,1,1
59478,59478,59479,1,2,1
59479,59479,59480,2,3,1
59480,59480,59481,3,4,1
59481,59481,59482,4,5,1
59482,59482,59483,5,6,1
59483,59483,59484,6,7,1
59484,59484,59485,7,8,1
59485,59485,59486,8,9,1
59486,59486,59487,9,0,-9
59487,59487,59488,0,1,1
59488,59488,59489,1,2,1
59489,59489,59490,2,3,1
59490,59490,59491,3,4,1
59491,59491,59492,4,5,1
59492,59492,59493,5,6,1
59493,59493,59494,6,7,1
59494,59494,59495,7,8,1
59495,59495,59496,8,9,1
59496,59496,59497,9,0,-9
59497,59497,59498,0,1,1
59498,59498,59499,1,2,1
59499,59499,59500,2,3,1
59500,59500,59501,3,4,1
59501,59501,59502,4,5,1
59502,59502,59503,5,6,1
59503,59503,59504,6,7,1
59504,59504,59505,7,8,1
59505,59505,59506,8,9,1
59506,59506,59507,9,5,-4
59507,59507,59508,5,6,1
59508,59508,59509,6,6,0
59509,59509,59510,6,0,-6
59510,59510,59511,0,8,8
59511,59511,59512,8,3,-5
59512,59512,59513,3,7,4
59513,59513,59514,7,9,2
59514,59514,59515,9,4,-5
59515,59515,59516,4,7,3
59516,59516,59517,7,1,-6
59517,59517,59518,1,9,8
59518,59518,59519,9,1,-8
59519,59519,59520,1,7,6
59520,59520,59521,7,1,-6
59521,59521,59522,1,4,3
59522,59522,59523,4,1,-3
59523,59523,59524,1,7,6
59524,59524,59525,7,5,-2
59525,59525,59526,5,7,2
59526,59526,59527,7,1,-6
59527,59527,59528,1,3,2
59528,59528,59529,3,3,0
59529,59529,59530,3,1,-2
59530,59530,59531,1,6,5
59531,59531,59532,6,9,3
59532,59532,59533,9,7,-2
59533,59533,59534,7,4,-3
59534,59534,59535,4,3,-1
59535,59535,59536,3,0,-3
59536,59536,59537,0,2,2
59537,59537,59538,2,5,3
59538,59538,59539,5,2,-3
59539,59539,59540,2,6,4
59540,59540,59541,6,0,-6
59541,59541,59542,0,8,8
59542,59542,59543,8,4,-4
59543,59543,59544,4,8,4
59544,59544,59545,8,1,-7
59545,59545,59546,1,5,4
59546,59546,59547,5,0,-5
59547,59547,59548,0,6,6
59548,59548,59549,6,6,0
59549,59549,59550,6,3,-3
59550,59550,59551,3,4,1
59551,59551,59552,4,7,3
59552,59552,59553,7,5,-2
59553,59553,59554,5,7,2
59554,59554,59555,7,2,-5
59555,59555,59556,2,2,0
59556,59556,59557,2,0,-2
59557,59557,59558,0,0,0
59558,59558,59559,0,1,1
59559,59559,59560,1,7,6
59560,59560,59561,7,7,0
59561,59561,59562,7,9,2
59562,59562,59563,9,5,-4
59563,59563,59564,5,9,4
59564,59564,59565,9,8,-1
59565,59565,59566,8,9,1
59566,59566,59567,9,6,-3
59567,59567,59568,6,8,2
59568,59568,59569,8,3,-5
59569,59569,59570,3,6,3
59570,59570,59571,6,1,-5
59571,59571,59572,1,2,1
59572,59572,59573,2,9,7
59573,59573,59574,9,5,-4
59574,59574,59575,5,2,-3
59575,59575,59576,2,5,3
59576,59576,59577,5,2,-3
59577,59577,59578,2,6,4
59578,59578,59579,6,2,-4
59579,59579,59580,2,4,2
59580,59580,59581,4,8,4
59581,59581,59582,8,4,-4
59582,59582,59583,4,6,2
59583,59583,59584,6,5,-1
59584,59584,59585,5,0,-5
59585,59585,59586,0,1,1
59586,59586,59587,1,2,1
59587,59587,59588,2,3,1
59588,59588,59589,3,4,1
59589,59589,59590,4,5,1
59590,59590,59591,5,6,1
59591,59591,59592,6,7,1
59592,59592,59593,7,8,1
59593,59593,59594,8,9,1
59594,59594,59595,9,0,-9
59595,59595,59596,0,1,1
59596,59596,59597,1,2,1
59597,59597,59598,2,3,1
59598,59598,59599,3,4,1
59599,59599,59600,4,5,1
59600,59600,59601,5,6,1
59601,59601,59602,6,7,1
59602,59602,59603,7,8,1
59603,59603,59604,8,9,1
59604,59604,59605,9,0,-9
59605,59605,59606,0,1,1
59606,59606,59607,1,2,1
59607,59607,59608,2,4,2
59608,59608,59609,4,5,1
59609,59609,59610,5,6,1
59610,59610,59611,6,7,1
59611,59611,59612,7,8,1
59612,59612,59613,8,0,-8
59613,59613,59614,0,4,4
59614,59614,59615,4,0,-4
59615,59615,59616,0,1,1
59616,59616,59617,1,7,6
59617,59617,59618,7,5,-2
59618,59618,59619,5,1,-4
59619,59619,59620,1,4,3
59620,59620,59621,4,2,-2
59621,59621,59622,2,8,6
59622,59622,59623,8,4,-4
59623,59623,59624,4,3,-1
59624,59624,59625,3,1,-2
59625,59625,59626,1,7,6
59626,59626,59627,7,8,1
59627,59627,59628,8,2,-6
59628,59628,59629,2,4,2
59629,59629,59630,4,3,-1
59630,59630,59631,3,3,0
59631,59631,59632,3,6,3
59632,59632,59633,6,9,3
59633,59633,59634,9,9,0
59634,59634,59635,9,5,-4
59635,59635,59636,5,8,3
59636,59636,59637,8,6,-2
59637,59637,59638,6,7,1
59638,59638,59639,7,0,-7
59639,59639,59640,0,6,6
59640,59640,59641,6,2,-4
59641,59641,59642,2,6,4
59642,59642,59643,6,3,-3
59643,59643,59644,3,9,6
59644,59644,59645,9,1,-8
59645,59645,59646,1,7,6
59646,59646,59647,7,4,-3
59647,59647,59648,4,8,4
59648,59648,59649,8,8,0
59649,59649,59650,8,9,1
59650,59650,59651,9,0,-9
59651,59651,59652,0,3,3
59652,59652,59653,3,0,-3
59653,59653,59654,0,5,5
59654,59654,59655,5,2,-3
59655,59655,59656,2,9,7
59656,59656,59657,9,4,-5
59657,59657,59658,4,1,-3
59658,59658,59659,1,0,-1
59659,59659,59660,0,3,3
59660,59660,59661,3,7,4
59661,59661,59662,7,5,-2
59662,59662,59663,5,8,3
59663,59663,59664,8,7,-1
59664,59664,59665,7,7,0
59665,59665,59666,7,8,1
59666,59666,59667,8,2,-6
59667,59667,59668,2,9,7
59668,59668,59669,9,5,-4
59669,59669,59670,5,5,0
59670,59670,59671,5,1,-4
59671,59671,59672,1,2,1
59672,59672,59673,2,6,4
59673,59673,59674,6,4,-2
59674,59674,59675,4,2,-2
59675,59675,59676,2,5,3
59676,59676,59677,5,2,-3
59677,59677,59678,2,3,1
59678,59678,59679,3,6,3
59679,59679,59680,6,0,-6
59680,59680,59681,0,0,0
59681,59681,59682,0,7,7
59682,59682,59683,7,5,-2
59683,59683,59684,5,2,-3
59684,59684,59685,2,8,6
59685,59685,59686,8,1,-7
59686,59686,59687,1,6,5
59687,59687,59688,6,1,-5
59688,59688,59689,1,0,-1
59689,59689,59690,0,4,4
59690,59690,59691,4,3,-1
59691,59691,59692,3,1,-2
59692,59692,59693,1,6,5
59693,59693,59694,6,1,-5
59694,59694,59695,1,9,8
59695,59695,59696,9,0,-9
59696,59696,59697,0,1,1
59697,59697,59698,1,2,1
59698,59698,59699,2,3,1
59699,59699,59700,3,4,1
59700,59700,59701,4,5,1
59701,59701,59702,5,6,1
59702,59702,59703,6,7,1
59703,59703,59704,7,0,-7
59704,59704,59705,0,1,1
59705,59705,59706,1,2,1
59706,59706,59707,2,3,1
59707,59707,59708,3,4,1
59708,59708,59709,4,6,2
59709,59709,59710,6,7,1
59710,59710,59711,7,8,1
59711,59711,59712,8,0,-8
59712,59712,59713,0,1,1
59713,59713,59714,1,2,1
59714,59714,59715,2,3,1
59715,59715,59716,3,4,1
59716,59716,59717,4,7,3
59717,59717,59718,7,8,1
59718,59718,59719,8,9,1
59719,59719,59720,9,2,-7
59720,59720,59721,2,2,0
59721,59721,59722,2,4,2
59722,59722,59723,4,0,-4
59723,59723,59724,0,7,7
59724,59724,59725,7,3,-4
59725,59725,59726,3,5,2
59726,59726,59727,5,4,-1
59727,59727,59728,4,1,-3
59728,59728,59729,1,8,7
59729,59729,59730,8,0,-8
59730,59730,59731,0,5,5
59731,59731,59732,5,2,-3
59732,59732,59733,2,7,5
59733,59733,59734,7,2,-5
59734,59734,59735,2,3,1
59735,59735,59736,3,6,3
59736,59736,59737,6,2,-4
59737,59737,59738,2,1,-1
59738,59738,59739,1,7,6
59739,59739,59740,7,7,0
59740,59740,59741,7,9,2
59741,59741,59742,9,2,-7
59742,59742,59743,2,4,2
59743,59743,59744,4,6,2
59744,59744,59745,6,7,1
59745,59745,59746,7,7,0
59746,59746,59747,7,5,-2
59747,59747,59748,5,9,4
59748,59748,59749,9,9,0
59749,59749,59750,9,1,-8
59750,59750,59751,1,8,7
59751,59751,59752,8,6,-2
59752,59752,59753,6,4,-2
59753,59753,59754,4,6,2
59754,59754,59755,6,0,-6
59755,59755,59756,0,9,9
59756,59756,59757,9,2,-7
59757,59757,59758,2,6,4
59758,59758,59759,6,4,-2
59759,59759,59760,4,3,-1
59760,59760,59761,3,9,6
59761,59761,59762,9,0,-9
59762,59762,59763,0,8,8
59763,59763,59764,8,8,0
59764,59764,59765,8,9,1
59765,59765,59766,9,4,-5
59766,59766,59767,4,7,3
59767,59767,59768,7,1,-6
59768,59768,59769,1,3,2
59769,59769,59770,3,6,3
59770,59770,59771,6,9,3
59771,59771,59772,9,4,-5
59772,59772,59773,4,1,-3
59773,59773,59774,1,7,6
59774,59774,59775,7,6,-1
59775,59775,59776,6,9,3
59776,59776,59777,9,3,-6
59777,59777,59778,3,3,0
59778,59778,59779,3,7,4
59779,59779,59780,7,4,-3
59780,59780,59781,4,1,-3
59781,59781,59782,1,9,8
59782,59782,59783,9,1,-8
59783,59783,59784,1,0,-1
59784,59784,59785,0,6,6
59785,59785,59786,6,0,-6
59786,59786,59787,0,1,1
59787,59787,59788,1,2,1
59788,59788,59789,2,4,2
59789,59789,59790,4,5,1
59790,59790,59791,5,6,1
59791,59791,59792,6,7,1
59792,59792,59793,7,8,1
59793,59793,59794,8,9,1
59794,59794,59795,9,0,-9
59795,59795,59796,0,1,1
59796,59796,59797,1,2,1
59797,59797,59798,2,3,1
59798,59798,59799,3,4,1
59799,59799,59800,4,5,1
59800,59800,59801,5,6,1
59801,59801,59802,6,7,1
59802,59802,59803,7,8,1
59803,59803,59804,8,9,1
59804,59804,59805,9,0,-9
59805,59805,59806,0,1,1
59806,59806,59807,1,2,1
59807,59807,59808,2,3,1
59808,59808,59809,3,4,1
59809,59809,59810,4,5,1
59810,59810,59811,5,6,1
59811,59811,59812,6,7,1
59812,59812,59813,7,8,1
59813,59813,59814,8,9,1
59814,59814,59815,9,3,-6
59815,59815,59816,3,2,-1
59816,59816,59817,2,9,7
59817,59817,59818,9,3,-6
59818,59818,59819,3,2,-1
59819,59819,59820,2,1,-1
59820,59820,59821,1,4,3
59821,59821,59822,4,5,1
59822,59822,59823,5,5,0
59823,59823,59824,5,2,-3
59824,59824,59825,2,3,1
59825,59825,59826,3,2,-1
59826,59826,59827,2,1,-1
59827,59827,59828,1,3,2
59828,59828,59829,3,9,6
59829,59829,59830,9,7,-2
59830,59830,59831,7,2,-5
59831,59831,59832,2,1,-1
59832,59832,59833,1,2,1
59833,59833,59834,2,8,6
59834,59834,59835,8,9,1
59835,59835,59836,9,1,-8
59836,59836,59837,1,8,7
59837,59837,59838,8,8,0
59838,59838,59839,8,7,-1
59839,59839,59840,7,0,-7
59840,59840,59841,0,6,6
59841,59841,59842,6,7,1
59842,59842,59843,7,7,0
59843,59843,59844,7,8,1
59844,59844,59845,8,7,-1
59845,59845,59846,7,5,-2
59846,59846,59847,5,0,-5
59847,59847,59848,0,6,6
59848,59848,59849,6,1,-5
59849,59849,59850,1,5,4
59850,59850,59851,5,7,2
59851,59851,59852,7,4,-3
59852,59852,59853,4,6,2
59853,59853,59854,6,1,-5
59854,59854,59855,1,2,1
59855,59855,59856,2,7,5
59856,59856,59857,7,9,2
59857,59857,59858,9,9,0
59858,59858,59859,9,0,-9
59859,59859,59860,0,3,3
59860,59860,59861,3,8,5
59861,59861,59862,8,4,-4
59862,59862,59863,4,4,0
59863,59863,59864,4,1,-3
59864,59864,59865,1,8,7
59865,59865,59866,8,6,-2
59866,59866,59867,6,5,-1
59867,59867,59868,5,0,-5
59868,59868,59869,0,0,0
59869,59869,59870,0,3,3
59870,59870,59871,3,7,4
59871,59871,59872,7,1,-6
59872,59872,59873,1,6,5
59873,59873,59874,6,4,-2
59874,59874,59875,4,2,-2
59875,59875,59876,2,6,4
59876,59876,59877,6,6,0
59877,59877,59878,6,0,-6
59878,59878,59879,0,4,4
59879,59879,59880,4,5,1
59880,59880,59881,5,4,-1
59881,59881,59882,4,1,-3
59882,59882,59883,1,3,2
59883,59883,59884,3,8,5
59884,59884,59885,8,6,-2
59885,59885,59886,6,3,-3
59886,59886,59887,3,9,6
59887,59887,59888,9,9,0
59888,59888,59889,9,5,-4
59889,59889,59890,5,9,4
59890,59890,59891,9,3,-6
59891,59891,59892,3,6,3
59892,59892,59893,6,4,-2
59893,59893,59894,4,7,3
59894,59894,59895,7,6,-1
59895,59895,59896,6,2,-4
59896,59896,59897,2,2,0
59897,59897,59898,2,0,-2
59898,59898,59899,0,9,9
59899,59899,59900,9,4,-5
59900,59900,59901,4,0,-4
59901,59901,59902,0,1,1
59902,59902,59903,1,2,1
59903,59903,59904,2,3,1
59904,59904,59905,3,4,1
59905,59905,59906,4,5,1
59906,59906,59907,5,6,1
59907,59907,59908,6,7,1
59908,59908,59909,7,8,1
59909,59909,59910,8,9,1
59910,59910,59911,9,0,-9
59911,59911,59912,0,1,1
59912,59912,59913,1,2,1
59913,59913,59914,2,3,1
59914,59914,59915,3,4,1
59915,59915,59916,4,8,4
59916,59916,59917,8,9,1
59917,59917,59918,9,0,-9
59918,59918,59919,0,1,1
59919,59919,59920,1,2,1
59920,59920,59921,2,3,1
59921,59921,59922,3,4,1
59922,59922,59923,4,5,1
59923,59923,59924,5,6,1
59924,59924,59925,6,7,1
59925,59925,59926,7,8,1
59926,59926,59927,8,9,1
59927,59927,59928,9,6,-3
59928,59928,59929,6,0,-6
59929,59929,59930,0,3,3
59930,59930,59931,3,4,1
59931,59931,59932,4,1,-3
59932,59932,59933,1,4,3
59933,59933,59934,4,0,-4
59934,59934,59935,0,7,7
59935,59935,59936,7,8,1
59936,59936,59937,8,7,-1
59937,59937,59938,7,7,0
59938,59938,59939,7,9,2
59939,59939,59940,9,0,-9
59940,59940,59941,0,4,4
59941,59941,59942,4,9,5
59942,59942,59943,9,4,-5
59943,59943,59944,4,0,-4
59944,59944,59945,0,5,5
59945,59945,59946,5,8,3
59946,59946,59947,8,5,-3
59947,59947,59948,5,9,4
59948,59948,59949,9,8,-1
59949,59949,59950,8,8,0
59950,59950,59951,8,4,-4
59951,59951,59952,4,0,-4
59952,59952,59953,0,7,7
59953,59953,59954,7,1,-6
59954,59954,59955,1,3,2
59955,59955,59956,3,5,2
59956,59956,59957,5,3,-2
59957,59957,59958,3,1,-2
59958,59958,59959,1,6,5
59959,59959,59960,6,5,-1
59960,59960,59961,5,3,-2
59961,59961,59962,3,8,5
59962,59962,59963,8,7,-1
59963,59963,59964,7,3,-4
59964,59964,59965,3,1,-2
59965,59965,59966,1,6,5
59966,59966,59967,6,8,2
59967,59967,59968,8,5,-3
59968,59968,59969,5,9,4
59969,59969,59970,9,2,-7
59970,59970,59971,2,2,0
59971,59971,59972,2,0,-2
59972,59972,59973,0,9,9
59973,59973,59974,9,2,-7
59974,59974,59975,2,4,2
59975,59975,59976,4,6,2
59976,59976,59977,6,7,1
59977,59977,59978,7,3,-4
59978,59978,59979,3,1,-2
59979,59979,59980,1,3,2
59980,59980,59981,3,6,3
59981,59981,59982,6,6,0
59982,59982,59983,6,2,-4
59983,59983,59984,2,1,-1
59984,59984,59985,1,2,1
59985,59985,59986,2,6,4
59986,59986,59987,6,0,-6
59987,59987,59988,0,7,7
59988,59988,59989,7,8,1
59989,59989,59990,8,9,1
59990,59990,59991,9,2,-7
59991,59991,59992,2,9,7
59992,59992,59993,9,5,-4
59993,59993,59994,5,1,-4
59994,59994,59995,1,8,7
59995,59995,59996,8,3,-5
59996,59996,59997,3,5,2
59997,59997,59998,5,6,1
59998,59998,59999,6,8,2
