,x1,x2,x1_label,x2_label,class_label
0,5262,5263,9,6,-3
1,5324,5325,7,5,-2
2,3203,3204,1,8,7
3,6269,6270,7,5,-2
4,3963,3964,2,8,6
5,2546,2547,5,7,2
6,2266,2267,1,6,5
7,9854,9855,8,2,-6
8,6347,6348,8,8,0
9,4287,4288,9,3,-6
10,978,979,5,1,-4
11,6831,6832,2,5,3
12,4890,4891,8,0,-8
13,4897,4898,6,6,0
14,5805,5806,9,0,-9
15,4497,4498,8,7,-1
16,7001,7002,2,2,0
17,777,778,1,5,4
18,8443,8444,1,5,4
19,818,819,1,3,2
20,8960,8961,4,4,0
21,5775,5776,8,1,-7
22,9271,9272,8,9,1
23,7049,7050,0,6,6
24,8167,8168,3,2,-1
25,9806,9807,7,8,1
26,5225,5226,3,8,5
27,9341,9342,2,3,1
28,6721,6722,2,3,1
29,3796,3797,2,5,3
30,3947,3948,3,6,3
31,9752,9753,2,0,-2
32,1981,1982,6,6,0
33,8878,8879,5,4,-1
34,1745,1746,9,3,-6
35,4521,4522,2,7,5
36,2980,2981,6,2,-4
37,7563,7564,1,2,1
38,3468,3469,5,3,-2
39,7270,7271,1,2,1
40,3615,3616,4,7,3
41,2193,2194,7,6,-1
42,9486,9487,7,2,-5
43,4346,4347,6,6,0
44,1237,1238,2,1,-1
45,3996,3997,4,7,3
46,7494,7495,4,9,5
47,8510,8511,7,4,-3
48,8312,8313,4,7,3
49,4057,4058,1,8,7
50,3629,3630,8,3,-5
51,6325,6326,6,7,1
52,6208,6209,7,8,1
53,5936,5937,4,5,1
54,9845,9846,1,1,0
55,8586,8587,1,0,-1
56,6676,6677,3,2,-1
57,748,749,4,1,-3
58,6176,6177,4,3,-1
59,5302,5303,5,6,1
60,878,879,8,8,0
61,474,475,8,4,-4
62,298,299,2,8,6
63,5915,5916,1,6,5
64,690,691,2,8,6
65,1598,1599,5,4,-1
66,7832,7833,1,4,3
67,9189,9190,0,1,1
68,8799,8800,1,2,1
69,2704,2705,1,1,0
70,3082,3083,3,3,0
71,2067,2068,0,9,9
72,1343,1344,9,6,-3
73,9260,9261,5,3,-2
74,9421,9422,2,5,3
75,7785,7786,2,9,7
76,5192,5193,2,1,-1
77,1130,1131,9,5,-4
78,9957,9958,7,7,0
79,3528,3529,3,9,6
80,3003,3004,1,2,1
81,6528,6529,2,4,2
82,9851,9852,7,7,0
83,3777,3778,1,5,4
84,7534,7535,8,9,1
85,6290,6291,3,5,2
86,6488,6489,4,0,-4
87,6444,6445,0,1,1
88,8358,8359,9,0,-9
89,8584,8585,2,8,6
90,5423,5424,8,9,1
91,107,108,1,9,8
92,7669,7670,4,6,2
93,5678,5679,8,1,-7
94,9772,9773,1,7,6
95,9193,9194,4,5,1
96,5264,5265,2,6,4
97,8410,8411,8,3,-5
98,7905,7906,3,6,3
99,5721,5722,0,1,1
100,3337,3338,2,9,7
101,4183,4184,9,9,0
102,423,424,2,0,-2
103,3457,3458,1,0,-1
104,3299,3300,3,3,0
105,9140,9141,1,7,6
106,3907,3908,5,6,1
107,5450,5451,0,5,5
108,3562,3563,1,8,7
109,3396,3397,2,4,2
110,7883,7884,4,9,5
111,9164,9165,7,9,2
112,9447,9448,7,7,0
113,546,547,0,2,2
114,9237,9238,8,3,-5
115,7675,7676,3,5,2
116,6848,6849,1,2,1
117,7225,7226,0,1,1
118,6085,6086,3,4,1
119,9337,9338,5,5,0
120,1297,1298,0,3,3
121,4471,4472,7,5,-2
122,550,551,7,7,0
123,5487,5488,2,5,3
124,1012,1013,7,9,2
125,2063,2064,7,5,-2
126,9740,9741,9,9,0
127,5363,5364,7,5,-2
128,9169,9170,7,9,2
129,7587,7588,2,9,7
130,2688,2689,1,5,4
131,1779,1780,3,1,-2
132,8662,8663,4,9,5
133,3518,3519,6,8,2
134,9592,9593,4,1,-3
135,8804,8805,6,7,1
136,2618,2619,3,0,-3
137,4418,4419,2,8,6
138,6774,6775,6,5,-1
139,5765,5766,8,3,-5
140,4546,4547,2,6,4
141,1900,1901,1,9,8
142,109,110,4,8,4
143,34,35,7,2,-5
144,2473,2474,1,7,6
145,4406,4407,3,9,6
146,8274,8275,9,5,-4
147,4687,4688,1,3,2
148,3384,3385,2,9,7
149,9910,9911,8,0,-8
150,9553,9554,9,9,0
151,5055,5056,4,5,1
152,5751,5752,7,5,-2
153,8992,8993,0,4,4
154,3126,3127,1,5,4
155,5667,5668,2,5,3
156,7869,7870,1,5,4
157,6202,6203,1,2,1
158,8123,8124,6,7,1
159,8206,8207,3,9,6
160,3942,3943,0,3,3
161,1823,1824,8,2,-6
162,4279,4280,2,9,7
163,9703,9704,2,0,-2
164,3467,3468,9,5,-4
165,6096,6097,3,0,-3
166,262,263,7,7,0
167,5564,5565,4,9,5
168,6124,6125,9,1,-8
169,5990,5991,0,1,1
170,5829,5830,2,0,-2
171,3555,3556,8,5,-3
172,2380,2381,9,8,-1
173,2358,2359,1,1,0
174,2784,2785,2,3,1
175,983,984,8,1,-7
176,724,725,6,1,-5
177,6612,6613,8,6,-2
178,3366,3367,4,2,-2
179,859,860,7,6,-1
180,9074,9075,4,5,1
181,3169,3170,4,0,-4
182,6065,6066,3,4,1
183,844,845,8,0,-8
184,1082,1083,5,1,-4
185,5310,5311,7,9,2
186,3114,3115,4,5,1
187,8722,8723,8,9,1
188,1355,1356,7,2,-5
189,9994,9995,1,2,1
190,8515,8516,6,6,0
191,4173,4174,2,9,7
192,9767,9768,9,2,-7
193,8615,8616,2,4,2
194,7069,7070,7,8,1
195,3092,3093,1,5,4
196,1290,1291,3,3,0
197,8342,8343,0,0,0
198,911,912,7,3,-4
199,2282,2283,5,1,-4
200,5913,5914,5,7,2
201,3597,3598,9,1,-8
202,9203,9204,4,7,3
203,7950,7951,7,8,1
204,2044,2045,2,3,1
205,4458,4459,4,7,3
206,3434,3435,1,2,1
207,5873,5874,1,5,4
208,1072,1073,3,5,2
209,8704,8705,2,9,7
210,9968,9969,7,1,-6
211,244,245,2,3,1
212,3909,3910,2,3,1
213,7009,7010,4,3,-1
214,5965,5966,0,6,6
215,7851,7852,6,7,1
216,4707,4708,8,1,-7
217,8941,8942,4,8,4
218,2035,2036,5,7,2
219,2979,2980,9,6,-3
220,8249,8250,8,9,1
221,4776,4777,0,8,8
222,8634,8635,0,8,8
223,4803,4804,4,0,-4
224,2436,2437,4,2,-2
225,9454,9455,6,0,-6
226,401,402,8,3,-5
227,2903,2904,5,2,-3
228,8477,8478,9,6,-3
229,5036,5037,1,2,1
230,3388,3389,4,8,4
231,3845,3846,8,6,-2
232,4283,4284,9,9,0
233,420,421,4,2,-2
234,3257,3258,2,2,0
235,6001,6002,8,6,-2
236,915,916,8,4,-4
237,8784,8785,9,3,-6
238,8849,8850,0,1,1
239,1931,1932,5,2,-3
240,1276,1277,7,9,2
241,7537,7538,0,7,7
242,3693,3694,9,2,-7
243,1680,1681,4,3,-1
244,7146,7147,8,2,-6
245,2,3,1,0,-1
246,1251,1252,2,5,3
247,3049,3050,3,1,-2
248,6900,6901,6,1,-5
249,252,253,9,5,-4
250,7016,7017,8,6,-2
251,290,291,8,2,-6
252,7428,7429,8,4,-4
253,3296,3297,7,0,-7
254,160,161,4,6,2
255,2009,2010,9,1,-8
256,7779,7780,5,0,-5
257,963,964,1,1,0
258,2621,2622,2,7,5
259,8442,8443,4,1,-3
260,2303,2304,3,0,-3
261,5251,5252,0,1,1
262,829,830,4,2,-2
263,6581,6582,2,4,2
264,1300,1301,4,4,0
265,6670,6671,1,9,8
266,6314,6315,5,6,1
267,9788,9789,7,4,-3
268,4404,4405,0,9,9
269,1885,1886,1,6,5
270,500,501,3,9,6
271,5168,5169,3,4,1
272,7608,7609,1,2,1
273,5553,5554,1,0,-1
274,9183,9184,4,5,1
275,9330,9331,8,5,-3
276,485,486,0,8,8
277,7246,7247,9,1,-8
278,3194,3195,4,2,-2
279,562,563,9,8,-1
280,6895,6896,9,6,-3
281,523,524,1,3,2
282,2399,2400,7,5,-2
283,8221,8222,0,4,4
284,7128,7129,9,0,-9
285,9747,9748,5,8,3
286,8047,8048,2,1,-1
287,5196,5197,5,5,0
288,2563,2564,7,7,0
289,9758,9759,3,8,5
290,7011,7012,8,2,-6
291,8901,8902,6,2,-4
292,8481,8482,0,2,2
293,3789,3790,1,0,-1
294,1086,1087,9,5,-4
295,5361,5362,1,4,3
296,5265,5266,6,2,-4
297,8420,8421,1,7,6
298,7040,7041,3,7,4
299,4277,4278,3,0,-3
300,2658,2659,4,4,0
301,3660,3661,0,2,2
302,4523,4524,8,1,-7
303,137,138,1,6,5
304,5852,5853,5,6,1
305,3301,3302,2,6,4
306,8445,8446,5,6,1
307,3207,3208,2,7,5
308,7870,7871,5,8,3
309,9076,9077,6,7,1
310,2366,2367,1,6,5
311,6652,6653,1,7,6
312,6892,6893,0,6,6
313,3537,3538,5,9,4
314,7881,7882,1,0,-1
315,976,977,3,1,-2
316,2876,2877,6,4,-2
317,2480,2481,7,2,-5
318,9950,9951,1,0,-1
319,495,496,8,9,1
320,2422,2423,6,8,2
321,8508,8509,3,1,-2
322,3282,3283,4,3,-1
323,1254,1255,1,9,8
324,7232,7233,1,3,2
325,9579,9580,3,9,6
326,9120,9121,1,1,0
327,4434,4435,8,3,-5
328,9244,9245,0,9,9
329,3900,3901,1,6,5
330,9313,9314,1,7,6
331,6490,6491,7,5,-2
332,5312,5313,4,7,3
333,8932,8933,8,9,1
334,7716,7717,2,1,-1
335,8894,8895,8,0,-8
336,6726,6727,1,3,2
337,8100,8101,1,9,8
338,5543,5544,8,1,-7
339,4996,4997,3,2,-1
340,2095,2096,7,0,-7
341,604,605,5,7,2
342,9915,9916,4,7,3
343,8344,8345,1,2,1
344,2264,2265,4,4,0
345,1077,1078,4,4,0
346,9927,9928,4,4,0
347,3106,3107,2,7,5
348,9799,9800,1,0,-1
349,9934,9935,8,7,-1
350,6172,6173,9,9,0
351,8564,8565,6,7,1
352,4430,4431,3,4,1
353,1656,1657,2,1,-1
354,4126,4127,8,2,-6
355,5344,5345,9,4,-5
356,6642,6643,9,0,-9
357,9783,9784,4,9,5
358,7498,7499,5,9,4
359,6312,6313,3,4,1
360,5506,5507,1,2,1
361,7737,7738,0,1,1
362,596,597,8,0,-8
363,808,809,3,1,-2
364,3414,3415,5,2,-3
365,9221,9222,0,1,1
366,4457,4458,0,4,4
367,6507,6508,9,9,0
368,7184,7185,2,3,1
369,8726,8727,8,7,-1
370,8738,8739,0,6,6
371,6373,6374,4,1,-3
372,3171,3172,5,4,-1
373,8603,8604,3,1,-2
374,6689,6690,4,3,-1
375,1371,1372,8,2,-6
376,7120,7121,2,8,6
377,8997,8998,6,9,3
378,1759,1760,8,1,-7
379,331,332,2,1,-1
380,4880,4881,0,7,7
381,4555,4556,9,9,0
382,2541,2542,1,6,5
383,9401,9402,1,8,7
384,1479,1480,3,3,0
385,5097,5098,7,5,-2
386,4124,4125,8,6,-2
387,4504,4505,2,9,7
388,4426,4427,9,2,-7
389,6146,6147,5,7,2
390,6877,6878,0,2,2
391,7012,7013,2,2,0
392,6920,6921,2,0,-2
393,8830,8831,2,6,4
394,1441,1442,8,3,-5
395,6358,6359,8,8,0
396,7287,7288,8,9,1
397,8447,8448,5,0,-5
398,877,878,8,8,0
399,538,539,8,2,-6
400,4462,4463,0,5,5
401,4085,4086,1,8,7
402,9687,9688,0,0,0
403,3895,3896,0,3,3
404,6795,6796,0,2,2
405,1476,1477,5,7,2
406,2360,2361,6,9,3
407,2550,2551,8,3,-5
408,1950,1951,7,6,-1
409,5286,5287,6,7,1
410,5654,5655,7,7,0
411,3815,3816,1,8,7
412,1913,1914,3,8,5
413,3210,3211,0,1,1
414,1064,1065,2,2,0
415,8310,8311,2,6,4
416,2219,2220,8,7,-1
417,5076,5077,4,7,3
418,8773,8774,4,5,1
419,1347,1348,7,2,-5
420,9442,9443,2,1,-1
421,6937,6938,0,1,1
422,4421,4422,4,5,1
423,139,140,4,6,2
424,1601,1602,3,6,3
425,2389,2390,8,2,-6
426,8864,8865,3,0,-3
427,4855,4856,7,9,2
428,6651,6652,0,1,1
429,5293,5294,3,4,1
430,1160,1161,4,6,2
431,1154,1155,0,2,2
432,7769,7770,9,8,-1
433,2661,2662,1,2,1
434,6887,6888,9,9,0
435,8424,8425,2,0,-2
436,1092,1093,3,8,5
437,8458,8459,0,1,1
438,8922,8923,1,2,1
439,1454,1455,0,9,9
440,6087,6088,5,6,1
441,4039,4040,1,9,8
442,7380,7381,9,0,-9
443,4591,4592,6,9,3
444,541,542,4,8,4
445,6533,6534,1,2,1
446,5343,5344,8,9,1
447,7678,7679,2,5,3
448,7297,7298,8,9,1
449,2250,2251,9,4,-5
450,5115,5116,6,6,0
451,5848,5849,1,2,1
452,5815,5816,3,4,1
453,7319,7320,1,7,6
454,8728,8729,8,1,-7
455,5640,5641,7,2,-5
456,6352,6353,2,7,5
457,6926,6927,6,0,-6
458,4194,4195,4,1,-3
459,8254,8255,3,4,1
460,9001,9002,6,1,-5
461,7020,7021,6,7,1
462,3706,3707,0,8,8
463,7637,7638,2,1,-1
464,8846,8847,9,5,-4
465,634,635,9,2,-7
466,1512,1513,9,3,-6
467,6853,6854,7,4,-3
468,3565,3566,5,2,-3
469,4938,4939,7,2,-5
470,3717,3718,3,4,1
471,1593,1594,6,9,3
472,8915,8916,2,3,1
473,1418,1419,9,4,-5
474,5576,5577,7,4,-3
475,4215,4216,7,1,-6
476,8224,8225,5,2,-3
477,9214,9215,9,2,-7
478,6846,6847,6,6,0
479,2967,2968,7,7,0
480,4753,4754,8,1,-7
481,3767,3768,7,0,-7
482,3291,3292,4,7,3
483,5319,5320,4,0,-4
484,6425,6426,6,0,-6
485,8022,8023,1,0,-1
486,3395,3396,6,2,-4
487,3084,3085,7,3,-4
488,4446,4447,6,0,-6
489,6417,6418,4,2,-2
490,2720,2721,9,6,-3
491,6473,6474,0,4,4
492,959,960,4,7,3
493,3293,3294,2,7,5
494,7707,7708,9,1,-8
495,5610,5611,7,8,1
496,3790,3791,0,9,9
497,1088,1089,9,5,-4
498,4731,4732,8,1,-7
499,4975,4976,9,4,-5
500,2906,2907,3,4,1
501,1791,1792,1,7,6
502,980,981,2,0,-2
503,6149,6150,7,8,1
504,7424,7425,1,4,3
505,3177,3178,3,0,-3
506,9770,9771,5,7,2
507,1642,1643,2,1,-1
508,8089,8090,5,1,-4
509,8350,8351,7,0,-7
510,8658,8659,1,1,0
511,1090,1091,9,7,-2
512,1994,1995,1,0,-1
513,7198,7199,8,9,1
514,5102,5103,5,8,3
515,1475,1476,6,5,-1
516,2094,2095,4,7,3
517,8129,8130,2,3,1
518,7528,7529,2,3,1
519,9736,9737,6,1,-5
520,9232,9233,4,1,-3
521,3190,3191,9,0,-9
522,3386,3387,1,9,8
523,7109,7110,8,6,-2
524,315,316,9,6,-3
525,7841,7842,3,5,2
526,5193,5194,1,5,4
527,6221,6222,9,1,-8
528,3793,3794,4,8,4
529,4120,4121,3,8,5
530,7122,7123,6,1,-5
531,5870,5871,0,9,9
532,154,155,1,5,4
533,2454,2455,6,0,-6
534,5073,5074,9,3,-6
535,5593,5594,0,1,1
536,5898,5899,6,0,-6
537,6902,6903,1,9,8
538,233,234,8,7,-1
539,3014,3015,1,3,2
540,8876,8877,3,8,5
541,5611,5612,8,9,1
542,5248,5249,3,0,-3
543,5719,5720,9,4,-5
544,7085,7086,4,0,-4
545,9342,9343,3,6,3
546,3519,3520,8,6,-2
547,4185,4186,1,0,-1
548,933,934,3,5,2
549,4770,4771,3,5,2
550,6470,6471,0,7,7
551,2853,2854,3,9,6
552,7992,7993,2,3,1
553,9358,9359,0,2,2
554,9028,9029,9,6,-3
555,4664,4665,3,9,6
556,4610,4611,9,0,-9
557,149,150,2,9,7
558,2176,2177,2,8,6
559,9669,9670,4,3,-1
560,288,289,1,5,4
561,727,728,3,2,-1
562,8672,8673,1,2,1
563,8527,8528,4,0,-4
564,4910,4911,9,4,-5
565,4794,4795,7,9,2
566,6280,6281,0,2,2
567,2051,2052,1,8,7
568,8639,8640,2,9,7
569,6068,6069,6,7,1
570,4300,4301,5,9,4
571,110,111,8,7,-1
572,3848,3849,7,0,-7
573,6673,6674,1,7,6
574,5136,5137,6,9,3
575,2687,2688,0,1,1
576,9610,9611,9,0,-9
577,3046,3047,8,2,-6
578,8448,8449,0,1,1
579,2739,2740,8,9,1
580,625,626,6,7,1
581,7499,7500,9,8,-1
582,4701,4702,9,6,-3
583,1768,1769,0,3,3
584,8685,8686,4,5,1
585,7830,7831,0,3,3
586,4750,4751,8,4,-4
587,2285,2286,7,6,-1
588,6672,6673,0,1,1
589,5098,5099,5,2,-3
590,6732,6733,2,1,-1
591,8593,8594,9,2,-7
592,9797,9798,3,2,-1
593,2747,2748,0,0,0
594,6066,6067,4,5,1
595,194,195,0,3,3
596,8011,8012,4,8,4
597,3137,3138,4,3,-1
598,5217,5218,2,6,4
599,2824,2825,0,1,1
600,7710,7711,2,7,5
601,70,71,7,0,-7
602,7831,7832,3,1,-2
603,9841,9842,5,6,1
604,1909,1910,1,5,4
605,5489,5490,8,1,-7
606,6332,6333,4,5,1
607,3970,3971,9,4,-5
608,5087,5088,0,6,6
609,545,546,0,0,0
610,6611,6612,5,8,3
611,1061,1062,0,3,3
612,5154,5155,7,0,-7
613,9096,9097,1,2,1
614,2065,2066,8,6,-2
615,1662,1663,6,8,2
616,8146,8147,9,8,-1
617,4034,4035,0,1,1
618,4304,4305,1,8,7
619,7693,7694,0,8,8
620,9699,9700,1,2,1
621,6117,6118,0,2,2
622,9656,9657,3,1,-2
623,2504,2505,1,7,6
624,9942,9943,3,3,0
625,4777,4778,8,1,-7
626,1422,1423,4,9,5
627,5253,5254,0,1,1
628,1105,1106,9,6,-3
629,8775,8776,4,1,-3
630,1788,1789,9,3,-6
631,3271,3272,0,1,1
632,1560,1561,8,4,-4
633,4924,4925,1,3,2
634,3653,3654,4,5,1
635,7626,7627,1,2,1
636,7348,7349,2,2,0
637,9603,9604,2,3,1
638,1546,1547,2,4,2
639,1116,1117,4,7,3
640,4361,4362,0,8,8
641,2575,2576,3,1,-2
642,4630,4631,3,0,-3
643,4810,4811,5,7,2
644,3163,3164,8,6,-2
645,1758,1759,8,8,0
646,502,503,5,2,-3
647,6248,6249,8,9,1
648,8567,8568,0,1,1
649,8887,8888,1,6,5
650,9992,9993,9,0,-9
651,2443,2444,9,1,-8
652,3183,3184,5,7,2
653,7175,7176,0,1,1
654,6956,6957,9,3,-6
655,2374,2375,2,4,2
656,4090,4091,0,0,0
657,3336,3337,5,2,-3
658,7150,7151,1,2,1
659,3716,3717,9,3,-6
660,9657,9658,1,6,5
661,8805,8806,7,8,1
662,7621,7622,4,5,1
663,5511,5512,6,7,1
664,3513,3514,2,2,0
665,9640,9641,7,1,-6
666,3262,3263,7,8,1
667,8238,8239,2,1,-1
668,8251,8252,0,1,1
669,3637,3638,7,1,-6
670,2470,2471,8,6,-2
671,8096,8097,6,8,2
672,5313,5314,7,1,-6
673,3806,3807,5,8,3
674,3327,3328,2,7,5
675,4568,4569,7,5,-2
676,5972,5973,5,3,-2
677,6637,6638,4,5,1
678,6556,6557,1,0,-1
679,8578,8579,5,6,1
680,7700,7701,9,7,-2
681,7154,7155,2,5,3
682,5162,5163,7,8,1
683,6188,6189,7,8,1
684,6785,6786,2,0,-2
685,8565,8566,7,8,1
686,6169,6170,4,7,3
687,5482,5483,7,0,-7
688,7933,7934,0,1,1
689,7518,7519,2,3,1
690,9561,9562,3,9,6
691,4501,4502,3,9,6
692,1096,1097,7,1,-6
693,3025,3026,4,1,-3
694,1968,1969,8,6,-2
695,6757,6758,1,1,0
696,4912,4913,4,7,3
697,8339,8340,8,1,-7
698,5835,5836,7,8,1
699,9006,9007,2,3,1
700,2619,2620,0,6,6
701,6079,6080,7,8,1
702,7691,7692,8,3,-5
703,3764,3765,0,1,1
704,1537,1538,6,2,-4
705,1018,1019,8,1,-7
706,3662,3663,8,5,-3
707,9494,9495,6,7,1
708,9938,9939,6,0,-6
709,3280,3281,2,1,-1
710,1770,1771,7,2,-5
711,347,348,5,1,-4
712,6633,6634,0,1,1
713,5064,5065,7,8,1
714,5119,5120,2,2,0
715,3734,3735,0,0,0
716,3837,3838,5,7,2
717,3667,3668,7,2,-5
718,3874,3875,9,4,-5
719,9803,9804,2,3,1
720,9602,9603,1,2,1
721,277,278,8,2,-6
722,88,89,6,1,-5
723,8030,8031,7,2,-5
724,480,481,1,9,8
725,8563,8564,5,6,1
726,1394,1395,8,2,-6
727,7427,7428,6,8,2
728,2143,2144,7,6,-1
729,7331,7332,6,4,-2
730,5716,5717,2,2,0
731,6896,6897,6,8,2
732,6017,6018,7,8,1
733,4133,4134,2,9,7
734,5199,5200,6,4,-2
735,2388,2389,6,8,2
736,3646,3647,0,7,7
737,4208,4209,0,6,6
738,994,995,1,2,1
739,9491,9492,3,4,1
740,8762,8763,9,0,-9
741,9929,9930,7,0,-7
742,9712,9713,8,9,1
743,1403,1404,1,0,-1
744,6971,6972,0,8,8
745,9890,9891,9,9,0
746,5675,5676,8,4,-4
747,8758,8759,1,8,7
748,9029,9030,6,1,-5
749,6230,6231,9,1,-8
750,9766,9767,4,9,5
751,3317,3318,0,2,2
752,6403,6404,8,8,0
753,161,162,6,5,-1
754,4405,4406,9,3,-6
755,4496,4497,8,8,0
756,9611,9612,0,1,1
757,1760,1761,1,5,4
758,6706,6707,5,6,1
759,6588,6589,0,7,7
760,7547,7548,6,6,0
761,955,956,5,1,-4
762,6759,6760,4,0,-4
763,7072,7073,0,1,1
764,9097,9098,2,4,2
765,3585,3586,7,1,-6
766,6800,6801,2,3,1
767,3311,3312,5,5,0
768,352,353,5,6,1
769,8072,8073,5,6,1
770,235,236,9,2,-7
771,4203,4204,6,2,-4
772,2335,2336,1,4,3
773,8099,8100,1,1,0
774,5681,5682,6,5,-1
775,8801,8802,3,4,1
776,7937,7938,4,5,1
777,5182,5183,9,8,-1
778,767,768,1,1,0
779,2263,2264,9,4,-5
780,8429,8430,3,3,0
781,403,404,8,2,-6
782,3984,3985,9,9,0
783,8689,8690,8,9,1
784,9225,9226,2,6,4
785,9856,9857,9,8,-1
786,6518,6519,5,2,-3
787,9519,9520,0,1,1
788,3426,3427,9,6,-3
789,7702,7703,0,0,0
790,6041,6042,2,5,3
791,1113,1114,5,3,-2
792,6855,6856,7,7,0
793,1307,1308,6,9,3
794,1376,1377,5,6,1
795,2701,2702,4,6,2
796,6644,6645,1,2,1
797,3568,3569,4,5,1
798,8387,8388,7,0,-7
799,9973,9974,9,4,-5
800,7629,7630,4,5,1
801,5797,5798,8,7,-1
802,2943,2944,1,0,-1
803,6602,6603,0,8,8
804,9199,9200,0,1,1
805,1588,1589,3,0,-3
806,7482,7483,2,2,0
807,2855,2856,5,8,3
808,1921,1922,6,1,-5
809,9270,9271,7,8,1
810,2461,2462,0,2,2
811,4679,4680,9,6,-3
812,6310,6311,1,2,1
813,3700,3701,4,3,-1
814,4071,4072,4,5,1
815,8490,8491,0,1,1
816,1499,1500,8,7,-1
817,4573,4574,2,1,-1
818,9966,9967,6,8,2
819,9815,9816,6,7,1
820,8502,8503,5,9,4
821,5939,5940,7,8,1
822,8320,8321,2,7,5
823,1075,1076,1,2,1
824,5906,5907,7,2,-5
825,2711,2712,6,3,-3
826,209,210,9,4,-5
827,2556,2557,5,0,-5
828,6276,6277,1,5,4
829,1388,1389,6,8,2
830,1692,1693,0,5,5
831,5574,5575,5,9,4
832,2180,2181,5,9,4
833,5892,5893,3,1,-2
834,7181,7182,8,9,1
835,8124,8125,7,8,1
836,9665,9666,6,0,-6
837,5429,5430,9,0,-9
838,9563,9564,8,8,0
839,4322,4323,7,5,-2
840,2086,2087,3,0,-3
841,9327,9328,7,7,0
842,5122,5123,7,4,-3
843,1461,1462,4,2,-2
844,3962,3963,3,2,-1
845,3195,3196,2,1,-1
846,1558,1559,0,9,9
847,7357,7358,9,6,-3
848,3279,3280,8,2,-6
849,6749,6750,6,0,-6
850,6679,6680,7,1,-6
851,2813,2814,3,5,2
852,6989,6990,2,4,2
853,6915,6916,4,9,5
854,1995,1996,0,6,6
855,8073,8074,6,7,1
856,783,784,1,4,3
857,1489,1490,3,3,0
858,4537,4538,3,1,-2
859,4365,4366,0,3,3
860,1901,1902,9,5,-4
861,1984,1985,2,4,2
862,3877,3878,5,7,2
863,3804,3805,0,0,0
864,9110,9111,8,2,-6
865,8753,8754,3,4,1
866,3903,3904,0,2,2
867,8497,8498,7,2,-5
868,3807,3808,8,7,-1
869,2682,2683,5,4,-1
870,9111,9112,2,1,-1
871,4509,4510,3,2,-1
872,8291,8292,6,2,-4
873,3266,3267,0,2,2
874,6086,6087,4,5,1
875,8299,8300,5,8,3
876,9951,9952,0,0,0
877,5741,5742,4,5,1
878,4728,4729,5,1,-4
879,507,508,3,6,3
880,946,947,7,8,1
881,63,64,3,7,4
882,3035,3036,2,6,4
883,4439,4440,6,5,-1
884,5685,5686,0,0,0
885,7030,7031,7,0,-7
886,9317,9318,6,2,-4
887,4997,4998,2,4,2
888,9899,9900,7,8,1
889,2117,2118,4,6,2
890,2582,2583,9,3,-6
891,3635,3636,8,5,-3
892,1430,1431,1,2,1
893,3032,3033,0,6,6
894,6783,6784,1,9,8
895,9673,9674,8,1,-7
896,1892,1893,0,8,8
897,8609,8610,8,4,-4
898,9170,9171,9,1,-8
899,5753,5754,9,9,0
900,5114,5115,7,6,-1
901,1723,1724,0,4,4
902,4675,4676,0,1,1
903,8169,8170,6,5,-1
904,5179,5180,7,7,0
905,1764,1765,0,3,3
906,7632,7633,7,8,1
907,8625,8626,2,4,2
908,1234,1235,8,5,-3
909,8132,8133,5,6,1
910,9241,9242,1,7,6
911,2973,2974,9,1,-8
912,4502,4503,9,2,-7
913,1306,1307,4,6,2
914,2959,2960,2,8,6
915,214,215,9,0,-9
916,5356,5357,3,6,3
917,5944,5945,2,3,1
918,8049,8050,5,3,-2
919,9802,9803,1,2,1
920,2225,2226,8,0,-8
921,7068,7069,6,7,1
922,6450,6451,8,9,1
923,2283,2284,1,3,2
924,5495,5496,8,7,-1
925,4995,4996,2,3,1
926,2693,2694,1,9,8
927,9642,9643,9,1,-8
928,8200,8201,6,3,-3
929,8800,8801,2,3,1
930,2708,2709,4,4,0
931,236,237,2,2,0
932,3904,3905,2,8,6
933,1022,1023,5,4,-1
934,6838,6839,8,8,0
935,9009,9010,7,2,-5
936,8422,8423,9,6,-3
937,4965,4966,2,7,5
938,1986,1987,1,0,-1
939,4487,4488,7,6,-1
940,1689,1690,2,3,1
941,3122,3123,7,4,-3
942,2603,2604,9,5,-4
943,6279,6280,2,0,-2
944,1404,1405,0,5,5
945,9062,9063,2,3,1
946,2975,2976,8,6,-2
947,7486,7487,2,9,7
948,9590,9591,5,1,-4
949,3491,3492,9,8,-1
950,272,273,1,9,8
951,6593,6594,3,2,-1
952,5655,5656,7,8,1
953,9861,9862,4,6,2
954,6371,6372,3,8,5
955,108,109,9,4,-5
956,6385,6386,5,5,0
957,2671,2672,7,6,-1
958,3971,3972,4,6,2
959,4754,4755,1,3,2
960,4006,4007,1,7,6
961,8041,8042,6,6,0
962,2057,2058,6,2,-4
963,2140,2141,6,7,1
964,6231,6232,1,1,0
965,3448,3449,3,3,0
966,1935,1936,7,2,-5
967,1058,1059,9,4,-5
968,9046,9047,2,4,2
969,7234,7235,8,2,-6
970,4260,4261,2,5,3
971,2902,2903,1,5,4
972,7101,7102,4,4,0
973,3358,3359,0,0,0
974,1792,1793,7,9,2
975,433,434,5,9,4
976,641,642,8,0,-8
977,5500,5501,4,6,2
978,4817,4818,8,3,-5
979,7907,7908,0,7,7
980,24,25,4,0,-4
981,1937,1938,6,4,-2
982,6437,6438,0,1,1
983,6909,6910,5,9,4
984,1775,1776,0,7,7
985,2834,2835,8,4,-4
986,8749,8750,7,9,2
987,8138,8139,1,2,1
988,8870,8871,2,7,5
989,3688,3689,6,1,-5
990,3711,3712,9,6,-3
991,1047,1048,0,9,9
992,3165,3166,9,7,-2
993,7434,7435,4,3,-1
994,9868,9869,7,7,0
995,3389,3390,8,3,-5
996,6797,6798,2,0,-2
997,2210,2211,6,8,2
998,4919,4920,9,2,-7
999,1850,1851,8,9,1
1000,7919,7920,8,1,-7
1001,1842,1843,2,0,-2
1002,6692,6693,9,6,-3
1003,3130,3131,6,3,-3
1004,5544,5545,1,2,1
1005,422,423,9,2,-7
1006,1264,1265,4,3,-1
1007,7981,7982,3,4,1
1008,6559,6560,4,9,5
1009,5507,5508,2,3,1
1010,7488,7489,4,9,5
1011,54,55,6,0,-6
1012,1114,1115,3,5,2
1013,8896,8897,6,9,3
1014,8760,8761,6,5,-1
1015,5552,5553,1,1,0
1016,7554,7555,3,0,-3
1017,6952,6953,5,6,1
1018,340,341,5,6,1
1019,9996,9997,3,4,1
1020,1696,1697,2,9,7
1021,1755,1756,5,8,3
1022,5476,5477,4,1,-3
1023,773,774,9,4,-5
1024,4970,4971,7,5,-2
1025,5074,5075,3,8,5
1026,7873,7874,0,9,9
1027,1655,1656,9,2,-7
1028,5291,5292,1,2,1
1029,503,504,2,1,-1
1030,8311,8312,6,4,-2
1031,8001,8002,9,9,0
1032,6028,6029,5,6,1
1033,9524,9525,3,4,1
1034,5967,5968,8,9,1
1035,5973,5974,3,0,-3
1036,7170,7171,3,1,-2
1037,9332,9333,3,4,1
1038,9746,9747,7,5,-2
1039,4362,4363,8,9,1
1040,7116,7117,6,3,-3
1041,7915,7916,7,1,-6
1042,4627,4628,6,0,-6
1043,493,494,3,7,4
1044,3244,3245,1,8,7
1045,2689,2690,5,3,-2
1046,597,598,0,9,9
1047,1927,1928,2,3,1
1048,3671,3672,6,4,-2
1049,8369,8370,4,3,-1
1050,239,240,1,5,4
1051,2728,2729,6,2,-4
1052,9779,9780,2,8,6
1053,1858,1859,6,8,2
1054,9086,9087,6,7,1
1055,3506,3507,5,9,4
1056,8423,8424,6,2,-4
1057,7510,7511,4,5,1
1058,3042,3043,4,0,-4
1059,9004,9005,0,1,1
1060,8568,8569,1,2,1
1061,2750,2751,6,6,0
1062,8381,8382,2,0,-2
1063,2127,2128,0,3,3
1064,1530,1531,8,3,-5
1065,6781,6782,0,6,6
1066,9780,9781,8,7,-1
1067,2218,2219,4,8,4
1068,95,96,4,1,-3
1069,9103,9104,4,4,0
1070,6904,6905,8,9,1
1071,6690,6691,3,6,3
1072,6380,6381,7,3,-4
1073,1591,1592,3,7,4
1074,104,105,9,9,0
1075,8963,8964,8,5,-3
1076,8882,8883,9,7,-2
1077,9572,9573,8,7,-1
1078,2450,2451,3,8,5
1079,7196,7197,6,7,1
1080,1415,1416,8,0,-8
1081,2099,2100,8,5,-3
1082,4284,4285,9,6,-3
1083,6638,6639,5,6,1
1084,3641,3642,1,3,2
1085,6943,6944,6,7,1
1086,2796,2797,6,5,-1
1087,112,113,3,9,6
1088,477,478,2,5,3
1089,4752,4753,9,8,-1
1090,1381,1382,2,4,2
1091,2113,2114,5,5,0
1092,6955,6956,8,9,1
1093,7218,7219,4,7,3
1094,6013,6014,4,2,-2
1095,1217,1218,9,0,-9
1096,5491,5492,9,3,-6
1097,208,209,2,9,7
1098,4527,4528,0,3,3
1099,4395,4396,6,4,-2
1100,5953,5954,1,2,1
1101,6291,6292,5,7,2
1102,3529,3530,9,4,-5
1103,1152,1153,9,6,-3
1104,7978,7979,7,8,1
1105,5525,5526,4,0,-4
1106,8004,8005,1,1,0
1107,8337,8338,3,0,-3
1108,287,288,4,1,-3
1109,18,19,3,4,1
1110,1789,1790,3,2,-1
1111,2393,2394,8,4,-4
1112,7652,7653,9,4,-5
1113,6228,6229,9,6,-3
1114,2754,2755,6,9,3
1115,832,833,7,9,2
1116,3723,3724,9,0,-9
1117,3843,3844,1,2,1
1118,6835,6836,0,2,2
1119,7227,7228,9,1,-8
1120,5548,5549,8,7,-1
1121,100,101,6,0,-6
1122,1971,1972,6,0,-6
1123,3494,3495,7,4,-3
1124,8690,8691,9,0,-9
1125,4560,4561,9,7,-2
1126,680,681,6,9,3
1127,4419,4420,8,5,-3
1128,7003,7004,5,8,3
1129,631,632,8,2,-6
1130,9759,9760,8,1,-7
1131,8552,8553,4,5,1
1132,1663,1664,8,8,0
1133,464,465,3,8,5
1134,9781,9782,7,6,-1
1135,2696,2697,9,5,-4
1136,5214,5215,3,3,0
1137,9764,9765,4,7,3
1138,5608,5609,5,6,1
1139,9849,9850,2,0,-2
1140,5975,5976,4,8,4
1141,3821,3822,9,6,-3
1142,361,362,6,2,-4
1143,1406,1407,5,2,-3
1144,3880,3881,8,9,1
1145,8891,8892,7,1,-6
1146,9859,9860,7,3,-4
1147,3746,3747,3,1,-2
1148,6021,6022,4,9,5
1149,7728,7729,1,2,1
1150,1976,1977,3,6,3
1151,790,791,1,5,4
1152,4490,4491,4,1,-3
1153,2287,2288,1,3,2
1154,1043,1044,4,6,2
1155,435,436,8,8,0
1156,3652,3653,1,4,3
1157,5957,5958,5,6,1
1158,5449,5450,2,0,-2
1159,8309,8310,4,2,-2
1160,7662,7663,4,8,4
1161,3217,3218,3,6,3
1162,8742,8743,7,4,-3
1163,6845,6846,7,6,-1
1164,1861,1862,1,4,3
1165,3453,3454,7,1,-6
1166,2050,2051,8,1,-7
1167,4921,4922,7,8,1
1168,2667,2668,8,5,-3
1169,68,69,3,0,-3
1170,1721,1722,7,2,-5
1171,2764,2765,0,0,0
1172,1041,1042,5,3,-2
1173,7641,7642,9,8,-1
1174,5018,5019,2,3,1
1175,5911,5912,8,3,-5
1176,6090,6091,8,9,1
1177,7166,7167,6,1,-5
1178,7191,7192,1,2,1
1179,3118,3119,6,5,-1
1180,6173,6174,9,3,-6
1181,5396,5397,6,5,-1
1182,8999,9000,0,7,7
1183,8962,8963,9,8,-1
1184,7497,7498,2,5,3
1185,4461,4462,5,0,-5
1186,4136,4137,8,8,0
1187,7092,7093,4,2,-2
1188,7368,7369,0,8,8
1189,8834,8835,5,5,0
1190,2104,2105,7,3,-4
1191,6397,6398,1,0,-1
1192,6753,6754,0,2,2
1193,6857,6858,3,7,4
1194,9326,9327,8,7,-1
1195,8517,8518,6,3,-3
1196,2724,2725,8,1,-7
1197,6164,6165,7,5,-2
1198,4985,4986,2,8,6
1199,1405,1406,5,5,0
1200,7667,7668,6,6,0
1201,7549,7550,6,4,-2
1202,6197,6198,6,7,1
1203,3995,3996,3,4,1
1204,5730,5731,9,0,-9
1205,7306,7307,5,7,2
1206,145,146,1,8,7
1207,5167,5168,2,3,1
1208,5270,5271,0,1,1
1209,97,98,7,6,-1
1210,6927,6928,0,1,1
1211,5604,5605,1,2,1
1212,4726,4727,8,3,-5
1213,4059,4060,5,4,-1
1214,8374,8375,9,7,-2
1215,9480,9481,2,5,3
1216,3399,3400,7,7,0
1217,8272,8273,3,0,-3
1218,8413,8414,8,0,-8
1219,120,121,5,4,-1
1220,9437,9438,6,1,-5
1221,6451,6452,9,7,-2
1222,2317,2318,7,0,-7
1223,2171,2172,1,8,7
1224,8604,8605,1,6,5
1225,9161,9162,8,0,-8
1226,6287,6288,0,0,0
1227,2493,2494,9,9,0
1228,905,906,2,9,7
1229,8617,8618,7,8,1
1230,8170,8171,5,3,-2
1231,2586,2587,5,3,-2
1232,1620,1621,2,0,-2
1233,6479,6480,6,2,-4
1234,6011,6012,3,1,-2
1235,4377,4378,4,5,1
1236,7828,7829,9,3,-6
1237,6489,6490,0,7,7
1238,4473,4474,0,7,7
1239,7565,7566,7,0,-7
1240,5615,5616,2,3,1
1241,28,29,0,1,1
1242,8751,8752,9,0,-9
1243,1769,1770,3,7,4
1244,5279,5280,9,0,-9
1245,8469,8470,1,2,1
1246,8319,8320,9,2,-7
1247,8663,8664,9,4,-5
1248,2444,2445,1,5,4
1249,8523,8524,9,8,-1
1250,3749,3750,6,5,-1
1251,5100,5101,9,4,-5
1252,8636,8637,1,6,5
1253,9663,9664,0,2,2
1254,1299,1300,5,4,-1
1255,2418,2419,1,8,7
1256,6264,6265,0,4,4
1257,9551,9552,4,0,-4
1258,4821,4822,7,8,1
1259,4894,4895,3,8,5
1260,1491,1492,6,9,3
1261,6639,6640,6,7,1
1262,4357,4358,7,9,2
1263,2866,2867,6,1,-5
1264,9125,9126,3,8,5
1265,3048,3049,2,3,1
1266,3201,3202,2,7,5
1267,21,22,6,6,0
1268,8612,8613,2,4,2
1269,9587,9588,9,5,-4
1270,5010,5011,6,8,2
1271,136,137,0,1,1
1272,1733,1734,6,7,1
1273,178,179,1,8,7
1274,3295,3296,5,7,2
1275,1959,1960,0,8,8
1276,8155,8156,4,3,-1
1277,3382,3383,6,6,0
1278,3375,3376,2,7,5
1279,9729,9730,5,6,1
1280,4557,4558,6,4,-2
1281,1726,1727,0,3,3
1282,7618,7619,1,2,1
1283,4882,4883,6,6,0
1284,2641,2642,0,7,7
1285,8069,8070,2,3,1
1286,3872,3873,9,8,-1
1287,1864,1865,4,4,0
1288,9424,9425,6,0,-6
1289,1366,1367,7,3,-4
1290,4990,4991,3,7,4
1291,1874,1875,5,7,2
1292,1314,1315,4,3,-1
1293,3479,3480,0,1,1
1294,3976,3977,7,3,-4
1295,1908,1909,6,1,-5
1296,967,968,1,4,3
1297,1920,1921,4,6,2
1298,2878,2879,1,4,3
1299,9187,9188,8,9,1
1300,1623,1624,0,7,7
1301,516,517,2,6,4
1302,5902,5903,1,7,6
1303,5756,5757,0,9,9
1304,5857,5858,8,7,-1
1305,8121,8122,4,5,1
1306,1177,1178,2,4,2
1307,9497,9498,9,0,-9
1308,2152,2153,8,3,-5
1309,686,687,3,3,0
1310,9913,9914,2,3,1
1311,8831,8832,6,4,-2
1312,876,877,8,8,0
1313,2494,2495,9,2,-7
1314,280,281,2,9,7
1315,8754,8755,4,4,0
1316,3885,3886,9,6,-3
1317,2738,2739,6,8,2
1318,8378,8379,4,3,-1
1319,1144,1145,5,4,-1
1320,9483,9484,9,4,-5
1321,2770,2771,3,4,1
1322,3214,3215,1,0,-1
1323,7773,7774,2,8,6
1324,8792,8793,6,2,-4
1325,8822,8823,4,5,1
1326,6286,6287,0,0,0
1327,2042,2043,0,4,4
1328,6234,6235,2,9,7
1329,3956,3957,4,5,1
1330,8503,8504,9,9,0
1331,8651,8652,7,5,-2
1332,8869,8870,6,2,-4
1333,9248,9249,7,1,-6
1334,8264,8265,4,7,3
1335,416,417,1,9,8
1336,4669,4670,7,1,-6
1337,8173,8174,7,2,-5
1338,3141,3142,6,2,-4
1339,5515,5516,2,3,1
1340,561,562,0,9,9
1341,1767,1768,4,0,-4
1342,3644,3645,8,5,-3
1343,7393,7394,5,4,-1
1344,6192,6193,1,2,1
1345,3695,3696,0,2,2
1346,8940,8941,5,4,-1
1347,8451,8452,3,4,1
1348,1629,1630,5,1,-4
1349,8880,8881,2,0,-2
1350,5764,5765,3,8,5
1351,9550,9551,4,4,0
1352,8162,8163,3,0,-3
1353,869,870,5,6,1
1354,3164,3165,6,9,3
1355,5923,5924,4,2,-2
1356,979,980,1,2,1
1357,7801,7802,7,1,-6
1358,1255,1256,9,2,-7
1359,3243,3244,0,1,1
1360,8110,8111,7,0,-7
1361,729,730,6,7,1
1362,1742,1743,3,9,6
1363,4026,4027,3,7,4
1364,4437,4438,3,4,1
1365,7962,7963,9,8,-1
1366,5108,5109,0,0,0
1367,3921,3922,2,1,-1
1368,4021,4022,1,6,5
1369,4898,4899,6,2,-4
1370,4717,4718,1,0,-1
1371,6049,6050,8,7,-1
1372,2440,2441,4,3,-1
1373,6088,6089,6,7,1
1374,8755,8756,4,8,4
1375,6201,6202,0,1,1
1376,2945,2946,3,1,-2
1377,6682,6683,9,1,-8
1378,5430,5431,0,1,1
1379,3231,3232,1,4,3
1380,1990,1991,6,2,-4
1381,5237,5238,3,7,4
1382,1631,1632,9,6,-3
1383,1713,1714,0,9,9
1384,9683,9684,4,7,3
1385,1123,1124,6,8,2
1386,1235,1236,5,1,-4
1387,9949,9950,6,1,-5
1388,9628,9629,7,8,1
1389,1377,1378,6,5,-1
1390,658,659,7,2,-5
1391,7344,7345,1,2,1
1392,666,667,7,7,0
1393,4348,4349,0,1,1
1394,1727,1728,3,1,-2
1395,8324,8325,1,0,-1
1396,2416,2417,1,0,-1
1397,2718,2719,6,1,-5
1398,8098,8099,0,1,1
1399,3393,3394,5,9,4
1400,2743,2744,5,8,3
1401,1963,1964,4,9,5
1402,730,731,7,2,-5
1403,7334,7335,7,6,-1
1404,7808,7809,5,5,0
1405,8988,8989,1,4,3
1406,5272,5273,2,3,1
1407,3180,3181,2,6,4
1408,446,447,6,4,-2
1409,8281,8282,6,7,1
1410,2272,2273,8,1,-7
1411,1490,1491,3,6,3
1412,5645,5646,9,1,-8
1413,2938,2939,4,9,5
1414,6767,6768,3,7,4
1415,7361,7362,4,7,3
1416,6696,6697,4,7,3
1417,234,235,7,9,2
1418,4788,4789,0,8,8
1419,4765,4766,6,5,-1
1420,1437,1438,4,0,-4
1421,2003,2004,5,8,3
1422,8686,8687,5,6,1
1423,5421,5422,6,7,1
1424,2518,2519,5,1,-4
1425,1132,1133,2,7,5
1426,6744,6745,2,3,1
1427,4796,4797,3,8,5
1428,4135,4136,2,8,6
1429,6305,6306,2,7,5
1430,6713,6714,2,3,1
1431,1460,1461,5,4,-1
1432,310,311,3,0,-3
1433,5542,5543,3,8,5
1434,1722,1723,2,0,-2
1435,6080,6081,8,9,1
1436,7935,7936,2,3,1
1437,8719,8720,2,1,-1
1438,9997,9998,4,5,1
1439,5472,5473,3,5,2
1440,2966,2967,9,7,-2
1441,4641,4642,0,0,0
1442,1736,1737,1,5,4
1443,2710,2711,7,6,-1
1444,8696,8697,5,6,1
1445,5718,5719,0,9,9
1446,2013,2014,1,9,8
1447,4353,4354,0,2,2
1448,5509,5510,4,5,1
1449,9167,9168,0,2,2
1450,8380,8381,6,2,-4
1451,1398,1399,8,0,-8
1452,6919,6920,9,2,-7
1453,6620,6621,5,0,-5
1454,6627,6628,9,1,-8
1455,1615,1616,3,6,3
1456,8545,8546,1,6,5
1457,8888,8889,6,2,-4
1458,1328,1329,7,1,-6
1459,9075,9076,5,6,1
1460,1872,1873,4,9,5
1461,4943,4944,2,2,0
1462,7235,7236,2,9,7
1463,9651,9652,5,7,2
1464,1997,1998,3,9,6
1465,7991,7992,9,2,-7
1466,7094,7095,8,9,1
1467,9498,9499,0,1,1
1468,5322,5323,4,1,-3
1469,6973,6974,3,4,1
1470,1015,1016,4,2,-2
1471,2102,2103,8,5,-3
1472,1062,1063,3,9,6
1473,718,719,8,4,-4
1474,5088,5089,6,2,-4
1475,9734,9735,7,4,-3
1476,4699,4700,6,9,3
1477,7446,7447,0,1,1
1478,6758,6759,1,4,3
1479,3826,3827,5,6,1
1480,4182,4183,9,9,0
1481,9391,9392,5,6,1
1482,6474,6475,4,4,0
1483,1875,1876,7,1,-6
1484,1205,1206,3,7,4
1485,5022,5023,9,4,-5
1486,6951,6952,4,5,1
1487,7540,7541,6,5,-1
1488,4736,4737,7,8,1
1489,5708,5709,3,7,4
1490,475,476,4,1,-3
1491,6084,6085,2,3,1
1492,6215,6216,5,5,0
1493,7027,7028,8,7,-1
1494,3274,3275,2,5,3
1495,2505,2506,7,0,-7
1496,7844,7845,7,8,1
1497,2659,2660,4,0,-4
1498,6429,6430,0,1,1
1499,8872,8873,8,1,-7
1500,3592,3593,9,1,-8
1501,6515,6516,1,4,3
1502,7940,7941,7,8,1
1503,4735,4736,9,7,-2
1504,5782,5783,4,1,-3
1505,3612,3613,4,0,-4
1506,624,625,2,6,4
1507,2369,2370,5,0,-5
1508,4614,4615,0,2,2
1509,2406,2407,9,7,-2
1510,7738,7739,1,2,1
1511,6977,6978,5,0,-5
1512,7199,7200,9,8,-1
1513,7067,7068,5,6,1
1514,1285,1286,5,8,3
1515,7550,7551,4,3,-1
1516,8204,8205,4,4,0
1517,7119,7120,3,2,-1
1518,8131,8132,4,5,1
1519,62,63,9,3,-6
1520,8063,8064,6,7,1
1521,5486,5487,1,2,1
1522,4866,4867,4,5,1
1523,9251,9252,6,9,3
1524,3832,3833,2,8,6
1525,7367,7368,0,0,0
1526,7180,7181,7,8,1
1527,2705,2706,1,1,0
1528,6461,6462,0,2,2
1529,8855,8856,5,3,-2
1530,1616,1617,6,3,-3
1531,1193,1194,1,7,6
1532,9753,9754,0,5,5
1533,8232,8233,5,1,-4
1534,4095,4096,9,8,-1
1535,7606,7607,7,0,-7
1536,44,45,3,5,2
1537,9384,9385,7,8,1
1538,9335,9336,1,1,0
1539,9373,9374,6,7,1
1540,1175,1176,7,0,-7
1541,5845,5846,7,8,1
1542,7910,7911,4,1,-3
1543,9205,9206,8,9,1
1544,9907,9908,5,6,1
1545,9608,9609,7,8,1
1546,2554,2555,5,3,-2
1547,5380,5381,8,2,-6
1548,8267,8268,9,1,-8
1549,6590,6591,0,6,6
1550,6894,6895,0,9,9
1551,3037,3038,2,7,5
1552,2607,2608,7,8,1
1553,966,967,9,1,-8
1554,9455,9456,0,2,2
1555,1260,1261,7,0,-7
1556,7224,7225,9,0,-9
1557,4909,4910,1,9,8
1558,771,772,7,1,-6
1559,6756,6757,7,1,-6
1560,7091,7092,1,4,3
1561,8268,8269,1,4,3
1562,5072,5073,1,9,8
1563,2259,2260,9,2,-7
1564,7110,7111,6,7,1
1565,157,158,0,3,3
1566,270,271,3,0,-3
1567,4048,4049,0,7,7
1568,2318,2319,0,4,4
1569,3277,3278,7,4,-3
1570,5513,5514,0,1,1
1571,8661,8662,8,4,-4
1572,5178,5179,4,7,3
1573,7613,7614,6,7,1
1574,2498,2499,4,4,0
1575,3074,3075,3,9,6
1576,1746,1747,3,5,2
1577,5066,5067,6,3,-3
1578,353,354,6,1,-5
1579,7855,7856,0,1,1
1580,4200,4201,7,1,-6
1581,8501,8502,0,5,5
1582,3278,3279,4,8,4
1583,5044,5045,1,2,1
1584,2477,2478,9,9,0
1585,6616,6617,2,8,6
1586,9954,9955,2,1,-1
1587,786,787,6,8,2
1588,6938,6939,1,2,1
1589,5135,5136,9,6,-3
1590,8976,8977,1,9,8
1591,9820,9821,2,3,1
1592,307,308,7,4,-3
1593,9821,9822,3,4,1
1594,5256,5257,4,0,-4
1595,5213,5214,6,3,-3
1596,2954,2955,0,3,3
1597,2350,2351,2,3,1
1598,2000,2001,6,5,-1
1599,2492,2493,0,9,9
1600,182,183,5,0,-5
1601,1257,1258,1,5,4
1602,6565,6566,9,2,-7
1603,4556,4557,9,6,-3
1604,5255,5256,0,4,4
1605,8972,8973,3,2,-1
1606,7767,7768,8,6,-2
1607,1011,1012,1,7,6
1608,2463,2464,7,4,-3
1609,2706,2707,1,0,-1
1610,4350,4351,2,0,-2
1611,8978,8979,0,1,1
1612,719,720,4,5,1
1613,1862,1863,4,2,-2
1614,2803,2804,1,4,3
1615,7315,7316,5,4,-1
1616,5274,5275,4,5,1
1617,37,38,1,2,1
1618,4841,4842,3,4,1
1619,2864,2865,2,3,1
1620,9255,9256,9,6,-3
1621,1401,1402,7,2,-5
1622,1368,1369,1,7,6
1623,1335,1336,2,2,0
1624,9388,9389,1,2,1
1625,5413,5414,8,9,1
1626,3363,3364,3,8,5
1627,3199,3200,5,9,4
1628,1772,1773,7,1,-6
1629,2852,2853,8,3,-5
1630,1442,1443,3,8,5
1631,2321,2322,6,5,-1
1632,7121,7122,8,6,-2
1633,1847,1848,5,7,2
1634,5686,5687,0,3,3
1635,4230,4231,8,8,0
1636,1214,1215,1,3,2
1637,3954,3955,8,5,-3
1638,5595,5596,2,3,1
1639,6991,6992,5,7,2
1640,3208,3209,7,6,-1
1641,8791,8792,7,6,-1
1642,5109,5110,0,7,7
1643,2703,2704,0,1,1
1644,2145,2146,4,8,4
1645,6906,6907,2,3,1
1646,5891,5892,5,3,-2
1647,4454,4455,9,8,-1
1648,1472,1473,3,5,2
1649,9678,9679,6,6,0
1650,4253,4254,8,5,-3
1651,1564,1565,7,0,-7
1652,2936,2937,4,0,-4
1653,7780,7781,0,2,2
1654,3284,3285,8,3,-5
1655,1911,1912,5,8,3
1656,7580,7581,9,1,-8
1657,1468,1469,0,3,3
1658,3674,3675,8,2,-6
1659,7569,7570,8,2,-6
1660,1304,1305,9,1,-8
1661,5907,5908,2,9,7
1662,402,403,3,8,5
1663,9457,9458,0,7,7
1664,442,443,3,0,-3
1665,1569,1570,6,0,-6
1666,1954,1955,5,8,3
1667,8479,8480,9,7,-2
1668,1646,1647,1,9,8
1669,9085,9086,5,6,1
1670,8259,8260,9,0,-9
1671,2434,2435,1,0,-1
1672,7389,7390,6,7,1
1673,7303,7304,1,5,4
1674,6512,6513,9,2,-7
1675,86,87,7,3,-4
1676,4047,4048,9,0,-9
1677,4386,4387,1,2,1
1678,2843,2844,7,7,0
1679,8798,8799,0,1,1
1680,4737,4738,8,4,-4
1681,2310,2311,9,2,-7
1682,6582,6583,4,0,-4
1683,9145,9146,2,6,4
1684,65,66,4,6,2
1685,2674,2675,1,4,3
1686,3372,3373,5,7,2
1687,7509,7510,3,4,1
1688,8868,8869,0,6,6
1689,3598,3599,1,2,1
1690,8257,8258,7,8,1
1691,2501,2502,3,3,0
1692,6143,6144,4,4,0
1693,673,674,9,5,-4
1694,426,427,9,1,-8
1695,2678,2679,4,2,-2
1696,2542,2543,6,8,2
1697,9365,9366,3,6,3
1698,1813,1814,8,7,-1
1699,1310,1311,3,9,6
1700,1350,1351,1,1,0
1701,1527,1528,1,1,0
1702,6137,6138,8,4,-4
1703,3182,3183,6,5,-1
1704,4209,4210,6,9,3
1705,9026,9027,9,3,-6
1706,8321,8322,7,9,2
1707,2568,2569,0,5,5
1708,1516,1517,4,0,-4
1709,2986,2987,5,5,0
1710,4989,4990,9,3,-6
1711,8163,8164,0,1,1
1712,817,818,6,1,-5
1713,5661,5662,1,5,4
1714,5052,5053,1,2,1
1715,5317,5318,7,1,-6
1716,2810,2811,5,0,-5
1717,1244,1245,7,2,-5
1718,8608,8609,7,8,1
1719,3744,3745,6,1,-5
1720,8998,8999,9,0,-9
1721,6034,6035,3,2,-1
1722,9090,9091,1,6,5
1723,250,251,4,1,-3
1724,7699,7700,0,9,9
1725,4535,4536,3,6,3
1726,8130,8131,3,4,1
1727,5862,5863,5,2,-3
1728,8117,8118,0,1,1
1729,6363,6364,7,7,0
1730,1941,1942,7,8,1
1731,6695,6696,4,4,0
1732,725,726,1,7,6
1733,43,44,2,3,1
1734,3367,3368,2,0,-2
1735,2772,2773,5,5,0
1736,3466,3467,8,9,1
1737,1699,1700,7,0,-7
1738,9577,9578,2,2,0
1739,6674,6675,7,6,-1
1740,2253,2254,2,2,0
1741,6850,6851,8,8,0
1742,548,549,3,2,-1
1743,6227,6228,5,9,4
1744,930,931,7,4,-3
1745,8225,8226,2,3,1
1746,4076,4077,5,1,-4
1747,6569,6570,3,3,0
1748,2502,2503,3,2,-1
1749,4344,4345,9,2,-7
1750,918,919,1,2,1
1751,7047,7048,4,1,-3
1752,8368,8369,6,4,-2
1753,8744,8745,6,1,-5
1754,612,613,2,2,0
1755,2414,2415,9,2,-7
1756,2455,2456,0,9,9
1757,3656,3657,7,6,-1
1758,8038,8039,5,4,-1
1759,4424,4425,9,9,0
1760,864,865,8,3,-5
1761,804,805,0,8,8
1762,4131,4132,5,6,1
1763,4572,4573,8,2,-6
1764,191,192,1,0,-1
1765,1172,1173,3,7,4
1766,7429,7430,4,5,1
1767,6530,6531,5,6,1
1768,5503,5504,9,3,-6
1769,48,49,4,4,0
1770,4668,4669,2,7,5
1771,2989,2990,3,8,5
1772,2593,2594,0,3,3
1773,7611,7612,4,5,1
1774,9399,9400,7,5,-2
1775,3847,3848,0,7,7
1776,2001,2002,5,6,1
1777,9155,9156,1,3,2
1778,1996,1997,6,3,-3
1779,7884,7885,9,4,-5
1780,190,191,1,1,0
1781,8248,8249,7,8,1
1782,6081,6082,9,0,-9
1783,8079,8080,2,3,1
1784,5541,5542,2,3,1
1785,6401,6402,9,6,-3
1786,7464,7465,9,0,-9
1787,443,444,0,2,2
1788,4981,4982,2,8,6
1789,6734,6735,4,8,4
1790,5629,5630,2,1,-1
1791,3424,3425,6,7,1
1792,9924,9925,9,3,-6
1793,9694,9695,8,8,0
1794,6763,6764,3,6,3
1795,2535,2536,6,0,-6
1796,7697,7698,9,5,-4
1797,69,70,0,7,7
1798,5327,5328,1,3,2
1799,3004,3005,2,9,7
1800,9098,9099,4,4,0
1801,4258,4259,4,9,5
1802,8496,8497,0,7,7
1803,5794,5795,1,7,6
1804,7466,7467,6,7,1
1805,6361,6362,7,4,-3
1806,1421,1422,5,4,-1
1807,1127,1128,3,3,0
1808,2527,2528,0,9,9
1809,6816,6817,8,9,1
1810,3636,3637,5,7,2
1811,4613,4614,3,0,-3
1812,3926,3927,9,9,0
1813,9842,9843,6,9,3
1814,9794,9795,6,1,-5
1815,7257,7258,3,6,3
1816,6107,6108,3,1,-2
1817,722,723,4,0,-4
1818,1575,1576,4,7,3
1819,7410,7411,0,1,1
1820,2059,2060,7,0,-7
1821,3498,3499,7,8,1
1822,7529,7530,3,4,1
1823,6152,6153,4,8,4
1824,8128,8129,1,2,1
1825,4109,4110,3,1,-2
1826,4336,4337,6,1,-5
1827,1277,1278,9,3,-6
1828,5691,5692,4,2,-2
1829,7089,7090,9,5,-4
1830,4578,4579,7,6,-1
1831,5300,5301,8,0,-8
1832,7283,7284,4,5,1
1833,3563,3564,8,6,-2
1834,2005,2006,4,6,2
1835,7414,7415,5,6,1
1836,3097,3098,1,7,6
1837,5946,5947,4,5,1
1838,8731,8732,0,6,6
1839,890,891,3,2,-1
1840,9492,9493,4,5,1
1841,7165,7166,1,6,5
1842,123,124,6,7,1
1843,2644,2645,5,4,-1
1844,6789,6790,1,3,2
1845,1361,1362,7,6,-1
1846,6465,6466,3,2,-1
1847,3898,3899,5,2,-3
1848,5462,5463,8,0,-8
1849,648,649,3,7,4
1850,6487,6488,9,4,-5
1851,5605,5606,2,3,1
1852,6930,6931,3,4,1
1853,3109,3110,7,3,-4
1854,4605,4606,3,1,-2
1855,8942,8943,8,2,-6
1856,6966,6967,6,9,3
1857,1330,1331,4,5,1
1858,3054,3055,7,7,0
1859,7616,7617,9,0,-9
1860,9012,9013,4,5,1
1861,5176,5177,8,7,-1
1862,5930,5931,0,2,2
1863,116,117,4,4,0
1864,9937,9938,2,6,4
1865,4648,4649,9,6,-3
1866,1282,1283,9,7,-2
1867,1220,1221,0,5,5
1868,4459,4460,7,7,0
1869,8470,8471,2,3,1
1870,7839,7840,1,2,1
1871,2036,2037,7,5,-2
1872,8765,8766,0,3,3
1873,8771,8772,6,0,-6
1874,4373,4374,4,5,1
1875,3510,3511,2,2,0
1876,8632,8633,5,1,-4
1877,4534,4535,9,3,-6
1878,4480,4481,9,4,-5
1879,3618,3619,9,5,-4
1880,3611,3612,2,4,2
1881,2497,2498,9,4,-5
1882,3871,3872,8,9,1
1883,3373,3374,7,8,1
1884,2794,2795,0,6,6
1885,153,154,5,1,-4
1886,7447,7448,1,5,4
1887,9582,9583,3,5,2
1888,1155,1156,2,7,5
1889,5672,5673,9,0,-9
1890,3318,3319,2,8,6
1891,5314,5315,1,9,8
1892,1463,1464,3,8,5
1893,7124,7125,7,4,-3
1894,5103,5104,8,4,-4
1895,7592,7593,9,0,-9
1896,5202,5203,4,1,-3
1897,479,480,9,1,-8
1898,4772,4773,4,7,3
1899,9814,9815,5,6,1
1900,1945,1946,1,8,7
1901,4383,4384,9,2,-7
1902,5206,5207,5,5,0
1903,4271,4272,5,9,4
1904,9993,9994,0,1,1
1905,9461,9462,6,8,2
1906,4980,4981,6,2,-4
1907,7381,7382,0,9,9
1908,1956,1957,4,2,-2
1909,216,217,3,6,3
1910,6362,6363,4,7,3
1911,2623,2624,3,3,0
1912,6705,6706,4,5,1
1913,6369,6370,4,3,-1
1914,7695,7696,7,4,-3
1915,9880,9881,2,3,1
1916,9443,9444,1,1,0
1917,362,363,2,2,0
1918,8067,8068,0,1,1
1919,6378,6379,4,3,-1
1920,2181,2182,9,1,-8
1921,243,244,7,2,-5
1922,3162,3163,7,8,1
1923,5894,5895,9,2,-7
1924,3632,3633,7,8,1
1925,5401,5402,6,7,1
1926,376,377,4,1,-3
1927,8594,8595,2,0,-2
1928,365,366,0,6,6
1929,3461,3462,7,5,-2
1930,9987,9988,4,5,1
1931,5224,5225,3,3,0
1932,2767,2768,3,5,2
1933,76,77,3,2,-1
1934,9245,9246,9,2,-7
1935,1098,1099,3,6,3
1936,220,221,7,2,-5
1937,9617,9618,6,7,1
1938,2860,2861,6,2,-4
1939,1166,1167,3,4,1
1940,217,218,6,5,-1
1941,8040,8041,6,6,0
1942,8097,8098,8,0,-8
1943,5457,5458,1,6,5
1944,7888,7889,5,0,-5
1945,6375,6376,1,9,8
1946,7597,7598,8,7,-1
1947,5054,5055,3,4,1
1948,1626,1627,6,9,3
1949,1357,1358,4,1,-3
1950,5927,5928,4,6,2
1951,1126,1127,7,3,-4
1952,9637,9638,7,9,2
1953,6252,6253,6,7,1
1954,9472,9473,9,4,-5
1955,2802,2803,2,1,-1
1956,3988,3989,8,0,-8
1957,7335,7336,6,9,3
1958,981,982,0,3,3
1959,9735,9736,4,6,2
1960,3889,3890,9,5,-4
1961,2214,2215,5,6,1
1962,5062,5063,3,4,1
1963,2520,2521,8,7,-1
1964,4244,4245,3,9,6
1965,3762,3763,6,5,-1
1966,4916,4917,4,1,-3
1967,9099,9100,4,3,-1
1968,6480,6481,2,3,1
1969,8881,8882,0,9,9
1970,6423,6424,2,0,-2
1971,5523,5524,9,1,-8
1972,8203,8204,7,4,-3
1973,1180,1181,1,6,5
1974,1898,1899,0,8,8
1975,5703,5704,3,9,6
1976,4298,4299,9,9,0
1977,4478,4479,8,9,1
1978,56,57,4,1,-3
1979,6997,6998,4,9,5
1980,3020,3021,0,2,2
1981,9777,9778,5,6,1
1982,2741,2742,2,9,7
1983,1373,1374,6,2,-4
1984,5207,5208,5,1,-4
1985,6818,6819,0,1,1
1986,31,32,1,3,2
1987,6161,6162,8,1,-7
1988,1372,1373,2,6,4
1989,7864,7865,9,7,-2
1990,8160,8161,5,2,-3
1991,7317,7318,0,9,9
1992,4829,4830,8,5,-3
1993,9559,9560,3,7,4
1994,3601,3602,1,6,5
1995,181,182,8,5,-3
1996,9585,9586,0,7,7
1997,8288,8289,9,1,-8
