,x1,x2,x1_label,x2_label,class_label
0,0,1,7,2,-5
1,1,2,2,1,-1
2,2,3,1,0,-1
3,3,4,0,4,4
4,4,5,4,1,-3
5,5,6,1,4,3
6,6,7,4,9,5
7,7,8,9,5,-4
8,8,9,5,9,4
9,9,10,9,0,-9
10,10,11,0,6,6
11,11,12,6,9,3
12,12,13,9,0,-9
13,13,14,0,1,1
14,14,15,1,5,4
15,15,16,5,9,4
16,16,17,9,7,-2
17,17,18,7,3,-4
18,18,19,3,4,1
19,19,20,4,9,5
20,20,21,9,6,-3
21,21,22,6,6,0
22,22,23,6,5,-1
23,23,24,5,4,-1
24,24,25,4,0,-4
25,25,26,0,7,7
26,26,27,7,4,-3
27,27,28,4,0,-4
28,28,29,0,1,1
29,29,30,1,3,2
30,30,31,3,1,-2
31,31,32,1,3,2
32,32,33,3,4,1
33,33,34,4,7,3
34,34,35,7,2,-5
35,35,36,2,7,5
36,36,37,7,1,-6
37,37,38,1,2,1
38,38,39,2,1,-1
39,39,40,1,1,0
40,40,41,1,7,6
41,41,42,7,4,-3
42,42,43,4,2,-2
43,43,44,2,3,1
44,44,45,3,5,2
45,45,46,5,1,-4
46,46,47,1,2,1
47,47,48,2,4,2
48,48,49,4,4,0
49,49,50,4,6,2
50,50,51,6,3,-3
51,51,52,3,5,2
52,52,53,5,5,0
53,53,54,5,6,1
54,54,55,6,0,-6
55,55,56,0,4,4
56,56,57,4,1,-3
57,57,58,1,9,8
58,58,59,9,5,-4
59,59,60,5,7,2
60,60,61,7,8,1
61,61,62,8,9,1
62,62,63,9,3,-6
63,63,64,3,7,4
64,64,65,7,4,-3
65,65,66,4,6,2
66,66,67,6,4,-2
67,67,68,4,3,-1
68,68,69,3,0,-3
69,69,70,0,7,7
70,70,71,7,0,-7
71,71,72,0,2,2
72,72,73,2,9,7
73,73,74,9,1,-8
74,74,75,1,7,6
75,75,76,7,3,-4
76,76,77,3,2,-1
77,77,78,2,9,7
78,78,79,9,7,-2
79,79,80,7,7,0
80,80,81,7,6,-1
81,81,82,6,2,-4
82,82,83,2,7,5
83,83,84,7,8,1
84,84,85,8,4,-4
85,85,86,4,7,3
86,86,87,7,3,-4
87,87,88,3,6,3
88,88,89,6,1,-5
89,89,90,1,3,2
90,90,91,3,6,3
91,91,92,6,9,3
92,92,93,9,3,-6
93,93,94,3,1,-2
94,94,95,1,4,3
95,95,96,4,1,-3
96,96,97,1,7,6
97,97,98,7,6,-1
98,98,99,6,9,3
99,99,100,9,6,-3
100,100,101,6,0,-6
101,101,102,0,5,5
102,102,103,5,4,-1
103,103,104,4,9,5
104,104,105,9,9,0
105,105,106,9,2,-7
106,106,107,2,1,-1
107,107,108,1,9,8
108,108,109,9,4,-5
109,109,110,4,8,4
110,110,111,8,7,-1
111,111,112,7,3,-4
112,112,113,3,9,6
113,113,114,9,7,-2
114,114,115,7,4,-3
115,115,116,4,4,0
116,116,117,4,4,0
117,117,118,4,9,5
118,118,119,9,2,-7
119,119,120,2,5,3
120,120,121,5,4,-1
121,121,122,4,7,3
122,122,123,7,6,-1
123,123,124,6,7,1
124,124,125,7,9,2
125,125,126,9,0,-9
126,126,127,0,5,5
127,127,128,5,8,3
128,128,129,8,5,-3
129,129,130,5,6,1
130,130,131,6,6,0
131,131,132,6,5,-1
132,132,133,5,7,2
133,133,134,7,8,1
134,134,135,8,1,-7
135,135,136,1,0,-1
136,136,137,0,1,1
137,137,138,1,6,5
138,138,139,6,4,-2
139,139,140,4,6,2
140,140,141,6,7,1
141,141,142,7,3,-4
142,142,143,3,1,-2
143,143,144,1,7,6
144,144,145,7,1,-6
145,145,146,1,8,7
146,146,147,8,2,-6
147,147,148,2,0,-2
148,148,149,0,2,2
149,149,150,2,9,7
150,150,151,9,9,0
151,151,152,9,5,-4
152,152,153,5,5,0
153,153,154,5,1,-4
154,154,155,1,5,4
155,155,156,5,6,1
156,156,157,6,0,-6
157,157,158,0,3,3
158,158,159,3,4,1
159,159,160,4,4,0
160,160,161,4,6,2
161,161,162,6,5,-1
162,162,163,5,4,-1
163,163,164,4,6,2
164,164,165,6,5,-1
165,165,166,5,4,-1
166,166,167,4,5,1
167,167,168,5,1,-4
168,168,169,1,4,3
169,169,170,4,4,0
170,170,171,4,7,3
171,171,172,7,2,-5
172,172,173,2,3,1
173,173,174,3,2,-1
174,174,175,2,7,5
175,175,176,7,1,-6
176,176,177,1,8,7
177,177,178,8,1,-7
178,178,179,1,8,7
179,179,180,8,1,-7
180,180,181,1,8,7
181,181,182,8,5,-3
182,182,183,5,0,-5
183,183,184,0,8,8
184,184,185,8,9,1
185,185,186,9,2,-7
186,186,187,2,5,3
187,187,188,5,0,-5
188,188,189,0,1,1
189,189,190,1,1,0
190,190,191,1,1,0
191,191,192,1,0,-1
192,192,193,0,9,9
193,193,194,9,0,-9
194,194,195,0,3,3
195,195,196,3,1,-2
196,196,197,1,6,5
197,197,198,6,4,-2
198,198,199,4,2,-2
199,199,200,2,3,1
200,200,201,3,6,3
201,201,202,6,1,-5
202,202,203,1,1,0
203,203,204,1,1,0
204,204,205,1,3,2
205,205,206,3,9,6
206,206,207,9,5,-4
207,207,208,5,2,-3
208,208,209,2,9,7
209,209,210,9,4,-5
210,210,211,4,5,1
211,211,212,5,9,4
212,212,213,9,3,-6
213,213,214,3,9,6
214,214,215,9,0,-9
215,215,216,0,3,3
216,216,217,3,6,3
217,217,218,6,5,-1
218,218,219,5,5,0
219,219,220,5,7,2
220,220,221,7,2,-5
221,221,222,2,2,0
222,222,223,2,7,5
223,223,224,7,1,-6
224,224,225,1,2,1
225,225,226,2,8,6
226,226,227,8,4,-4
227,227,228,4,1,-3
228,228,229,1,7,6
229,229,230,7,3,-4
230,230,231,3,3,0
231,231,232,3,8,5
232,232,233,8,8,0
233,233,234,8,7,-1
234,234,235,7,9,2
235,235,236,9,2,-7
236,236,237,2,2,0
237,237,238,2,4,2
238,238,239,4,1,-3
239,239,240,1,5,4
240,240,241,5,9,4
241,241,242,9,8,-1
242,242,243,8,7,-1
243,243,244,7,2,-5
244,244,245,2,3,1
245,245,246,3,0,-3
246,246,247,0,4,4
247,247,248,4,4,0
248,248,249,4,2,-2
249,249,250,2,4,2
250,250,251,4,1,-3
251,251,252,1,9,8
252,252,253,9,5,-4
253,253,254,5,7,2
254,254,255,7,7,0
255,255,256,7,2,-5
256,256,257,2,8,6
257,257,258,8,2,-6
258,258,259,2,6,4
259,259,260,6,8,2
260,260,261,8,5,-3
261,261,262,5,7,2
262,262,263,7,7,0
263,263,264,7,9,2
264,264,265,9,1,-8
265,265,266,1,8,7
266,266,267,8,1,-7
267,267,268,1,8,7
268,268,269,8,0,-8
269,269,270,0,3,3
270,270,271,3,0,-3
271,271,272,0,1,1
272,272,273,1,9,8
273,273,274,9,9,0
274,274,275,9,4,-5
275,275,276,4,1,-3
276,276,277,1,8,7
277,277,278,8,2,-6
278,278,279,2,1,-1
279,279,280,1,2,1
280,280,281,2,9,7
281,281,282,9,7,-2
282,282,283,7,5,-2
283,283,284,5,9,4
284,284,285,9,2,-7
285,285,286,2,6,4
286,286,287,6,4,-2
287,287,288,4,1,-3
288,288,289,1,5,4
289,289,290,5,8,3
290,290,291,8,2,-6
291,291,292,2,9,7
292,292,293,9,2,-7
293,293,294,2,0,-2
294,294,295,0,4,4
295,295,296,4,0,-4
296,296,297,0,0,0
297,297,298,0,2,2
298,298,299,2,8,6
299,299,300,8,4,-4
300,300,301,4,7,3
301,301,302,7,1,-6
302,302,303,1,2,1
303,303,304,2,4,2
304,304,305,4,0,-4
305,305,306,0,2,2
306,306,307,2,7,5
307,307,308,7,4,-3
308,308,309,4,3,-1
309,309,310,3,3,0
310,310,311,3,0,-3
311,311,312,0,0,0
312,312,313,0,3,3
313,313,314,3,1,-2
314,314,315,1,9,8
315,315,316,9,6,-3
316,316,317,6,5,-1
317,317,318,5,2,-3
318,318,319,2,5,3
319,319,320,5,9,4
320,320,321,9,2,-7
321,321,322,2,9,7
322,322,323,9,3,-6
323,323,324,3,0,-3
324,324,325,0,4,4
325,325,326,4,2,-2
326,326,327,2,0,-2
327,327,328,0,7,7
328,328,329,7,1,-6
329,329,330,1,1,0
330,330,331,1,2,1
331,331,332,2,1,-1
332,332,333,1,5,4
333,333,334,5,3,-2
334,334,335,3,3,0
335,335,336,3,9,6
336,336,337,9,7,-2
337,337,338,7,8,1
338,338,339,8,6,-2
339,339,340,6,5,-1
340,340,341,5,6,1
341,341,342,6,1,-5
342,342,343,1,3,2
343,343,344,3,8,5
344,344,345,8,1,-7
345,345,346,1,0,-1
346,346,347,0,5,5
347,347,348,5,1,-4
348,348,349,1,3,2
349,349,350,3,1,-2
350,350,351,1,5,4
351,351,352,5,5,0
352,352,353,5,6,1
353,353,354,6,1,-5
354,354,355,1,8,7
355,355,356,8,5,-3
356,356,357,5,1,-4
357,357,358,1,7,6
358,358,359,7,9,2
359,359,360,9,4,-5
360,360,361,4,6,2
361,361,362,6,2,-4
362,362,363,2,2,0
363,363,364,2,5,3
364,364,365,5,0,-5
365,365,366,0,6,6
366,366,367,6,5,-1
367,367,368,5,6,1
368,368,369,6,3,-3
369,369,370,3,7,4
370,370,371,7,2,-5
371,371,372,2,0,-2
372,372,373,0,8,8
373,373,374,8,8,0
374,374,375,8,5,-3
375,375,376,5,4,-1
376,376,377,4,1,-3
377,377,378,1,1,0
378,378,379,1,4,3
379,379,380,4,0,-4
380,380,381,0,3,3
381,381,382,3,3,0
382,382,383,3,7,4
383,383,384,7,6,-1
384,384,385,6,1,-5
385,385,386,1,6,5
386,386,387,6,2,-4
387,387,388,2,1,-1
388,388,389,1,9,8
389,389,390,9,2,-7
390,390,391,2,8,6
391,391,392,8,6,-2
392,392,393,6,1,-5
393,393,394,1,9,8
394,394,395,9,5,-4
395,395,396,5,2,-3
396,396,397,2,5,3
397,397,398,5,4,-1
398,398,399,4,4,0
399,399,400,4,2,-2
400,400,401,2,8,6
401,401,402,8,3,-5
402,402,403,3,8,5
403,403,404,8,2,-6
404,404,405,2,4,2
405,405,406,4,5,1
406,406,407,5,0,-5
407,407,408,0,3,3
408,408,409,3,1,-2
409,409,410,1,7,6
410,410,411,7,7,0
411,411,412,7,5,-2
412,412,413,5,7,2
413,413,414,7,9,2
414,414,415,9,7,-2
415,415,416,7,1,-6
416,416,417,1,9,8
417,417,418,9,2,-7
418,418,419,2,1,-1
419,419,420,1,4,3
420,420,421,4,2,-2
421,421,422,2,9,7
422,422,423,9,2,-7
423,423,424,2,0,-2
424,424,425,0,4,4
425,425,426,4,9,5
426,426,427,9,1,-8
427,427,428,1,4,3
428,428,429,4,8,4
429,429,430,8,1,-7
430,430,431,1,8,7
431,431,432,8,4,-4
432,432,433,4,5,1
433,433,434,5,9,4
434,434,435,9,8,-1
435,435,436,8,8,0
436,436,437,8,3,-5
437,437,438,3,7,4
438,438,439,7,6,-1
439,439,440,6,0,-6
440,440,441,0,0,0
441,441,442,0,3,3
442,442,443,3,0,-3
443,443,444,0,2,2
444,444,445,2,6,4
445,445,446,6,6,0
446,446,447,6,4,-2
447,447,448,4,9,5
448,448,449,9,3,-6
449,449,450,3,3,0
450,450,451,3,3,0
451,451,452,3,2,-1
452,452,453,2,3,1
453,453,454,3,9,6
454,454,455,9,1,-8
455,455,456,1,2,1
456,456,457,2,6,4
457,457,458,6,8,2
458,458,459,8,0,-8
459,459,460,0,5,5
460,460,461,5,6,1
461,461,462,6,6,0
462,462,463,6,6,0
463,463,464,6,3,-3
464,464,465,3,8,5
465,465,466,8,8,0
466,466,467,8,2,-6
467,467,468,2,7,5
468,468,469,7,5,-2
469,469,470,5,8,3
470,470,471,8,9,1
471,471,472,9,6,-3
472,472,473,6,1,-5
473,473,474,1,8,7
474,474,475,8,4,-4
475,475,476,4,1,-3
476,476,477,1,2,1
477,477,478,2,5,3
478,478,479,5,9,4
479,479,480,9,1,-8
480,480,481,1,9,8
481,481,482,9,7,-2
482,482,483,7,5,-2
483,483,484,5,4,-1
484,484,485,4,0,-4
485,485,486,0,8,8
486,486,487,8,9,1
487,487,488,9,9,0
488,488,489,9,1,-8
489,489,490,1,0,-1
490,490,491,0,5,5
491,491,492,5,2,-3
492,492,493,2,3,1
493,493,494,3,7,4
494,494,495,7,8,1
495,495,496,8,9,1
496,496,497,9,4,-5
497,497,498,4,0,-4
498,498,499,0,6,6
499,499,500,6,3,-3
500,500,501,3,9,6
501,501,502,9,5,-4
502,502,503,5,2,-3
503,503,504,2,1,-1
504,504,505,1,3,2
505,505,506,3,1,-2
506,506,507,1,3,2
507,507,508,3,6,3
508,508,509,6,5,-1
509,509,510,5,7,2
510,510,511,7,4,-3
511,511,512,4,2,-2
512,512,513,2,2,0
513,513,514,2,6,4
514,514,515,6,3,-3
515,515,516,3,2,-1
516,516,517,2,6,4
517,517,518,6,5,-1
518,518,519,5,4,-1
519,519,520,4,8,4
520,520,521,8,9,1
521,521,522,9,7,-2
522,522,523,7,1,-6
523,523,524,1,3,2
524,524,525,3,0,-3
525,525,526,0,3,3
526,526,527,3,8,5
527,527,528,8,3,-5
528,528,529,3,1,-2
529,529,530,1,9,8
530,530,531,9,3,-6
531,531,532,3,4,1
532,532,533,4,4,0
533,533,534,4,6,2
534,534,535,6,4,-2
535,535,536,4,2,-2
536,536,537,2,1,-1
537,537,538,1,8,7
538,538,539,8,2,-6
539,539,540,2,5,3
540,540,541,5,4,-1
541,541,542,4,8,4
542,542,543,8,8,0
543,543,544,8,4,-4
544,544,545,4,0,-4
545,545,546,0,0,0
546,546,547,0,2,2
547,547,548,2,3,1
548,548,549,3,2,-1
549,549,550,2,7,5
550,550,551,7,7,0
551,551,552,7,0,-7
552,552,553,0,8,8
553,553,554,8,7,-1
554,554,555,7,4,-3
555,555,556,4,4,0
556,556,557,4,7,3
557,557,558,7,9,2
558,558,559,9,6,-3
559,559,560,6,9,3
560,560,561,9,0,-9
561,561,562,0,9,9
562,562,563,9,8,-1
563,563,564,8,0,-8
564,564,565,0,4,4
565,565,566,4,6,2
566,566,567,6,0,-6
567,567,568,0,6,6
568,568,569,6,3,-3
569,569,570,3,5,2
570,570,571,5,4,-1
571,571,572,4,8,4
572,572,573,8,3,-5
573,573,574,3,3,0
574,574,575,3,9,6
575,575,576,9,3,-6
576,576,577,3,3,0
577,577,578,3,3,0
578,578,579,3,7,4
579,579,580,7,8,1
580,580,581,8,0,-8
581,581,582,0,8,8
582,582,583,8,2,-6
583,583,584,2,1,-1
584,584,585,1,7,6
585,585,586,7,0,-7
586,586,587,0,6,6
587,587,588,6,5,-1
588,588,589,5,4,-1
589,589,590,4,3,-1
590,590,591,3,8,5
591,591,592,8,0,-8
592,592,593,0,9,9
593,593,594,9,6,-3
594,594,595,6,3,-3
595,595,596,3,8,5
596,596,597,8,0,-8
597,597,598,0,9,9
598,598,599,9,9,0
599,599,600,9,6,-3
600,600,601,6,8,2
601,601,602,8,6,-2
602,602,603,6,8,2
603,603,604,8,5,-3
604,604,605,5,7,2
605,605,606,7,8,1
606,606,607,8,6,-2
607,607,608,6,0,-6
608,608,609,0,2,2
609,609,610,2,4,2
610,610,611,4,0,-4
611,611,612,0,2,2
612,612,613,2,2,0
613,613,614,2,3,1
614,614,615,3,1,-2
615,615,616,1,9,8
616,616,617,9,7,-2
617,617,618,7,5,-2
618,618,619,5,1,-4
619,619,620,1,0,-1
620,620,621,0,8,8
621,621,622,8,4,-4
622,622,623,4,6,2
623,623,624,6,2,-4
624,624,625,2,6,4
625,625,626,6,7,1
626,626,627,7,9,2
627,627,628,9,3,-6
628,628,629,3,2,-1
629,629,630,2,9,7
630,630,631,9,8,-1
631,631,632,8,2,-6
632,632,633,2,2,0
633,633,634,2,9,7
634,634,635,9,2,-7
635,635,636,2,7,5
636,636,637,7,3,-4
637,637,638,3,5,2
638,638,639,5,9,4
639,639,640,9,1,-8
640,640,641,1,8,7
641,641,642,8,0,-8
642,642,643,0,2,2
643,643,644,2,0,-2
644,644,645,0,5,5
645,645,646,5,2,-3
646,646,647,2,1,-1
647,647,648,1,3,2
648,648,649,3,7,4
649,649,650,7,6,-1
650,650,651,6,7,1
651,651,652,7,1,-6
652,652,653,1,2,1
653,653,654,2,5,3
654,654,655,5,8,3
655,655,656,8,0,-8
656,656,657,0,3,3
657,657,658,3,7,4
658,658,659,7,2,-5
659,659,660,2,4,2
660,660,661,4,0,-4
661,661,662,0,9,9
662,662,663,9,1,-8
663,663,664,1,8,7
664,664,665,8,6,-2
665,665,666,6,7,1
666,666,667,7,7,0
667,667,668,7,4,-3
668,668,669,4,3,-1
669,669,670,3,4,1
670,670,671,4,9,5
671,671,672,9,1,-8
672,672,673,1,9,8
673,673,674,9,5,-4
674,674,675,5,1,-4
675,675,676,1,7,6
676,676,677,7,3,-4
677,677,678,3,9,6
678,678,679,9,7,-2
679,679,680,7,6,-1
680,680,681,6,9,3
681,681,682,9,1,-8
682,682,683,1,3,2
683,683,684,3,7,4
684,684,685,7,8,1
685,685,686,8,3,-5
686,686,687,3,3,0
687,687,688,3,6,3
688,688,689,6,7,1
689,689,690,7,2,-5
690,690,691,2,8,6
691,691,692,8,5,-3
692,692,693,5,8,3
693,693,694,8,5,-3
694,694,695,5,1,-4
695,695,696,1,1,0
696,696,697,1,4,3
697,697,698,4,4,0
698,698,699,4,3,-1
699,699,700,3,1,-2
700,700,701,1,0,-1
701,701,702,0,7,7
702,702,703,7,7,0
703,703,704,7,0,-7
704,704,705,0,7,7
705,705,706,7,9,2
706,706,707,9,4,-5
707,707,708,4,4,0
708,708,709,4,8,4
709,709,710,8,5,-3
710,710,711,5,5,0
711,711,712,5,4,-1
712,712,713,4,0,-4
713,713,714,0,8,8
714,714,715,8,2,-6
715,715,716,2,1,-1
716,716,717,1,0,-1
717,717,718,0,8,8
718,718,719,8,4,-4
719,719,720,4,5,1
720,720,721,5,0,-5
721,721,722,0,4,4
722,722,723,4,0,-4
723,723,724,0,6,6
724,724,725,6,1,-5
725,725,726,1,7,6
726,726,727,7,3,-4
727,727,728,3,2,-1
728,728,729,2,6,4
729,729,730,6,7,1
730,730,731,7,2,-5
731,731,732,2,6,4
732,732,733,6,9,3
733,733,734,9,3,-6
734,734,735,3,1,-2
735,735,736,1,4,3
736,736,737,4,6,2
737,737,738,6,2,-4
738,738,739,2,5,3
739,739,740,5,4,-1
740,740,741,4,2,-2
741,741,742,2,0,-2
742,742,743,0,6,6
743,743,744,6,2,-4
744,744,745,2,1,-1
745,745,746,1,7,6
746,746,747,7,3,-4
747,747,748,3,4,1
748,748,749,4,1,-3
749,749,750,1,0,-1
750,750,751,0,5,5
751,751,752,5,4,-1
752,752,753,4,3,-1
753,753,754,3,1,-2
754,754,755,1,1,0
755,755,756,1,7,6
756,756,757,7,4,-3
757,757,758,4,9,5
758,758,759,9,9,0
759,759,760,9,4,-5
760,760,761,4,8,4
761,761,762,8,4,-4
762,762,763,4,0,-4
763,763,764,0,2,2
764,764,765,2,4,2
765,765,766,4,5,1
766,766,767,5,1,-4
767,767,768,1,1,0
768,768,769,1,6,5
769,769,770,6,4,-2
770,770,771,4,7,3
771,771,772,7,1,-6
772,772,773,1,9,8
773,773,774,9,4,-5
774,774,775,4,2,-2
775,775,776,2,4,2
776,776,777,4,1,-3
777,777,778,1,5,4
778,778,779,5,5,0
779,779,780,5,3,-2
780,780,781,3,8,5
781,781,782,8,3,-5
782,782,783,3,1,-2
783,783,784,1,4,3
784,784,785,4,5,1
785,785,786,5,6,1
786,786,787,6,8,2
787,787,788,8,9,1
788,788,789,9,4,-5
789,789,790,4,1,-3
790,790,791,1,5,4
791,791,792,5,3,-2
792,792,793,3,8,5
793,793,794,8,0,-8
794,794,795,0,3,3
795,795,796,3,2,-1
796,796,797,2,5,3
797,797,798,5,1,-4
798,798,799,1,2,1
799,799,800,2,8,6
800,800,801,8,3,-5
801,801,802,3,4,1
802,802,803,4,4,0
803,803,804,4,0,-4
804,804,805,0,8,8
805,805,806,8,8,0
806,806,807,8,3,-5
807,807,808,3,3,0
808,808,809,3,1,-2
809,809,810,1,7,6
810,810,811,7,3,-4
811,811,812,3,5,2
812,812,813,5,9,4
813,813,814,9,6,-3
814,814,815,6,3,-3
815,815,816,3,2,-1
816,816,817,2,6,4
817,817,818,6,1,-5
818,818,819,1,3,2
819,819,820,3,6,3
820,820,821,6,0,-6
821,821,822,0,7,7
822,822,823,7,2,-5
823,823,824,2,1,-1
824,824,825,1,7,6
825,825,826,7,1,-6
826,826,827,1,4,3
827,827,828,4,2,-2
828,828,829,2,4,2
829,829,830,4,2,-2
830,830,831,2,1,-1
831,831,832,1,7,6
832,832,833,7,9,2
833,833,834,9,6,-3
834,834,835,6,1,-5
835,835,836,1,1,0
836,836,837,1,2,1
837,837,838,2,4,2
838,838,839,4,8,4
839,839,840,8,1,-7
840,840,841,1,7,6
841,841,842,7,7,0
842,842,843,7,4,-3
843,843,844,4,8,4
844,844,845,8,0,-8
845,845,846,0,7,7
846,846,847,7,3,-4
847,847,848,3,1,-2
848,848,849,1,3,2
849,849,850,3,1,-2
850,850,851,1,0,-1
851,851,852,0,7,7
852,852,853,7,7,0
853,853,854,7,0,-7
854,854,855,0,3,3
855,855,856,3,5,2
856,856,857,5,5,0
857,857,858,5,2,-3
858,858,859,2,7,5
859,859,860,7,6,-1
860,860,861,6,6,0
861,861,862,6,9,3
862,862,863,9,2,-7
863,863,864,2,8,6
864,864,865,8,3,-5
865,865,866,3,5,2
866,866,867,5,2,-3
867,867,868,2,2,0
868,868,869,2,5,3
869,869,870,5,6,1
870,870,871,6,0,-6
871,871,872,0,8,8
872,872,873,8,2,-6
873,873,874,2,9,7
874,874,875,9,2,-7
875,875,876,2,8,6
876,876,877,8,8,0
877,877,878,8,8,0
878,878,879,8,8,0
879,879,880,8,7,-1
880,880,881,7,4,-3
881,881,882,4,9,5
882,882,883,9,3,-6
883,883,884,3,0,-3
884,884,885,0,6,6
885,885,886,6,6,0
886,886,887,6,3,-3
887,887,888,3,2,-1
888,888,889,2,1,-1
889,889,890,1,3,2
890,890,891,3,2,-1
891,891,892,2,2,0
892,892,893,2,9,7
893,893,894,9,3,-6
894,894,895,3,0,-3
895,895,896,0,0,0
896,896,897,0,5,5
897,897,898,5,7,2
898,898,899,7,8,1
899,899,900,8,1,-7
900,900,901,1,4,3
901,901,902,4,4,0
902,902,903,4,6,2
903,903,904,6,0,-6
904,904,905,0,2,2
905,905,906,2,9,7
906,906,907,9,1,-8
907,907,908,1,4,3
908,908,909,4,7,3
909,909,910,7,4,-3
910,910,911,4,7,3
911,911,912,7,3,-4
912,912,913,3,9,6
913,913,914,9,8,-1
914,914,915,8,8,0
915,915,916,8,4,-4
916,916,917,4,7,3
917,917,918,7,1,-6
918,918,919,1,2,1
919,919,920,2,1,-1
920,920,921,1,2,1
921,921,922,2,2,0
922,922,923,2,3,1
923,923,924,3,2,-1
924,924,925,2,3,1
925,925,926,3,2,-1
926,926,927,2,3,1
927,927,928,3,9,6
928,928,929,9,1,-8
929,929,930,1,7,6
930,930,931,7,4,-3
931,931,932,4,0,-4
932,932,933,0,3,3
933,933,934,3,5,2
934,934,935,5,5,0
935,935,936,5,8,3
936,936,937,8,6,-2
937,937,938,6,3,-3
938,938,939,3,2,-1
939,939,940,2,6,4
940,940,941,6,7,1
941,941,942,7,6,-1
942,942,943,6,6,0
943,943,944,6,3,-3
944,944,945,3,2,-1
945,945,946,2,7,5
946,946,947,7,8,1
947,947,948,8,1,-7
948,948,949,1,1,0
949,949,950,1,7,6
950,950,951,7,5,-2
951,951,952,5,6,1
952,952,953,6,4,-2
953,953,954,4,9,5
954,954,955,9,5,-4
955,955,956,5,1,-4
956,956,957,1,3,2
957,957,958,3,3,0
958,958,959,3,4,1
959,959,960,4,7,3
960,960,961,7,8,1
961,961,962,8,9,1
962,962,963,9,1,-8
963,963,964,1,1,0
964,964,965,1,6,5
965,965,966,6,9,3
966,966,967,9,1,-8
967,967,968,1,4,3
968,968,969,4,4,0
969,969,970,4,5,1
970,970,971,5,4,-1
971,971,972,4,0,-4
972,972,973,0,6,6
973,973,974,6,2,-4
974,974,975,2,2,0
975,975,976,2,3,1
976,976,977,3,1,-2
977,977,978,1,5,4
978,978,979,5,1,-4
979,979,980,1,2,1
980,980,981,2,0,-2
981,981,982,0,3,3
982,982,983,3,8,5
983,983,984,8,1,-7
984,984,985,1,2,1
985,985,986,2,6,4
986,986,987,6,7,1
987,987,988,7,1,-6
988,988,989,1,6,5
989,989,990,6,2,-4
990,990,991,2,3,1
991,991,992,3,9,6
992,992,993,9,0,-9
993,993,994,0,1,1
994,994,995,1,2,1
995,995,996,2,2,0
996,996,997,2,0,-2
997,997,998,0,8,8
998,998,999,8,9,1
999,999,1000,9,9,0
1000,1000,1001,9,0,-9
1001,1001,1002,0,2,2
1002,1002,1003,2,5,3
1003,1003,1004,5,1,-4
1004,1004,1005,1,9,8
1005,1005,1006,9,7,-2
1006,1006,1007,7,8,1
1007,1007,1008,8,1,-7
1008,1008,1009,1,0,-1
1009,1009,1010,0,4,4
1010,1010,1011,4,1,-3
1011,1011,1012,1,7,6
1012,1012,1013,7,9,2
1013,1013,1014,9,6,-3
1014,1014,1015,6,4,-2
1015,1015,1016,4,2,-2
1016,1016,1017,2,6,4
1017,1017,1018,6,8,2
1018,1018,1019,8,1,-7
1019,1019,1020,1,3,2
1020,1020,1021,3,7,4
1021,1021,1022,7,5,-2
1022,1022,1023,5,4,-1
1023,1023,1024,4,4,0
1024,1024,1025,4,1,-3
1025,1025,1026,1,8,7
1026,1026,1027,8,1,-7
1027,1027,1028,1,3,2
1028,1028,1029,3,8,5
1029,1029,1030,8,1,-7
1030,1030,1031,1,2,1
1031,1031,1032,2,5,3
1032,1032,1033,5,8,3
1033,1033,1034,8,0,-8
1034,1034,1035,0,6,6
1035,1035,1036,6,2,-4
1036,1036,1037,2,1,-1
1037,1037,1038,1,1,0
1038,1038,1039,1,7,6
1039,1039,1040,7,1,-6
1040,1040,1041,1,5,4
1041,1041,1042,5,3,-2
1042,1042,1043,3,4,1
1043,1043,1044,4,6,2
1044,1044,1045,6,9,3
1045,1045,1046,9,5,-4
1046,1046,1047,5,0,-5
1047,1047,1048,0,9,9
1048,1048,1049,9,2,-7
1049,1049,1050,2,2,0
1050,1050,1051,2,4,2
1051,1051,1052,4,8,4
1052,1052,1053,8,2,-6
1053,1053,1054,2,1,-1
1054,1054,1055,1,7,6
1055,1055,1056,7,2,-5
1056,1056,1057,2,4,2
1057,1057,1058,4,9,5
1058,1058,1059,9,4,-5
1059,1059,1060,4,4,0
1060,1060,1061,4,0,-4
1061,1061,1062,0,3,3
1062,1062,1063,3,9,6
1063,1063,1064,9,2,-7
1064,1064,1065,2,2,0
1065,1065,1066,2,3,1
1066,1066,1067,3,3,0
1067,1067,1068,3,8,5
1068,1068,1069,8,3,-5
1069,1069,1070,3,5,2
1070,1070,1071,5,7,2
1071,1071,1072,7,3,-4
1072,1072,1073,3,5,2
1073,1073,1074,5,8,3
1074,1074,1075,8,1,-7
1075,1075,1076,1,2,1
1076,1076,1077,2,4,2
1077,1077,1078,4,4,0
1078,1078,1079,4,6,2
1079,1079,1080,6,4,-2
1080,1080,1081,4,9,5
1081,1081,1082,9,5,-4
1082,1082,1083,5,1,-4
1083,1083,1084,1,0,-1
1084,1084,1085,0,6,6
1085,1085,1086,6,9,3
1086,1086,1087,9,5,-4
1087,1087,1088,5,9,4
1088,1088,1089,9,5,-4
1089,1089,1090,5,9,4
1090,1090,1091,9,7,-2
1091,1091,1092,7,3,-4
1092,1092,1093,3,8,5
1093,1093,1094,8,0,-8
1094,1094,1095,0,3,3
1095,1095,1096,3,7,4
1096,1096,1097,7,1,-6
1097,1097,1098,1,3,2
1098,1098,1099,3,6,3
1099,1099,1100,6,7,1
1100,1100,1101,7,8,1
1101,1101,1102,8,5,-3
1102,1102,1103,5,9,4
1103,1103,1104,9,7,-2
1104,1104,1105,7,9,2
1105,1105,1106,9,6,-3
1106,1106,1107,6,9,3
1107,1107,1108,9,6,-3
1108,1108,1109,6,3,-3
1109,1109,1110,3,7,4
1110,1110,1111,7,4,-3
1111,1111,1112,4,4,0
1112,1112,1113,4,5,1
1113,1113,1114,5,3,-2
1114,1114,1115,3,5,2
1115,1115,1116,5,4,-1
1116,1116,1117,4,7,3
1117,1117,1118,7,8,1
1118,1118,1119,8,7,-1
1119,1119,1120,7,8,1
1120,1120,1121,8,0,-8
1121,1121,1122,0,7,7
1122,1122,1123,7,6,-1
1123,1123,1124,6,8,2
1124,1124,1125,8,8,0
1125,1125,1126,8,7,-1
1126,1126,1127,7,3,-4
1127,1127,1128,3,3,0
1128,1128,1129,3,1,-2
1129,1129,1130,1,9,8
1130,1130,1131,9,5,-4
1131,1131,1132,5,2,-3
1132,1132,1133,2,7,5
1133,1133,1134,7,3,-4
1134,1134,1135,3,5,2
1135,1135,1136,5,1,-4
1136,1136,1137,1,1,0
1137,1137,1138,1,2,1
1138,1138,1139,2,1,-1
1139,1139,1140,1,4,3
1140,1140,1141,4,7,3
1141,1141,1142,7,4,-3
1142,1142,1143,4,7,3
1143,1143,1144,7,5,-2
1144,1144,1145,5,4,-1
1145,1145,1146,4,5,1
1146,1146,1147,5,4,-1
1147,1147,1148,4,0,-4
1148,1148,1149,0,8,8
1149,1149,1150,8,3,-5
1150,1150,1151,3,6,3
1151,1151,1152,6,9,3
1152,1152,1153,9,6,-3
1153,1153,1154,6,0,-6
1154,1154,1155,0,2,2
1155,1155,1156,2,7,5
1156,1156,1157,7,4,-3
1157,1157,1158,4,4,0
1158,1158,1159,4,4,0
1159,1159,1160,4,4,0
1160,1160,1161,4,6,2
1161,1161,1162,6,6,0
1162,1162,1163,6,4,-2
1163,1163,1164,4,7,3
1164,1164,1165,7,9,2
1165,1165,1166,9,3,-6
1166,1166,1167,3,4,1
1167,1167,1168,4,5,1
1168,1168,1169,5,5,0
1169,1169,1170,5,8,3
1170,1170,1171,8,7,-1
1171,1171,1172,7,3,-4
1172,1172,1173,3,7,4
1173,1173,1174,7,2,-5
1174,1174,1175,2,7,5
1175,1175,1176,7,0,-7
1176,1176,1177,0,2,2
1177,1177,1178,2,4,2
1178,1178,1179,4,1,-3
1179,1179,1180,1,1,0
1180,1180,1181,1,6,5
1181,1181,1182,6,6,0
1182,1182,1183,6,9,3
1183,1183,1184,9,2,-7
1184,1184,1185,2,8,6
1185,1185,1186,8,7,-1
1186,1186,1187,7,2,-5
1187,1187,1188,2,0,-2
1188,1188,1189,0,1,1
1189,1189,1190,1,5,4
1190,1190,1191,5,0,-5
1191,1191,1192,0,9,9
1192,1192,1193,9,1,-8
1193,1193,1194,1,7,6
1194,1194,1195,7,0,-7
1195,1195,1196,0,6,6
1196,1196,1197,6,0,-6
1197,1197,1198,0,8,8
1198,1198,1199,8,6,-2
1199,1199,1200,6,8,2
1200,1200,1201,8,1,-7
1201,1201,1202,1,8,7
1202,1202,1203,8,0,-8
1203,1203,1204,0,3,3
1204,1204,1205,3,3,0
1205,1205,1206,3,7,4
1206,1206,1207,7,2,-5
1207,1207,1208,2,3,1
1208,1208,1209,3,6,3
1209,1209,1210,6,2,-4
1210,1210,1211,2,1,-1
1211,1211,1212,1,6,5
1212,1212,1213,6,1,-5
1213,1213,1214,1,1,0
1214,1214,1215,1,3,2
1215,1215,1216,3,7,4
1216,1216,1217,7,9,2
1217,1217,1218,9,0,-9
1218,1218,1219,0,8,8
1219,1219,1220,8,0,-8
1220,1220,1221,0,5,5
1221,1221,1222,5,4,-1
1222,1222,1223,4,0,-4
1223,1223,1224,0,2,2
1224,1224,1225,2,8,6
1225,1225,1226,8,7,-1
1226,1226,1227,7,2,-5
1227,1227,1228,2,9,7
1228,1228,1229,9,8,-1
1229,1229,1230,8,4,-4
1230,1230,1231,4,0,-4
1231,1231,1232,0,9,9
1232,1232,1233,9,5,-4
1233,1233,1234,5,8,3
1234,1234,1235,8,5,-3
1235,1235,1236,5,1,-4
1236,1236,1237,1,2,1
1237,1237,1238,2,1,-1
1238,1238,1239,1,3,2
1239,1239,1240,3,1,-2
1240,1240,1241,1,7,6
1241,1241,1242,7,4,-3
1242,1242,1243,4,5,1
1243,1243,1244,5,7,2
1244,1244,1245,7,2,-5
1245,1245,1246,2,0,-2
1246,1246,1247,0,9,9
1247,1247,1248,9,8,-1
1248,1248,1249,8,8,0
1249,1249,1250,8,6,-2
1250,1250,1251,6,2,-4
1251,1251,1252,2,5,3
1252,1252,1253,5,4,-1
1253,1253,1254,4,1,-3
1254,1254,1255,1,9,8
1255,1255,1256,9,2,-7
1256,1256,1257,2,1,-1
1257,1257,1258,1,5,4
1258,1258,1259,5,8,3
1259,1259,1260,8,7,-1
1260,1260,1261,7,0,-7
1261,1261,1262,0,2,2
1262,1262,1263,2,4,2
1263,1263,1264,4,4,0
1264,1264,1265,4,3,-1
1265,1265,1266,3,6,3
1266,1266,1267,6,8,2
1267,1267,1268,8,8,0
1268,1268,1269,8,2,-6
1269,1269,1270,2,4,2
1270,1270,1271,4,0,-4
1271,1271,1272,0,5,5
1272,1272,1273,5,0,-5
1273,1273,1274,0,4,4
1274,1274,1275,4,4,0
1275,1275,1276,4,7,3
1276,1276,1277,7,9,2
1277,1277,1278,9,3,-6
1278,1278,1279,3,4,1
1279,1279,1280,4,1,-3
1280,1280,1281,1,5,4
1281,1281,1282,5,9,4
1282,1282,1283,9,7,-2
1283,1283,1284,7,3,-4
1284,1284,1285,3,5,2
1285,1285,1286,5,8,3
1286,1286,1287,8,8,0
1287,1287,1288,8,0,-8
1288,1288,1289,0,5,5
1289,1289,1290,5,3,-2
1290,1290,1291,3,3,0
1291,1291,1292,3,6,3
1292,1292,1293,6,6,0
1293,1293,1294,6,0,-6
1294,1294,1295,0,1,1
1295,1295,1296,1,6,5
1296,1296,1297,6,0,-6
1297,1297,1298,0,3,3
1298,1298,1299,3,5,2
1299,1299,1300,5,4,-1
1300,1300,1301,4,4,0
1301,1301,1302,4,1,-3
1302,1302,1303,1,2,1
1303,1303,1304,2,9,7
1304,1304,1305,9,1,-8
1305,1305,1306,1,4,3
1306,1306,1307,4,6,2
1307,1307,1308,6,9,3
1308,1308,1309,9,9,0
1309,1309,1310,9,3,-6
1310,1310,1311,3,9,6
1311,1311,1312,9,8,-1
1312,1312,1313,8,4,-4
1313,1313,1314,4,4,0
1314,1314,1315,4,3,-1
1315,1315,1316,3,1,-2
1316,1316,1317,1,3,2
1317,1317,1318,3,1,-2
1318,1318,1319,1,8,7
1319,1319,1320,8,8,0
1320,1320,1321,8,7,-1
1321,1321,1322,7,9,2
1322,1322,1323,9,4,-5
1323,1323,1324,4,8,4
1324,1324,1325,8,8,0
1325,1325,1326,8,7,-1
1326,1326,1327,7,9,2
1327,1327,1328,9,7,-2
1328,1328,1329,7,1,-6
1329,1329,1330,1,4,3
1330,1330,1331,4,5,1
1331,1331,1332,5,6,1
1332,1332,1333,6,0,-6
1333,1333,1334,0,5,5
1334,1334,1335,5,2,-3
1335,1335,1336,2,2,0
1336,1336,1337,2,2,0
1337,1337,1338,2,1,-1
1338,1338,1339,1,5,4
1339,1339,1340,5,5,0
1340,1340,1341,5,2,-3
1341,1341,1342,2,4,2
1342,1342,1343,4,9,5
1343,1343,1344,9,6,-3
1344,1344,1345,6,2,-4
1345,1345,1346,2,7,5
1346,1346,1347,7,7,0
1347,1347,1348,7,2,-5
1348,1348,1349,2,2,0
1349,1349,1350,2,1,-1
1350,1350,1351,1,1,0
1351,1351,1352,1,2,1
1352,1352,1353,2,8,6
1353,1353,1354,8,3,-5
1354,1354,1355,3,7,4
1355,1355,1356,7,2,-5
1356,1356,1357,2,4,2
1357,1357,1358,4,1,-3
1358,1358,1359,1,7,6
1359,1359,1360,7,1,-6
1360,1360,1361,1,7,6
1361,1361,1362,7,6,-1
1362,1362,1363,6,7,1
1363,1363,1364,7,8,1
1364,1364,1365,8,2,-6
1365,1365,1366,2,7,5
1366,1366,1367,7,3,-4
1367,1367,1368,3,1,-2
1368,1368,1369,1,7,6
1369,1369,1370,7,5,-2
1370,1370,1371,5,8,3
1371,1371,1372,8,2,-6
1372,1372,1373,2,6,4
1373,1373,1374,6,2,-4
1374,1374,1375,2,2,0
1375,1375,1376,2,5,3
1376,1376,1377,5,6,1
1377,1377,1378,6,5,-1
1378,1378,1379,5,0,-5
1379,1379,1380,0,9,9
1380,1380,1381,9,2,-7
1381,1381,1382,2,4,2
1382,1382,1383,4,3,-1
1383,1383,1384,3,3,0
1384,1384,1385,3,9,6
1385,1385,1386,9,7,-2
1386,1386,1387,7,6,-1
1387,1387,1388,6,6,0
1388,1388,1389,6,8,2
1389,1389,1390,8,0,-8
1390,1390,1391,0,4,4
1391,1391,1392,4,1,-3
1392,1392,1393,1,5,4
1393,1393,1394,5,8,3
1394,1394,1395,8,2,-6
1395,1395,1396,2,9,7
1396,1396,1397,9,1,-8
1397,1397,1398,1,8,7
1398,1398,1399,8,0,-8
1399,1399,1400,0,6,6
1400,1400,1401,6,7,1
1401,1401,1402,7,2,-5
1402,1402,1403,2,1,-1
1403,1403,1404,1,0,-1
1404,1404,1405,0,5,5
1405,1405,1406,5,5,0
1406,1406,1407,5,2,-3
1407,1407,1408,2,0,-2
1408,1408,1409,0,2,2
1409,1409,1410,2,2,0
1410,1410,1411,2,0,-2
1411,1411,1412,0,2,2
1412,1412,1413,2,4,2
1413,1413,1414,4,9,5
1414,1414,1415,9,8,-1
1415,1415,1416,8,0,-8
1416,1416,1417,0,9,9
1417,1417,1418,9,9,0
1418,1418,1419,9,4,-5
1419,1419,1420,4,6,2
1420,1420,1421,6,5,-1
1421,1421,1422,5,4,-1
1422,1422,1423,4,9,5
1423,1423,1424,9,1,-8
1424,1424,1425,1,8,7
1425,1425,1426,8,3,-5
1426,1426,1427,3,4,1
1427,1427,1428,4,9,5
1428,1428,1429,9,9,0
1429,1429,1430,9,1,-8
1430,1430,1431,1,2,1
1431,1431,1432,2,2,0
1432,1432,1433,2,8,6
1433,1433,1434,8,1,-7
1434,1434,1435,1,9,8
1435,1435,1436,9,6,-3
1436,1436,1437,6,4,-2
1437,1437,1438,4,0,-4
1438,1438,1439,0,9,9
1439,1439,1440,9,4,-5
1440,1440,1441,4,8,4
1441,1441,1442,8,3,-5
1442,1442,1443,3,8,5
1443,1443,1444,8,6,-2
1444,1444,1445,6,0,-6
1445,1445,1446,0,2,2
1446,1446,1447,2,5,3
1447,1447,1448,5,1,-4
1448,1448,1449,1,9,8
1449,1449,1450,9,6,-3
1450,1450,1451,6,2,-4
1451,1451,1452,2,9,7
1452,1452,1453,9,4,-5
1453,1453,1454,4,0,-4
1454,1454,1455,0,9,9
1455,1455,1456,9,6,-3
1456,1456,1457,6,0,-6
1457,1457,1458,0,6,6
1458,1458,1459,6,2,-4
1459,1459,1460,2,5,3
1460,1460,1461,5,4,-1
1461,1461,1462,4,2,-2
1462,1462,1463,2,3,1
1463,1463,1464,3,8,5
1464,1464,1465,8,4,-4
1465,1465,1466,4,5,1
1466,1466,1467,5,5,0
1467,1467,1468,5,0,-5
1468,1468,1469,0,3,3
1469,1469,1470,3,8,5
1470,1470,1471,8,5,-3
1471,1471,1472,5,3,-2
1472,1472,1473,3,5,2
1473,1473,1474,5,8,3
1474,1474,1475,8,6,-2
1475,1475,1476,6,5,-1
1476,1476,1477,5,7,2
1477,1477,1478,7,6,-1
1478,1478,1479,6,3,-3
1479,1479,1480,3,3,0
1480,1480,1481,3,9,6
1481,1481,1482,9,6,-3
1482,1482,1483,6,1,-5
1483,1483,1484,1,1,0
1484,1484,1485,1,2,1
1485,1485,1486,2,9,7
1486,1486,1487,9,0,-9
1487,1487,1488,0,4,4
1488,1488,1489,4,3,-1
1489,1489,1490,3,3,0
1490,1490,1491,3,6,3
1491,1491,1492,6,9,3
1492,1492,1493,9,5,-4
1493,1493,1494,5,7,2
1494,1494,1495,7,3,-4
1495,1495,1496,3,7,4
1496,1496,1497,7,7,0
1497,1497,1498,7,7,0
1498,1498,1499,7,8,1
1499,1499,1500,8,7,-1
1500,1500,1501,7,9,2
1501,1501,1502,9,8,-1
1502,1502,1503,8,3,-5
1503,1503,1504,3,0,-3
1504,1504,1505,0,7,7
1505,1505,1506,7,2,-5
1506,1506,1507,2,7,5
1507,1507,1508,7,9,2
1508,1508,1509,9,4,-5
1509,1509,1510,4,5,1
1510,1510,1511,5,4,-1
1511,1511,1512,4,9,5
1512,1512,1513,9,3,-6
1513,1513,1514,3,2,-1
1514,1514,1515,2,1,-1
1515,1515,1516,1,4,3
1516,1516,1517,4,0,-4
1517,1517,1518,0,2,2
1518,1518,1519,2,3,1
1519,1519,1520,3,7,4
1520,1520,1521,7,5,-2
1521,1521,1522,5,7,2
1522,1522,1523,7,8,1
1523,1523,1524,8,8,0
1524,1524,1525,8,5,-3
1525,1525,1526,5,0,-5
1526,1526,1527,0,1,1
1527,1527,1528,1,1,0
1528,1528,1529,1,4,3
1529,1529,1530,4,8,4
1530,1530,1531,8,3,-5
1531,1531,1532,3,9,6
1532,1532,1533,9,0,-9
1533,1533,1534,0,0,0
1534,1534,1535,0,0,0
1535,1535,1536,0,6,6
1536,1536,1537,6,6,0
1537,1537,1538,6,2,-4
1538,1538,1539,2,3,1
1539,1539,1540,3,7,4
1540,1540,1541,7,8,1
1541,1541,1542,8,4,-4
1542,1542,1543,4,7,3
1543,1543,1544,7,7,0
1544,1544,1545,7,9,2
1545,1545,1546,9,2,-7
1546,1546,1547,2,4,2
1547,1547,1548,4,1,-3
1548,1548,1549,1,4,3
1549,1549,1550,4,5,1
1550,1550,1551,5,2,-3
1551,1551,1552,2,4,2
1552,1552,1553,4,9,5
1553,1553,1554,9,9,0
1554,1554,1555,9,1,-8
1555,1555,1556,1,8,7
1556,1556,1557,8,4,-4
1557,1557,1558,4,0,-4
1558,1558,1559,0,9,9
1559,1559,1560,9,8,-1
1560,1560,1561,8,4,-4
1561,1561,1562,4,8,4
1562,1562,1563,8,7,-1
1563,1563,1564,7,7,0
1564,1564,1565,7,0,-7
1565,1565,1566,0,7,7
1566,1566,1567,7,8,1
1567,1567,1568,8,8,0
1568,1568,1569,8,6,-2
1569,1569,1570,6,0,-6
1570,1570,1571,0,4,4
1571,1571,1572,4,8,4
1572,1572,1573,8,8,0
1573,1573,1574,8,2,-6
1574,1574,1575,2,4,2
1575,1575,1576,4,7,3
1576,1576,1577,7,6,-1
1577,1577,1578,6,6,0
1578,1578,1579,6,6,0
1579,1579,1580,6,4,-2
1580,1580,1581,4,7,3
1581,1581,1582,7,1,-6
1582,1582,1583,1,8,7
1583,1583,1584,8,8,0
1584,1584,1585,8,2,-6
1585,1585,1586,2,3,1
1586,1586,1587,3,6,3
1587,1587,1588,6,3,-3
1588,1588,1589,3,0,-3
1589,1589,1590,0,0,0
1590,1590,1591,0,3,3
1591,1591,1592,3,7,4
1592,1592,1593,7,6,-1
1593,1593,1594,6,9,3
1594,1594,1595,9,7,-2
1595,1595,1596,7,9,2
1596,1596,1597,9,9,0
1597,1597,1598,9,5,-4
1598,1598,1599,5,4,-1
1599,1599,1600,4,3,-1
1600,1600,1601,3,3,0
1601,1601,1602,3,6,3
1602,1602,1603,6,1,-5
1603,1603,1604,1,2,1
1604,1604,1605,2,3,1
1605,1605,1606,3,7,4
1606,1606,1607,7,3,-4
1607,1607,1608,3,3,0
1608,1608,1609,3,2,-1
1609,1609,1610,2,0,-2
1610,1610,1611,0,3,3
1611,1611,1612,3,3,0
1612,1612,1613,3,8,5
1613,1613,1614,8,4,-4
1614,1614,1615,4,3,-1
1615,1615,1616,3,6,3
1616,1616,1617,6,3,-3
1617,1617,1618,3,5,2
1618,1618,1619,5,0,-5
1619,1619,1620,0,2,2
1620,1620,1621,2,0,-2
1621,1621,1622,0,9,9
1622,1622,1623,9,0,-9
1623,1623,1624,0,7,7
1624,1624,1625,7,4,-3
1625,1625,1626,4,6,2
1626,1626,1627,6,9,3
1627,1627,1628,9,3,-6
1628,1628,1629,3,5,2
1629,1629,1630,5,1,-4
1630,1630,1631,1,9,8
1631,1631,1632,9,6,-3
1632,1632,1633,6,1,-5
1633,1633,1634,1,4,3
1634,1634,1635,4,5,1
1635,1635,1636,5,4,-1
1636,1636,1637,4,5,1
1637,1637,1638,5,0,-5
1638,1638,1639,0,5,5
1639,1639,1640,5,9,4
1640,1640,1641,9,5,-4
1641,1641,1642,5,2,-3
1642,1642,1643,2,1,-1
1643,1643,1644,1,2,1
1644,1644,1645,2,9,7
1645,1645,1646,9,1,-8
1646,1646,1647,1,9,8
1647,1647,1648,9,9,0
1648,1648,1649,9,4,-5
1649,1649,1650,4,0,-4
1650,1650,1651,0,8,8
1651,1651,1652,8,4,-4
1652,1652,1653,4,5,1
1653,1653,1654,5,2,-3
1654,1654,1655,2,9,7
1655,1655,1656,9,2,-7
1656,1656,1657,2,1,-1
1657,1657,1658,1,2,1
1658,1658,1659,2,1,-1
1659,1659,1660,1,7,6
1660,1660,1661,7,3,-4
1661,1661,1662,3,6,3
1662,1662,1663,6,8,2
1663,1663,1664,8,8,0
1664,1664,1665,8,4,-4
1665,1665,1666,4,9,5
1666,1666,1667,9,1,-8
1667,1667,1668,1,9,8
1668,1668,1669,9,8,-1
1669,1669,1670,8,5,-3
1670,1670,1671,5,7,2
1671,1671,1672,7,5,-2
1672,1672,1673,5,1,-4
1673,1673,1674,1,1,0
1674,1674,1675,1,8,7
1675,1675,1676,8,6,-2
1676,1676,1677,6,5,-1
1677,1677,1678,5,2,-3
1678,1678,1679,2,4,2
1679,1679,1680,4,4,0
1680,1680,1681,4,3,-1
1681,1681,1682,3,2,-1
1682,1682,1683,2,3,1
1683,1683,1684,3,5,2
1684,1684,1685,5,6,1
1685,1685,1686,6,8,2
1686,1686,1687,8,8,0
1687,1687,1688,8,6,-2
1688,1688,1689,6,2,-4
1689,1689,1690,2,3,1
1690,1690,1691,3,1,-2
1691,1691,1692,1,0,-1
1692,1692,1693,0,5,5
1693,1693,1694,5,8,3
1694,1694,1695,8,9,1
1695,1695,1696,9,2,-7
1696,1696,1697,2,9,7
1697,1697,1698,9,6,-3
1698,1698,1699,6,7,1
1699,1699,1700,7,0,-7
1700,1700,1701,0,4,4
1701,1701,1702,4,8,4
1702,1702,1703,8,7,-1
1703,1703,1704,7,1,-6
1704,1704,1705,1,7,6
1705,1705,1706,7,4,-3
1706,1706,1707,4,1,-3
1707,1707,1708,1,0,-1
1708,1708,1709,0,9,9
1709,1709,1710,9,7,-2
1710,1710,1711,7,2,-5
1711,1711,1712,2,0,-2
1712,1712,1713,0,0,0
1713,1713,1714,0,9,9
1714,1714,1715,9,1,-8
1715,1715,1716,1,7,6
1716,1716,1717,7,8,1
1717,1717,1718,8,7,-1
1718,1718,1719,7,8,1
1719,1719,1720,8,4,-4
1720,1720,1721,4,7,3
1721,1721,1722,7,2,-5
1722,1722,1723,2,0,-2
1723,1723,1724,0,4,4
1724,1724,1725,4,6,2
1725,1725,1726,6,0,-6
1726,1726,1727,0,3,3
1727,1727,1728,3,1,-2
1728,1728,1729,1,1,0
1729,1729,1730,1,3,2
1730,1730,1731,3,3,0
1731,1731,1732,3,9,6
1732,1732,1733,9,6,-3
1733,1733,1734,6,7,1
1734,1734,1735,7,4,-3
1735,1735,1736,4,1,-3
1736,1736,1737,1,5,4
1737,1737,1738,5,3,-2
1738,1738,1739,3,0,-3
1739,1739,1740,0,8,8
1740,1740,1741,8,7,-1
1741,1741,1742,7,3,-4
1742,1742,1743,3,9,6
1743,1743,1744,9,6,-3
1744,1744,1745,6,9,3
1745,1745,1746,9,3,-6
1746,1746,1747,3,5,2
1747,1747,1748,5,0,-5
1748,1748,1749,0,2,2
1749,1749,1750,2,7,5
1750,1750,1751,7,4,-3
1751,1751,1752,4,5,1
1752,1752,1753,5,1,-4
1753,1753,1754,1,7,6
1754,1754,1755,7,5,-2
1755,1755,1756,5,8,3
1756,1756,1757,8,0,-8
1757,1757,1758,0,8,8
1758,1758,1759,8,8,0
1759,1759,1760,8,1,-7
1760,1760,1761,1,5,4
1761,1761,1762,5,0,-5
1762,1762,1763,0,3,3
1763,1763,1764,3,0,-3
1764,1764,1765,0,3,3
1765,1765,1766,3,1,-2
1766,1766,1767,1,4,3
1767,1767,1768,4,0,-4
1768,1768,1769,0,3,3
1769,1769,1770,3,7,4
1770,1770,1771,7,2,-5
1771,1771,1772,2,7,5
1772,1772,1773,7,1,-6
1773,1773,1774,1,8,7
1774,1774,1775,8,0,-8
1775,1775,1776,0,7,7
1776,1776,1777,7,0,-7
1777,1777,1778,0,4,4
1778,1778,1779,4,3,-1
1779,1779,1780,3,1,-2
1780,1780,1781,1,9,8
1781,1781,1782,9,8,-1
1782,1782,1783,8,7,-1
1783,1783,1784,7,7,0
1784,1784,1785,7,1,-6
1785,1785,1786,1,4,3
1786,1786,1787,4,9,5
1787,1787,1788,9,9,0
1788,1788,1789,9,3,-6
1789,1789,1790,3,2,-1
1790,1790,1791,2,1,-1
1791,1791,1792,1,7,6
1792,1792,1793,7,9,2
1793,1793,1794,9,0,-9
1794,1794,1795,0,2,2
1795,1795,1796,2,0,-2
1796,1796,1797,0,3,3
1797,1797,1798,3,3,0
1798,1798,1799,3,7,4
1799,1799,1800,7,6,-1
1800,1800,1801,6,9,3
1801,1801,1802,9,2,-7
1802,1802,1803,2,3,1
1803,1803,1804,3,3,0
1804,1804,1805,3,7,4
1805,1805,1806,7,7,0
1806,1806,1807,7,0,-7
1807,1807,1808,0,0,0
1808,1808,1809,0,7,7
1809,1809,1810,7,5,-2
1810,1810,1811,5,2,-3
1811,1811,1812,2,9,7
1812,1812,1813,9,8,-1
1813,1813,1814,8,7,-1
1814,1814,1815,7,4,-3
1815,1815,1816,4,4,0
1816,1816,1817,4,2,-2
1817,1817,1818,2,6,4
1818,1818,1819,6,6,0
1819,1819,1820,6,1,-5
1820,1820,1821,1,9,8
1821,1821,1822,9,6,-3
1822,1822,1823,6,8,2
1823,1823,1824,8,2,-6
1824,1824,1825,2,9,7
1825,1825,1826,9,0,-9
1826,1826,1827,0,8,8
1827,1827,1828,8,3,-5
1828,1828,1829,3,1,-2
1829,1829,1830,1,1,0
1830,1830,1831,1,6,5
1831,1831,1832,6,3,-3
1832,1832,1833,3,5,2
1833,1833,1834,5,1,-4
1834,1834,1835,1,1,0
1835,1835,1836,1,1,0
1836,1836,1837,1,3,2
1837,1837,1838,3,1,-2
1838,1838,1839,1,2,1
1839,1839,1840,2,3,1
1840,1840,1841,3,0,-3
1841,1841,1842,0,2,2
1842,1842,1843,2,0,-2
1843,1843,1844,0,1,1
1844,1844,1845,1,3,2
1845,1845,1846,3,5,2
1846,1846,1847,5,5,0
1847,1847,1848,5,7,2
1848,1848,1849,7,4,-3
1849,1849,1850,4,8,4
1850,1850,1851,8,9,1
1851,1851,1852,9,6,-3
1852,1852,1853,6,9,3
1853,1853,1854,9,6,-3
1854,1854,1855,6,8,2
1855,1855,1856,8,3,-5
1856,1856,1857,3,6,3
1857,1857,1858,6,6,0
1858,1858,1859,6,8,2
1859,1859,1860,8,5,-3
1860,1860,1861,5,1,-4
1861,1861,1862,1,4,3
1862,1862,1863,4,2,-2
1863,1863,1864,2,4,2
1864,1864,1865,4,4,0
1865,1865,1866,4,5,1
1866,1866,1867,5,1,-4
1867,1867,1868,1,1,0
1868,1868,1869,1,9,8
1869,1869,1870,9,0,-9
1870,1870,1871,0,2,2
1871,1871,1872,2,4,2
1872,1872,1873,4,9,5
1873,1873,1874,9,5,-4
1874,1874,1875,5,7,2
1875,1875,1876,7,1,-6
1876,1876,1877,1,8,7
1877,1877,1878,8,8,0
1878,1878,1879,8,5,-3
1879,1879,1880,5,6,1
1880,1880,1881,6,9,3
1881,1881,1882,9,8,-1
1882,1882,1883,8,7,-1
1883,1883,1884,7,1,-6
1884,1884,1885,1,1,0
1885,1885,1886,1,6,5
1886,1886,1887,6,7,1
1887,1887,1888,7,6,-1
1888,1888,1889,6,3,-3
1889,1889,1890,3,2,-1
1890,1890,1891,2,2,0
1891,1891,1892,2,0,-2
1892,1892,1893,0,8,8
1893,1893,1894,8,9,1
1894,1894,1895,9,2,-7
1895,1895,1896,2,5,3
1896,1896,1897,5,1,-4
1897,1897,1898,1,0,-1
1898,1898,1899,0,8,8
1899,1899,1900,8,1,-7
1900,1900,1901,1,9,8
1901,1901,1902,9,5,-4
1902,1902,1903,5,7,2
1903,1903,1904,7,9,2
1904,1904,1905,9,6,-3
1905,1905,1906,6,9,3
1906,1906,1907,9,0,-9
1907,1907,1908,0,6,6
1908,1908,1909,6,1,-5
1909,1909,1910,1,5,4
1910,1910,1911,5,5,0
1911,1911,1912,5,8,3
1912,1912,1913,8,3,-5
1913,1913,1914,3,8,5
1914,1914,1915,8,2,-6
1915,1915,1916,2,6,4
1916,1916,1917,6,5,-1
1917,1917,1918,5,0,-5
1918,1918,1919,0,7,7
1919,1919,1920,7,4,-3
1920,1920,1921,4,6,2
1921,1921,1922,6,1,-5
1922,1922,1923,1,3,2
1923,1923,1924,3,4,1
1924,1924,1925,4,7,3
1925,1925,1926,7,3,-4
1926,1926,1927,3,2,-1
1927,1927,1928,2,3,1
1928,1928,1929,3,4,1
1929,1929,1930,4,2,-2
1930,1930,1931,2,5,3
1931,1931,1932,5,2,-3
1932,1932,1933,2,7,5
1933,1933,1934,7,1,-6
1934,1934,1935,1,7,6
1935,1935,1936,7,2,-5
1936,1936,1937,2,6,4
1937,1937,1938,6,4,-2
1938,1938,1939,4,1,-3
1939,1939,1940,1,5,4
1940,1940,1941,5,7,2
1941,1941,1942,7,8,1
1942,1942,1943,8,6,-2
1943,1943,1944,6,0,-6
1944,1944,1945,0,1,1
1945,1945,1946,1,8,7
1946,1946,1947,8,2,-6
1947,1947,1948,2,5,3
1948,1948,1949,5,7,2
1949,1949,1950,7,7,0
1950,1950,1951,7,6,-1
1951,1951,1952,6,9,3
1952,1952,1953,9,3,-6
1953,1953,1954,3,5,2
1954,1954,1955,5,8,3
1955,1955,1956,8,4,-4
1956,1956,1957,4,2,-2
1957,1957,1958,2,4,2
1958,1958,1959,4,0,-4
1959,1959,1960,0,8,8
1960,1960,1961,8,8,0
1961,1961,1962,8,3,-5
1962,1962,1963,3,4,1
1963,1963,1964,4,9,5
1964,1964,1965,9,2,-7
1965,1965,1966,2,7,5
1966,1966,1967,7,5,-2
1967,1967,1968,5,8,3
1968,1968,1969,8,6,-2
1969,1969,1970,6,5,-1
1970,1970,1971,5,6,1
1971,1971,1972,6,0,-6
1972,1972,1973,0,8,8
1973,1973,1974,8,6,-2
1974,1974,1975,6,7,1
1975,1975,1976,7,3,-4
1976,1976,1977,3,6,3
1977,1977,1978,6,4,-2
1978,1978,1979,4,9,5
1979,1979,1980,9,4,-5
1980,1980,1981,4,6,2
1981,1981,1982,6,6,0
1982,1982,1983,6,3,-3
1983,1983,1984,3,2,-1
1984,1984,1985,2,4,2
1985,1985,1986,4,1,-3
1986,1986,1987,1,0,-1
1987,1987,1988,0,1,1
1988,1988,1989,1,4,3
1989,1989,1990,4,6,2
1990,1990,1991,6,2,-4
1991,1991,1992,2,9,7
1992,1992,1993,9,1,-8
1993,1993,1994,1,1,0
1994,1994,1995,1,0,-1
1995,1995,1996,0,6,6
1996,1996,1997,6,3,-3
1997,1997,1998,3,9,6
1998,1998,1999,9,5,-4
1999,1999,2000,5,6,1
2000,2000,2001,6,5,-1
2001,2001,2002,5,6,1
2002,2002,2003,6,5,-1
2003,2003,2004,5,8,3
2004,2004,2005,8,4,-4
2005,2005,2006,4,6,2
2006,2006,2007,6,4,-2
2007,2007,2008,4,3,-1
2008,2008,2009,3,9,6
2009,2009,2010,9,1,-8
2010,2010,2011,1,3,2
2011,2011,2012,3,4,1
2012,2012,2013,4,1,-3
2013,2013,2014,1,9,8
2014,2014,2015,9,1,-8
2015,2015,2016,1,7,6
2016,2016,2017,7,1,-6
2017,2017,2018,1,1,0
2018,2018,2019,1,9,8
2019,2019,2020,9,3,-6
2020,2020,2021,3,5,2
2021,2021,2022,5,4,-1
2022,2022,2023,4,0,-4
2023,2023,2024,0,7,7
2024,2024,2025,7,3,-4
2025,2025,2026,3,6,3
2026,2026,2027,6,1,-5
2027,2027,2028,1,7,6
2028,2028,2029,7,5,-2
2029,2029,2030,5,5,0
2030,2030,2031,5,3,-2
2031,2031,2032,3,3,0
2032,2032,2033,3,0,-3
2033,2033,2034,0,1,1
2034,2034,2035,1,5,4
2035,2035,2036,5,7,2
2036,2036,2037,7,5,-2
2037,2037,2038,5,8,3
2038,2038,2039,8,6,-2
2039,2039,2040,6,5,-1
2040,2040,2041,5,1,-4
2041,2041,2042,1,0,-1
2042,2042,2043,0,4,4
2043,2043,2044,4,2,-2
2044,2044,2045,2,3,1
2045,2045,2046,3,4,1
2046,2046,2047,4,6,2
2047,2047,2048,6,7,1
2048,2048,2049,7,9,2
2049,2049,2050,9,8,-1
2050,2050,2051,8,1,-7
2051,2051,2052,1,8,7
2052,2052,2053,8,4,-4
2053,2053,2054,4,9,5
2054,2054,2055,9,2,-7
2055,2055,2056,2,8,6
2056,2056,2057,8,6,-2
2057,2057,2058,6,2,-4
2058,2058,2059,2,7,5
2059,2059,2060,7,0,-7
2060,2060,2061,0,0,0
2061,2061,2062,0,6,6
2062,2062,2063,6,7,1
2063,2063,2064,7,5,-2
2064,2064,2065,5,8,3
2065,2065,2066,8,6,-2
2066,2066,2067,6,0,-6
2067,2067,2068,0,9,9
2068,2068,2069,9,3,-6
2069,2069,2070,3,7,4
2070,2070,2071,7,1,-6
2071,2071,2072,1,3,2
2072,2072,2073,3,5,2
2073,2073,2074,5,4,-1
2074,2074,2075,4,3,-1
2075,2075,2076,3,3,0
2076,2076,2077,3,5,2
2077,2077,2078,5,5,0
2078,2078,2079,5,6,1
2079,2079,2080,6,3,-3
2080,2080,2081,3,0,-3
2081,2081,2082,0,2,2
2082,2082,2083,2,3,1
2083,2083,2084,3,4,1
2084,2084,2085,4,2,-2
2085,2085,2086,2,3,1
2086,2086,2087,3,0,-3
2087,2087,2088,0,9,9
2088,2088,2089,9,9,0
2089,2089,2090,9,4,-5
2090,2090,2091,4,7,3
2091,2091,2092,7,2,-5
2092,2092,2093,2,8,6
2093,2093,2094,8,4,-4
2094,2094,2095,4,7,3
2095,2095,2096,7,0,-7
2096,2096,2097,0,6,6
2097,2097,2098,6,2,-4
2098,2098,2099,2,8,6
2099,2099,2100,8,5,-3
2100,2100,2101,5,2,-3
2101,2101,2102,2,8,6
2102,2102,2103,8,5,-3
2103,2103,2104,5,7,2
2104,2104,2105,7,3,-4
2105,2105,2106,3,0,-3
2106,2106,2107,0,8,8
2107,2107,2108,8,2,-6
2108,2108,2109,2,3,1
2109,2109,2110,3,2,-1
2110,2110,2111,2,8,6
2111,2111,2112,8,2,-6
2112,2112,2113,2,5,3
2113,2113,2114,5,5,0
2114,2114,2115,5,7,2
2115,2115,2116,7,6,-1
2116,2116,2117,6,4,-2
2117,2117,2118,4,6,2
2118,2118,2119,6,8,2
2119,2119,2120,8,4,-4
2120,2120,2121,4,8,4
2121,2121,2122,8,2,-6
2122,2122,2123,2,7,5
2123,2123,2124,7,4,-3
2124,2124,2125,4,5,1
2125,2125,2126,5,2,-3
2126,2126,2127,2,0,-2
2127,2127,2128,0,3,3
2128,2128,2129,3,9,6
2129,2129,2130,9,4,-5
2130,2130,2131,4,6,2
2131,2131,2132,6,7,1
2132,2132,2133,7,2,-5
2133,2133,2134,2,5,3
2134,2134,2135,5,6,1
2135,2135,2136,6,1,-5
2136,2136,2137,1,1,0
2137,2137,2138,1,2,1
2138,2138,2139,2,3,1
2139,2139,2140,3,6,3
2140,2140,2141,6,7,1
2141,2141,2142,7,8,1
2142,2142,2143,8,7,-1
2143,2143,2144,7,6,-1
2144,2144,2145,6,4,-2
2145,2145,2146,4,8,4
2146,2146,2147,8,9,1
2147,2147,2148,9,4,-5
2148,2148,2149,4,8,4
2149,2149,2150,8,6,-2
2150,2150,2151,6,3,-3
2151,2151,2152,3,8,5
2152,2152,2153,8,3,-5
2153,2153,2154,3,1,-2
2154,2154,2155,1,0,-1
2155,2155,2156,0,6,6
2156,2156,2157,6,2,-4
2157,2157,2158,2,2,0
2158,2158,2159,2,5,3
2159,2159,2160,5,6,1
2160,2160,2161,6,9,3
2161,2161,2162,9,5,-4
2162,2162,2163,5,8,3
2163,2163,2164,8,1,-7
2164,2164,2165,1,4,3
2165,2165,2166,4,1,-3
2166,2166,2167,1,7,6
2167,2167,2168,7,8,1
2168,2168,2169,8,4,-4
2169,2169,2170,4,6,2
2170,2170,2171,6,1,-5
2171,2171,2172,1,8,7
2172,2172,2173,8,4,-4
2173,2173,2174,4,3,-1
2174,2174,2175,3,1,-2
2175,2175,2176,1,2,1
2176,2176,2177,2,8,6
2177,2177,2178,8,0,-8
2178,2178,2179,0,8,8
2179,2179,2180,8,5,-3
2180,2180,2181,5,9,4
2181,2181,2182,9,1,-8
2182,2182,2183,1,4,3
2183,2183,2184,4,2,-2
2184,2184,2185,2,0,-2
2185,2185,2186,0,2,2
2186,2186,2187,2,7,5
2187,2187,2188,7,0,-7
2188,2188,2189,0,9,9
2189,2189,2190,9,0,-9
2190,2190,2191,0,2,2
2191,2191,2192,2,5,3
2192,2192,2193,5,7,2
2193,2193,2194,7,6,-1
2194,2194,2195,6,7,1
2195,2195,2196,7,9,2
2196,2196,2197,9,4,-5
2197,2197,2198,4,2,-2
2198,2198,2199,2,6,4
2199,2199,2200,6,2,-4
2200,2200,2201,2,4,2
2201,2201,2202,4,4,0
2202,2202,2203,4,8,4
2203,2203,2204,8,0,-8
2204,2204,2205,0,4,4
2205,2205,2206,4,4,0
2206,2206,2207,4,5,1
2207,2207,2208,5,8,3
2208,2208,2209,8,0,-8
2209,2209,2210,0,6,6
2210,2210,2211,6,8,2
2211,2211,2212,8,9,1
2212,2212,2213,9,8,-1
2213,2213,2214,8,5,-3
2214,2214,2215,5,6,1
2215,2215,2216,6,9,3
2216,2216,2217,9,0,-9
2217,2217,2218,0,4,4
2218,2218,2219,4,8,4
2219,2219,2220,8,7,-1
2220,2220,2221,7,1,-6
2221,2221,2222,1,3,2
2222,2222,2223,3,4,1
2223,2223,2224,4,5,1
2224,2224,2225,5,8,3
2225,2225,2226,8,0,-8
2226,2226,2227,0,9,9
2227,2227,2228,9,1,-8
2228,2228,2229,1,3,2
2229,2229,2230,3,3,0
2230,2230,2231,3,6,3
2231,2231,2232,6,9,3
2232,2232,2233,9,8,-1
2233,2233,2234,8,7,-1
2234,2234,2235,7,1,-6
2235,2235,2236,1,0,-1
2236,2236,2237,0,5,5
2237,2237,2238,5,7,2
2238,2238,2239,7,1,-6
2239,2239,2240,1,7,6
2240,2240,2241,7,5,-2
2241,2241,2242,5,2,-3
2242,2242,2243,2,7,5
2243,2243,2244,7,9,2
2244,2244,2245,9,1,-8
2245,2245,2246,1,8,7
2246,2246,2247,8,5,-3
2247,2247,2248,5,2,-3
2248,2248,2249,2,4,2
2249,2249,2250,4,9,5
2250,2250,2251,9,4,-5
2251,2251,2252,4,7,3
2252,2252,2253,7,2,-5
2253,2253,2254,2,2,0
2254,2254,2255,2,3,1
2255,2255,2256,3,4,1
2256,2256,2257,4,9,5
2257,2257,2258,9,1,-8
2258,2258,2259,1,9,8
2259,2259,2260,9,2,-7
2260,2260,2261,2,1,-1
2261,2261,2262,1,7,6
2262,2262,2263,7,9,2
2263,2263,2264,9,4,-5
2264,2264,2265,4,4,0
2265,2265,2266,4,1,-3
2266,2266,2267,1,6,5
2267,2267,2268,6,7,1
2268,2268,2269,7,2,-5
2269,2269,2270,2,7,5
2270,2270,2271,7,8,1
2271,2271,2272,8,8,0
2272,2272,2273,8,1,-7
2273,2273,2274,1,9,8
2274,2274,2275,9,7,-2
2275,2275,2276,7,1,-6
2276,2276,2277,1,1,0
2277,2277,2278,1,7,6
2278,2278,2279,7,5,-2
2279,2279,2280,5,3,-2
2280,2280,2281,3,3,0
2281,2281,2282,3,5,2
2282,2282,2283,5,1,-4
2283,2283,2284,1,3,2
2284,2284,2285,3,7,4
2285,2285,2286,7,6,-1
2286,2286,2287,6,1,-5
2287,2287,2288,1,3,2
2288,2288,2289,3,8,5
2289,2289,2290,8,7,-1
2290,2290,2291,7,5,-2
2291,2291,2292,5,9,4
2292,2292,2293,9,9,0
2293,2293,2294,9,0,-9
2294,2294,2295,0,0,0
2295,2295,2296,0,2,2
2296,2296,2297,2,8,6
2297,2297,2298,8,8,0
2298,2298,2299,8,2,-6
2299,2299,2300,2,3,1
2300,2300,2301,3,7,4
2301,2301,2302,7,1,-6
2302,2302,2303,1,3,2
2303,2303,2304,3,0,-3
2304,2304,2305,0,3,3
2305,2305,2306,3,4,1
2306,2306,2307,4,4,0
2307,2307,2308,4,3,-1
2308,2308,2309,3,8,5
2309,2309,2310,8,9,1
2310,2310,2311,9,2,-7
2311,2311,2312,2,3,1
2312,2312,2313,3,9,6
2313,2313,2314,9,7,-2
2314,2314,2315,7,1,-6
2315,2315,2316,1,1,0
2316,2316,2317,1,7,6
2317,2317,2318,7,0,-7
2318,2318,2319,0,4,4
2319,2319,2320,4,9,5
2320,2320,2321,9,6,-3
2321,2321,2322,6,5,-1
2322,2322,2323,5,9,4
2323,2323,2324,9,1,-8
2324,2324,2325,1,7,6
2325,2325,2326,7,0,-7
2326,2326,2327,0,2,2
2327,2327,2328,2,0,-2
2328,2328,2329,0,0,0
2329,2329,2330,0,4,4
2330,2330,2331,4,6,2
2331,2331,2332,6,7,1
2332,2332,2333,7,0,-7
2333,2333,2334,0,7,7
2334,2334,2335,7,1,-6
2335,2335,2336,1,4,3
2336,2336,2337,4,6,2
2337,2337,2338,6,4,-2
2338,2338,2339,4,5,1
2339,2339,2340,5,4,-1
2340,2340,2341,4,9,5
2341,2341,2342,9,9,0
2342,2342,2343,9,1,-8
2343,2343,2344,1,7,6
2344,2344,2345,7,9,2
2345,2345,2346,9,5,-4
2346,2346,2347,5,3,-2
2347,2347,2348,3,3,0
2348,2348,2349,3,8,5
2349,2349,2350,8,2,-6
2350,2350,2351,2,3,1
2351,2351,2352,3,6,3
2352,2352,2353,6,2,-4
2353,2353,2354,2,2,0
2354,2354,2355,2,1,-1
2355,2355,2356,1,1,0
2356,2356,2357,1,1,0
2357,2357,2358,1,1,0
2358,2358,2359,1,1,0
2359,2359,2360,1,6,5
2360,2360,2361,6,9,3
2361,2361,2362,9,8,-1
2362,2362,2363,8,4,-4
2363,2363,2364,4,3,-1
2364,2364,2365,3,7,4
2365,2365,2366,7,1,-6
2366,2366,2367,1,6,5
2367,2367,2368,6,4,-2
2368,2368,2369,4,5,1
2369,2369,2370,5,0,-5
2370,2370,2371,0,4,4
2371,2371,2372,4,7,3
2372,2372,2373,7,4,-3
2373,2373,2374,4,2,-2
2374,2374,2375,2,4,2
2375,2375,2376,4,0,-4
2376,2376,2377,0,7,7
2377,2377,2378,7,0,-7
2378,2378,2379,0,1,1
2379,2379,2380,1,9,8
2380,2380,2381,9,8,-1
2381,2381,2382,8,8,0
2382,2382,2383,8,6,-2
2383,2383,2384,6,0,-6
2384,2384,2385,0,0,0
2385,2385,2386,0,4,4
2386,2386,2387,4,9,5
2387,2387,2388,9,6,-3
2388,2388,2389,6,8,2
2389,2389,2390,8,2,-6
2390,2390,2391,2,2,0
2391,2391,2392,2,3,1
2392,2392,2393,3,8,5
2393,2393,2394,8,4,-4
2394,2394,2395,4,8,4
2395,2395,2396,8,2,-6
2396,2396,2397,2,2,0
2397,2397,2398,2,1,-1
2398,2398,2399,1,7,6
2399,2399,2400,7,5,-2
2400,2400,2401,5,4,-1
2401,2401,2402,4,4,0
2402,2402,2403,4,0,-4
2403,2403,2404,0,4,4
2404,2404,2405,4,3,-1
2405,2405,2406,3,9,6
2406,2406,2407,9,7,-2
2407,2407,2408,7,3,-4
2408,2408,2409,3,1,-2
2409,2409,2410,1,0,-1
2410,2410,2411,0,1,1
2411,2411,2412,1,2,1
2412,2412,2413,2,5,3
2413,2413,2414,5,9,4
2414,2414,2415,9,2,-7
2415,2415,2416,2,1,-1
2416,2416,2417,1,0,-1
2417,2417,2418,0,1,1
2418,2418,2419,1,8,7
2419,2419,2420,8,9,1
2420,2420,2421,9,1,-8
2421,2421,2422,1,6,5
2422,2422,2423,6,8,2
2423,2423,2424,8,3,-5
2424,2424,2425,3,8,5
2425,2425,2426,8,9,1
2426,2426,2427,9,3,-6
2427,2427,2428,3,6,3
2428,2428,2429,6,2,-4
2429,2429,2430,2,8,6
2430,2430,2431,8,3,-5
2431,2431,2432,3,2,-1
2432,2432,2433,2,2,0
2433,2433,2434,2,1,-1
2434,2434,2435,1,0,-1
2435,2435,2436,0,4,4
2436,2436,2437,4,2,-2
2437,2437,2438,2,9,7
2438,2438,2439,9,2,-7
2439,2439,2440,2,4,2
2440,2440,2441,4,3,-1
2441,2441,2442,3,7,4
2442,2442,2443,7,9,2
2443,2443,2444,9,1,-8
2444,2444,2445,1,5,4
2445,2445,2446,5,2,-3
2446,2446,2447,2,4,2
2447,2447,2448,4,9,5
2448,2448,2449,9,0,-9
2449,2449,2450,0,3,3
2450,2450,2451,3,8,5
2451,2451,2452,8,5,-3
2452,2452,2453,5,3,-2
2453,2453,2454,3,6,3
2454,2454,2455,6,0,-6
2455,2455,2456,0,9,9
2456,2456,2457,9,4,-5
2457,2457,2458,4,6,2
2458,2458,2459,6,2,-4
2459,2459,2460,2,5,3
2460,2460,2461,5,0,-5
2461,2461,2462,0,2,2
2462,2462,2463,2,7,5
2463,2463,2464,7,4,-3
2464,2464,2465,4,6,2
2465,2465,2466,6,6,0
2466,2466,2467,6,8,2
2467,2467,2468,8,6,-2
2468,2468,2469,6,6,0
2469,2469,2470,6,8,2
2470,2470,2471,8,6,-2
2471,2471,2472,6,9,3
2472,2472,2473,9,1,-8
2473,2473,2474,1,7,6
2474,2474,2475,7,2,-5
2475,2475,2476,2,5,3
2476,2476,2477,5,9,4
2477,2477,2478,9,9,0
2478,2478,2479,9,0,-9
2479,2479,2480,0,7,7
2480,2480,2481,7,2,-5
2481,2481,2482,2,7,5
2482,2482,2483,7,6,-1
2483,2483,2484,6,7,1
2484,2484,2485,7,0,-7
2485,2485,2486,0,6,6
2486,2486,2487,6,5,-1
2487,2487,2488,5,2,-3
2488,2488,2489,2,4,2
2489,2489,2490,4,7,3
2490,2490,2491,7,2,-5
2491,2491,2492,2,0,-2
2492,2492,2493,0,9,9
2493,2493,2494,9,9,0
2494,2494,2495,9,2,-7
2495,2495,2496,2,2,0
2496,2496,2497,2,9,7
2497,2497,2498,9,4,-5
2498,2498,2499,4,4,0
2499,2499,2500,4,2,-2
2500,2500,2501,2,3,1
2501,2501,2502,3,3,0
2502,2502,2503,3,2,-1
2503,2503,2504,2,1,-1
2504,2504,2505,1,7,6
2505,2505,2506,7,0,-7
2506,2506,2507,0,7,7
2507,2507,2508,7,6,-1
2508,2508,2509,6,4,-2
2509,2509,2510,4,1,-3
2510,2510,2511,1,3,2
2511,2511,2512,3,8,5
2512,2512,2513,8,7,-1
2513,2513,2514,7,4,-3
2514,2514,2515,4,5,1
2515,2515,2516,5,9,4
2516,2516,2517,9,2,-7
2517,2517,2518,2,5,3
2518,2518,2519,5,1,-4
2519,2519,2520,1,8,7
2520,2520,2521,8,7,-1
2521,2521,2522,7,3,-4
2522,2522,2523,3,7,4
2523,2523,2524,7,1,-6
2524,2524,2525,1,5,4
2525,2525,2526,5,5,0
2526,2526,2527,5,0,-5
2527,2527,2528,0,9,9
2528,2528,2529,9,1,-8
2529,2529,2530,1,4,3
2530,2530,2531,4,0,-4
2531,2531,2532,0,6,6
2532,2532,2533,6,3,-3
2533,2533,2534,3,3,0
2534,2534,2535,3,6,3
2535,2535,2536,6,0,-6
2536,2536,2537,0,4,4
2537,2537,2538,4,9,5
2538,2538,2539,9,7,-2
2539,2539,2540,7,5,-2
2540,2540,2541,5,1,-4
2541,2541,2542,1,6,5
2542,2542,2543,6,8,2
2543,2543,2544,8,9,1
2544,2544,2545,9,5,-4
2545,2545,2546,5,5,0
2546,2546,2547,5,7,2
2547,2547,2548,7,9,2
2548,2548,2549,9,3,-6
2549,2549,2550,3,8,5
2550,2550,2551,8,3,-5
2551,2551,2552,3,8,5
2552,2552,2553,8,1,-7
2553,2553,2554,1,5,4
2554,2554,2555,5,3,-2
2555,2555,2556,3,5,2
2556,2556,2557,5,0,-5
2557,2557,2558,0,5,5
2558,2558,2559,5,5,0
2559,2559,2560,5,3,-2
2560,2560,2561,3,8,5
2561,2561,2562,8,6,-2
2562,2562,2563,6,7,1
2563,2563,2564,7,7,0
2564,2564,2565,7,7,0
2565,2565,2566,7,3,-4
2566,2566,2567,3,7,4
2567,2567,2568,7,0,-7
2568,2568,2569,0,5,5
2569,2569,2570,5,9,4
2570,2570,2571,9,0,-9
2571,2571,2572,0,2,2
2572,2572,2573,2,5,3
2573,2573,2574,5,5,0
2574,2574,2575,5,3,-2
2575,2575,2576,3,1,-2
2576,2576,2577,1,7,6
2577,2577,2578,7,7,0
2578,2578,2579,7,8,1
2579,2579,2580,8,6,-2
2580,2580,2581,6,5,-1
2581,2581,2582,5,9,4
2582,2582,2583,9,3,-6
2583,2583,2584,3,8,5
2584,2584,2585,8,9,1
2585,2585,2586,9,5,-4
2586,2586,2587,5,3,-2
2587,2587,2588,3,7,4
2588,2588,2589,7,9,2
2589,2589,2590,9,1,-8
2590,2590,2591,1,7,6
2591,2591,2592,7,0,-7
2592,2592,2593,0,0,0
2593,2593,2594,0,3,3
2594,2594,2595,3,7,4
2595,2595,2596,7,2,-5
2596,2596,2597,2,5,3
2597,2597,2598,5,8,3
2598,2598,2599,8,1,-7
2599,2599,2600,1,8,7
2600,2600,2601,8,6,-2
2601,2601,2602,6,2,-4
2602,2602,2603,2,9,7
2603,2603,2604,9,5,-4
2604,2604,2605,5,7,2
2605,2605,2606,7,5,-2
2606,2606,2607,5,7,2
2607,2607,2608,7,8,1
2608,2608,2609,8,6,-2
2609,2609,2610,6,2,-4
2610,2610,2611,2,5,3
2611,2611,2612,5,1,-4
2612,2612,2613,1,4,3
2613,2613,2614,4,8,4
2614,2614,2615,8,4,-4
2615,2615,2616,4,5,1
2616,2616,2617,5,8,3
2617,2617,2618,8,3,-5
2618,2618,2619,3,0,-3
2619,2619,2620,0,6,6
2620,2620,2621,6,2,-4
2621,2621,2622,2,7,5
2622,2622,2623,7,3,-4
2623,2623,2624,3,3,0
2624,2624,2625,3,2,-1
2625,2625,2626,2,1,-1
2626,2626,2627,1,0,-1
2627,2627,2628,0,7,7
2628,2628,2629,7,3,-4
2629,2629,2630,3,4,1
2630,2630,2631,4,0,-4
2631,2631,2632,0,3,3
2632,2632,2633,3,9,6
2633,2633,2634,9,3,-6
2634,2634,2635,3,2,-1
2635,2635,2636,2,8,6
2636,2636,2637,8,9,1
2637,2637,2638,9,0,-9
2638,2638,2639,0,3,3
2639,2639,2640,3,8,5
2640,2640,2641,8,0,-8
2641,2641,2642,0,7,7
2642,2642,2643,7,6,-1
2643,2643,2644,6,5,-1
2644,2644,2645,5,4,-1
2645,2645,2646,4,7,3
2646,2646,2647,7,3,-4
2647,2647,2648,3,9,6
2648,2648,2649,9,0,-9
2649,2649,2650,0,8,8
2650,2650,2651,8,6,-2
2651,2651,2652,6,2,-4
2652,2652,2653,2,5,3
2653,2653,2654,5,6,1
2654,2654,2655,6,1,-5
2655,2655,2656,1,0,-1
2656,2656,2657,0,0,0
2657,2657,2658,0,4,4
2658,2658,2659,4,4,0
2659,2659,2660,4,0,-4
2660,2660,2661,0,1,1
2661,2661,2662,1,2,1
2662,2662,2663,2,3,1
2663,2663,2664,3,2,-1
2664,2664,2665,2,7,5
2665,2665,2666,7,7,0
2666,2666,2667,7,8,1
2667,2667,2668,8,5,-3
2668,2668,2669,5,2,-3
2669,2669,2670,2,5,3
2670,2670,2671,5,7,2
2671,2671,2672,7,6,-1
2672,2672,2673,6,9,3
2673,2673,2674,9,1,-8
2674,2674,2675,1,4,3
2675,2675,2676,4,1,-3
2676,2676,2677,1,6,5
2677,2677,2678,6,4,-2
2678,2678,2679,4,2,-2
2679,2679,2680,2,4,2
2680,2680,2681,4,3,-1
2681,2681,2682,3,5,2
2682,2682,2683,5,4,-1
2683,2683,2684,4,3,-1
2684,2684,2685,3,9,6
2685,2685,2686,9,5,-4
2686,2686,2687,5,0,-5
2687,2687,2688,0,1,1
2688,2688,2689,1,5,4
2689,2689,2690,5,3,-2
2690,2690,2691,3,8,5
2691,2691,2692,8,9,1
2692,2692,2693,9,1,-8
2693,2693,2694,1,9,8
2694,2694,2695,9,7,-2
2695,2695,2696,7,9,2
2696,2696,2697,9,5,-4
2697,2697,2698,5,5,0
2698,2698,2699,5,2,-3
2699,2699,2700,2,7,5
2700,2700,2701,7,4,-3
2701,2701,2702,4,6,2
2702,2702,2703,6,0,-6
2703,2703,2704,0,1,1
2704,2704,2705,1,1,0
2705,2705,2706,1,1,0
2706,2706,2707,1,0,-1
2707,2707,2708,0,4,4
2708,2708,2709,4,4,0
2709,2709,2710,4,7,3
2710,2710,2711,7,6,-1
2711,2711,2712,6,3,-3
2712,2712,2713,3,0,-3
2713,2713,2714,0,0,0
2714,2714,2715,0,4,4
2715,2715,2716,4,3,-1
2716,2716,2717,3,0,-3
2717,2717,2718,0,6,6
2718,2718,2719,6,1,-5
2719,2719,2720,1,9,8
2720,2720,2721,9,6,-3
2721,2721,2722,6,1,-5
2722,2722,2723,1,3,2
2723,2723,2724,3,8,5
2724,2724,2725,8,1,-7
2725,2725,2726,1,2,1
2726,2726,2727,2,5,3
2727,2727,2728,5,6,1
2728,2728,2729,6,2,-4
2729,2729,2730,2,7,5
2730,2730,2731,7,3,-4
2731,2731,2732,3,6,3
2732,2732,2733,6,0,-6
2733,2733,2734,0,1,1
2734,2734,2735,1,9,8
2735,2735,2736,9,7,-2
2736,2736,2737,7,6,-1
2737,2737,2738,6,6,0
2738,2738,2739,6,8,2
2739,2739,2740,8,9,1
2740,2740,2741,9,2,-7
2741,2741,2742,2,9,7
2742,2742,2743,9,5,-4
2743,2743,2744,5,8,3
2744,2744,2745,8,3,-5
2745,2745,2746,3,1,-2
2746,2746,2747,1,0,-1
2747,2747,2748,0,0,0
2748,2748,2749,0,7,7
2749,2749,2750,7,6,-1
2750,2750,2751,6,6,0
2751,2751,2752,6,2,-4
2752,2752,2753,2,1,-1
2753,2753,2754,1,6,5
2754,2754,2755,6,9,3
2755,2755,2756,9,3,-6
2756,2756,2757,3,1,-2
2757,2757,2758,1,8,7
2758,2758,2759,8,6,-2
2759,2759,2760,6,9,3
2760,2760,2761,9,0,-9
2761,2761,2762,0,6,6
2762,2762,2763,6,0,-6
2763,2763,2764,0,0,0
2764,2764,2765,0,0,0
2765,2765,2766,0,6,6
2766,2766,2767,6,3,-3
2767,2767,2768,3,5,2
2768,2768,2769,5,9,4
2769,2769,2770,9,3,-6
2770,2770,2771,3,4,1
2771,2771,2772,4,5,1
2772,2772,2773,5,5,0
2773,2773,2774,5,8,3
2774,2774,2775,8,5,-3
2775,2775,2776,5,3,-2
2776,2776,2777,3,0,-3
2777,2777,2778,0,4,4
2778,2778,2779,4,0,-4
2779,2779,2780,0,2,2
2780,2780,2781,2,9,7
2781,2781,2782,9,6,-3
2782,2782,2783,6,8,2
2783,2783,2784,8,2,-6
2784,2784,2785,2,3,1
2785,2785,2786,3,1,-2
2786,2786,2787,1,2,1
2787,2787,2788,2,1,-1
2788,2788,2789,1,1,0
2789,2789,2790,1,5,4
2790,2790,2791,5,6,1
2791,2791,2792,6,9,3
2792,2792,2793,9,8,-1
2793,2793,2794,8,0,-8
2794,2794,2795,0,6,6
2795,2795,2796,6,6,0
2796,2796,2797,6,5,-1
2797,2797,2798,5,5,0
2798,2798,2799,5,3,-2
2799,2799,2800,3,8,5
2800,2800,2801,8,6,-2
2801,2801,2802,6,2,-4
2802,2802,2803,2,1,-1
2803,2803,2804,1,4,3
2804,2804,2805,4,5,1
2805,2805,2806,5,4,-1
2806,2806,2807,4,3,-1
2807,2807,2808,3,7,4
2808,2808,2809,7,8,1
2809,2809,2810,8,5,-3
2810,2810,2811,5,0,-5
2811,2811,2812,0,9,9
2812,2812,2813,9,3,-6
2813,2813,2814,3,5,2
2814,2814,2815,5,1,-4
2815,2815,2816,1,1,0
2816,2816,2817,1,0,-1
2817,2817,2818,0,4,4
2818,2818,2819,4,4,0
2819,2819,2820,4,7,3
2820,2820,2821,7,0,-7
2821,2821,2822,0,1,1
2822,2822,2823,1,7,6
2823,2823,2824,7,0,-7
2824,2824,2825,0,1,1
2825,2825,2826,1,6,5
2826,2826,2827,6,1,-5
2827,2827,2828,1,4,3
2828,2828,2829,4,5,1
2829,2829,2830,5,6,1
2830,2830,2831,6,6,0
2831,2831,2832,6,5,-1
2832,2832,2833,5,7,2
2833,2833,2834,7,8,1
2834,2834,2835,8,4,-4
2835,2835,2836,4,4,0
2836,2836,2837,4,7,3
2837,2837,2838,7,2,-5
2838,2838,2839,2,5,3
2839,2839,2840,5,3,-2
2840,2840,2841,3,7,4
2841,2841,2842,7,0,-7
2842,2842,2843,0,7,7
2843,2843,2844,7,7,0
2844,2844,2845,7,9,2
2845,2845,2846,9,6,-3
2846,2846,2847,6,4,-2
2847,2847,2848,4,2,-2
2848,2848,2849,2,8,6
2849,2849,2850,8,5,-3
2850,2850,2851,5,7,2
2851,2851,2852,7,8,1
2852,2852,2853,8,3,-5
2853,2853,2854,3,9,6
2854,2854,2855,9,5,-4
2855,2855,2856,5,8,3
2856,2856,2857,8,9,1
2857,2857,2858,9,9,0
2858,2858,2859,9,8,-1
2859,2859,2860,8,6,-2
2860,2860,2861,6,2,-4
2861,2861,2862,2,8,6
2862,2862,2863,8,9,1
2863,2863,2864,9,2,-7
2864,2864,2865,2,3,1
2865,2865,2866,3,6,3
2866,2866,2867,6,1,-5
2867,2867,2868,1,1,0
2868,2868,2869,1,8,7
2869,2869,2870,8,9,1
2870,2870,2871,9,3,-6
2871,2871,2872,3,4,1
2872,2872,2873,4,0,-4
2873,2873,2874,0,7,7
2874,2874,2875,7,9,2
2875,2875,2876,9,6,-3
2876,2876,2877,6,4,-2
2877,2877,2878,4,1,-3
2878,2878,2879,1,4,3
2879,2879,2880,4,1,-3
2880,2880,2881,1,3,2
2881,2881,2882,3,4,1
2882,2882,2883,4,9,5
2883,2883,2884,9,3,-6
2884,2884,2885,3,1,-2
2885,2885,2886,1,4,3
2886,2886,2887,4,7,3
2887,2887,2888,7,7,0
2888,2888,2889,7,4,-3
2889,2889,2890,4,7,3
2890,2890,2891,7,2,-5
2891,2891,2892,2,9,7
2892,2892,2893,9,3,-6
2893,2893,2894,3,0,-3
2894,2894,2895,0,8,8
2895,2895,2896,8,8,0
2896,2896,2897,8,8,0
2897,2897,2898,8,4,-4
2898,2898,2899,4,0,-4
2899,2899,2900,0,4,4
2900,2900,2901,4,4,0
2901,2901,2902,4,1,-3
2902,2902,2903,1,5,4
2903,2903,2904,5,2,-3
2904,2904,2905,2,8,6
2905,2905,2906,8,3,-5
2906,2906,2907,3,4,1
2907,2907,2908,4,9,5
2908,2908,2909,9,5,-4
2909,2909,2910,5,2,-3
2910,2910,2911,2,8,6
2911,2911,2912,8,1,-7
2912,2912,2913,1,5,4
2913,2913,2914,5,3,-2
2914,2914,2915,3,7,4
2915,2915,2916,7,9,2
2916,2916,2917,9,4,-5
2917,2917,2918,4,2,-2
2918,2918,2919,2,5,3
2919,2919,2920,5,6,1
2920,2920,2921,6,3,-3
2921,2921,2922,3,5,2
2922,2922,2923,5,9,4
2923,2923,2924,9,3,-6
2924,2924,2925,3,5,2
2925,2925,2926,5,9,4
2926,2926,2927,9,3,-6
2927,2927,2928,3,1,-2
2928,2928,2929,1,9,8
2929,2929,2930,9,5,-4
2930,2930,2931,5,3,-2
2931,2931,2932,3,0,-3
2932,2932,2933,0,6,6
2933,2933,2934,6,9,3
2934,2934,2935,9,8,-1
2935,2935,2936,8,4,-4
2936,2936,2937,4,0,-4
2937,2937,2938,0,4,4
2938,2938,2939,4,9,5
2939,2939,2940,9,2,-7
2940,2940,2941,2,9,7
2941,2941,2942,9,0,-9
2942,2942,2943,0,1,1
2943,2943,2944,1,0,-1
2944,2944,2945,0,3,3
2945,2945,2946,3,1,-2
2946,2946,2947,1,6,5
2947,2947,2948,6,5,-1
2948,2948,2949,5,8,3
2949,2949,2950,8,1,-7
2950,2950,2951,1,5,4
2951,2951,2952,5,3,-2
2952,2952,2953,3,3,0
2953,2953,2954,3,0,-3
2954,2954,2955,0,3,3
2955,2955,2956,3,5,2
2956,2956,2957,5,5,0
2957,2957,2958,5,9,4
2958,2958,2959,9,2,-7
2959,2959,2960,2,8,6
2960,2960,2961,8,7,-1
2961,2961,2962,7,0,-7
2962,2962,2963,0,4,4
2963,2963,2964,4,9,5
2964,2964,2965,9,1,-8
2965,2965,2966,1,9,8
2966,2966,2967,9,7,-2
2967,2967,2968,7,7,0
2968,2968,2969,7,5,-2
2969,2969,2970,5,5,0
2970,2970,2971,5,2,-3
2971,2971,2972,2,0,-2
2972,2972,2973,0,9,9
2973,2973,2974,9,1,-8
2974,2974,2975,1,8,7
2975,2975,2976,8,6,-2
2976,2976,2977,6,2,-4
2977,2977,2978,2,3,1
2978,2978,2979,3,9,6
2979,2979,2980,9,6,-3
2980,2980,2981,6,2,-4
2981,2981,2982,2,1,-1
2982,2982,2983,1,9,8
2983,2983,2984,9,1,-8
2984,2984,2985,1,3,2
2985,2985,2986,3,5,2
2986,2986,2987,5,5,0
2987,2987,2988,5,0,-5
2988,2988,2989,0,3,3
2989,2989,2990,3,8,5
2990,2990,2991,8,3,-5
2991,2991,2992,3,3,0
2992,2992,2993,3,7,4
2993,2993,2994,7,6,-1
2994,2994,2995,6,6,0
2995,2995,2996,6,0,-6
2996,2996,2997,0,1,1
2997,2997,2998,1,4,3
2998,2998,2999,4,0,-4
2999,2999,3000,0,6,6
3000,3000,3001,6,9,3
3001,3001,3002,9,8,-1
3002,3002,3003,8,1,-7
3003,3003,3004,1,2,1
3004,3004,3005,2,9,7
3005,3005,3006,9,9,0
3006,3006,3007,9,5,-4
3007,3007,3008,5,9,4
3008,3008,3009,9,7,-2
3009,3009,3010,7,3,-4
3010,3010,3011,3,7,4
3011,3011,3012,7,8,1
3012,3012,3013,8,0,-8
3013,3013,3014,0,1,1
3014,3014,3015,1,3,2
3015,3015,3016,3,0,-3
3016,3016,3017,0,4,4
3017,3017,3018,4,6,2
3018,3018,3019,6,1,-5
3019,3019,3020,1,0,-1
3020,3020,3021,0,2,2
3021,3021,3022,2,5,3
3022,3022,3023,5,8,3
3023,3023,3024,8,4,-4
3024,3024,3025,4,4,0
3025,3025,3026,4,1,-3
3026,3026,3027,1,1,0
3027,3027,3028,1,5,4
3028,3028,3029,5,4,-1
3029,3029,3030,4,6,2
3030,3030,3031,6,6,0
3031,3031,3032,6,0,-6
3032,3032,3033,0,6,6
3033,3033,3034,6,9,3
3034,3034,3035,9,2,-7
3035,3035,3036,2,6,4
3036,3036,3037,6,2,-4
3037,3037,3038,2,7,5
3038,3038,3039,7,1,-6
3039,3039,3040,1,7,6
3040,3040,3041,7,9,2
3041,3041,3042,9,4,-5
3042,3042,3043,4,0,-4
3043,3043,3044,0,0,0
3044,3044,3045,0,3,3
3045,3045,3046,3,8,5
3046,3046,3047,8,2,-6
3047,3047,3048,2,2,0
3048,3048,3049,2,3,1
3049,3049,3050,3,1,-2
3050,3050,3051,1,6,5
3051,3051,3052,6,0,-6
3052,3052,3053,0,5,5
3053,3053,3054,5,7,2
3054,3054,3055,7,7,0
3055,3055,3056,7,9,2
3056,3056,3057,9,2,-7
3057,3057,3058,2,6,4
3058,3058,3059,6,7,1
3059,3059,3060,7,9,2
3060,3060,3061,9,7,-2
3061,3061,3062,7,8,1
3062,3062,3063,8,6,-2
3063,3063,3064,6,8,2
3064,3064,3065,8,8,0
3065,3065,3066,8,4,-4
3066,3066,3067,4,6,2
3067,3067,3068,6,8,2
3068,3068,3069,8,4,-4
3069,3069,3070,4,1,-3
3070,3070,3071,1,2,1
3071,3071,3072,2,8,6
3072,3072,3073,8,1,-7
3073,3073,3074,1,3,2
3074,3074,3075,3,9,6
3075,3075,3076,9,4,-5
3076,3076,3077,4,0,-4
3077,3077,3078,0,3,3
3078,3078,3079,3,7,4
3079,3079,3080,7,3,-4
3080,3080,3081,3,2,-1
3081,3081,3082,2,3,1
3082,3082,3083,3,3,0
3083,3083,3084,3,7,4
3084,3084,3085,7,3,-4
3085,3085,3086,3,4,1
3086,3086,3087,4,0,-4
3087,3087,3088,0,6,6
3088,3088,3089,6,2,-4
3089,3089,3090,2,0,-2
3090,3090,3091,0,8,8
3091,3091,3092,8,1,-7
3092,3092,3093,1,5,4
3093,3093,3094,5,3,-2
3094,3094,3095,3,5,2
3095,3095,3096,5,4,-1
3096,3096,3097,4,1,-3
3097,3097,3098,1,7,6
3098,3098,3099,7,1,-6
3099,3099,3100,1,5,4
3100,3100,3101,5,7,2
3101,3101,3102,7,5,-2
3102,3102,3103,5,7,2
3103,3103,3104,7,3,-4
3104,3104,3105,3,2,-1
3105,3105,3106,2,2,0
3106,3106,3107,2,7,5
3107,3107,3108,7,3,-4
3108,3108,3109,3,7,4
3109,3109,3110,7,3,-4
3110,3110,3111,3,7,4
3111,3111,3112,7,8,1
3112,3112,3113,8,5,-3
3113,3113,3114,5,4,-1
3114,3114,3115,4,5,1
3115,3115,3116,5,2,-3
3116,3116,3117,2,5,3
3117,3117,3118,5,6,1
3118,3118,3119,6,5,-1
3119,3119,3120,5,3,-2
3120,3120,3121,3,6,3
3121,3121,3122,6,7,1
3122,3122,3123,7,4,-3
3123,3123,3124,4,1,-3
3124,3124,3125,1,7,6
3125,3125,3126,7,1,-6
3126,3126,3127,1,5,4
3127,3127,3128,5,2,-3
3128,3128,3129,2,3,1
3129,3129,3130,3,6,3
3130,3130,3131,6,3,-3
3131,3131,3132,3,1,-2
3132,3132,3133,1,4,3
3133,3133,3134,4,2,-2
3134,3134,3135,2,6,4
3135,3135,3136,6,7,1
3136,3136,3137,7,4,-3
3137,3137,3138,4,3,-1
3138,3138,3139,3,8,5
3139,3139,3140,8,0,-8
3140,3140,3141,0,6,6
3141,3141,3142,6,2,-4
3142,3142,3143,2,1,-1
3143,3143,3144,1,6,5
3144,3144,3145,6,5,-1
3145,3145,3146,5,3,-2
3146,3146,3147,3,9,6
3147,3147,3148,9,1,-8
3148,3148,3149,1,9,8
3149,3149,3150,9,3,-6
3150,3150,3151,3,2,-1
3151,3151,3152,2,1,-1
3152,3152,3153,1,8,7
3153,3153,3154,8,4,-4
3154,3154,3155,4,4,0
3155,3155,3156,4,6,2
3156,3156,3157,6,5,-1
3157,3157,3158,5,8,3
3158,3158,3159,8,6,-2
3159,3159,3160,6,9,3
3160,3160,3161,9,7,-2
3161,3161,3162,7,7,0
3162,3162,3163,7,8,1
3163,3163,3164,8,6,-2
3164,3164,3165,6,9,3
3165,3165,3166,9,7,-2
3166,3166,3167,7,3,-4
3167,3167,3168,3,9,6
3168,3168,3169,9,4,-5
3169,3169,3170,4,0,-4
3170,3170,3171,0,5,5
3171,3171,3172,5,4,-1
3172,3172,3173,4,6,2
3173,3173,3174,6,4,-2
3174,3174,3175,4,1,-3
3175,3175,3176,1,2,1
3176,3176,3177,2,3,1
3177,3177,3178,3,0,-3
3178,3178,3179,0,0,0
3179,3179,3180,0,2,2
3180,3180,3181,2,6,4
3181,3181,3182,6,6,0
3182,3182,3183,6,5,-1
3183,3183,3184,5,7,2
3184,3184,3185,7,0,-7
3185,3185,3186,0,8,8
3186,3186,3187,8,6,-2
3187,3187,3188,6,4,-2
3188,3188,3189,4,7,3
3189,3189,3190,7,9,2
3190,3190,3191,9,0,-9
3191,3191,3192,0,7,7
3192,3192,3193,7,3,-4
3193,3193,3194,3,4,1
3194,3194,3195,4,2,-2
3195,3195,3196,2,1,-1
3196,3196,3197,1,8,7
3197,3197,3198,8,8,0
3198,3198,3199,8,5,-3
3199,3199,3200,5,9,4
3200,3200,3201,9,2,-7
3201,3201,3202,2,7,5
3202,3202,3203,7,1,-6
3203,3203,3204,1,8,7
3204,3204,3205,8,8,0
3205,3205,3206,8,8,0
3206,3206,3207,8,2,-6
3207,3207,3208,2,7,5
3208,3208,3209,7,6,-1
3209,3209,3210,6,0,-6
3210,3210,3211,0,1,1
3211,3211,3212,1,2,1
3212,3212,3213,2,7,5
3213,3213,3214,7,1,-6
3214,3214,3215,1,0,-1
3215,3215,3216,0,8,8
3216,3216,3217,8,3,-5
3217,3217,3218,3,6,3
3218,3218,3219,6,0,-6
3219,3219,3220,0,5,5
3220,3220,3221,5,3,-2
3221,3221,3222,3,6,3
3222,3222,3223,6,2,-4
3223,3223,3224,2,8,6
3224,3224,3225,8,7,-1
3225,3225,3226,7,0,-7
3226,3226,3227,0,1,1
3227,3227,3228,1,4,3
3228,3228,3229,4,2,-2
3229,3229,3230,2,1,-1
3230,3230,3231,1,1,0
3231,3231,3232,1,4,3
3232,3232,3233,4,4,0
3233,3233,3234,4,4,0
3234,3234,3235,4,4,0
3235,3235,3236,4,7,3
3236,3236,3237,7,1,-6
3237,3237,3238,1,6,5
3238,3238,3239,6,2,-4
3239,3239,3240,2,9,7
3240,3240,3241,9,9,0
3241,3241,3242,9,0,-9
3242,3242,3243,0,0,0
3243,3243,3244,0,1,1
3244,3244,3245,1,8,7
3245,3245,3246,8,8,0
3246,3246,3247,8,4,-4
3247,3247,3248,4,3,-1
3248,3248,3249,3,4,1
3249,3249,3250,4,2,-2
3250,3250,3251,2,0,-2
3251,3251,3252,0,6,6
3252,3252,3253,6,1,-5
3253,3253,3254,1,6,5
3254,3254,3255,6,1,-5
3255,3255,3256,1,2,1
3256,3256,3257,2,2,0
3257,3257,3258,2,2,0
3258,3258,3259,2,1,-1
3259,3259,3260,1,2,1
3260,3260,3261,2,3,1
3261,3261,3262,3,7,4
3262,3262,3263,7,8,1
3263,3263,3264,8,1,-7
3264,3264,3265,1,0,-1
3265,3265,3266,0,0,0
3266,3266,3267,0,2,2
3267,3267,3268,2,1,-1
3268,3268,3269,1,6,5
3269,3269,3270,6,6,0
3270,3270,3271,6,0,-6
3271,3271,3272,0,1,1
3272,3272,3273,1,6,5
3273,3273,3274,6,2,-4
3274,3274,3275,2,5,3
3275,3275,3276,5,1,-4
3276,3276,3277,1,7,6
3277,3277,3278,7,4,-3
3278,3278,3279,4,8,4
3279,3279,3280,8,2,-6
3280,3280,3281,2,1,-1
3281,3281,3282,1,4,3
3282,3282,3283,4,3,-1
3283,3283,3284,3,8,5
3284,3284,3285,8,3,-5
3285,3285,3286,3,9,6
3286,3286,3287,9,9,0
3287,3287,3288,9,4,-5
3288,3288,3289,4,8,4
3289,3289,3290,8,3,-5
3290,3290,3291,3,4,1
3291,3291,3292,4,7,3
3292,3292,3293,7,2,-5
3293,3293,3294,2,7,5
3294,3294,3295,7,5,-2
3295,3295,3296,5,7,2
3296,3296,3297,7,0,-7
3297,3297,3298,0,4,4
3298,3298,3299,4,3,-1
3299,3299,3300,3,3,0
3300,3300,3301,3,2,-1
3301,3301,3302,2,6,4
3302,3302,3303,6,7,1
3303,3303,3304,7,6,-1
3304,3304,3305,6,0,-6
3305,3305,3306,0,0,0
3306,3306,3307,0,6,6
3307,3307,3308,6,7,1
3308,3308,3309,7,7,0
3309,3309,3310,7,0,-7
3310,3310,3311,0,5,5
3311,3311,3312,5,5,0
3312,3312,3313,5,8,3
3313,3313,3314,8,1,-7
3314,3314,3315,1,0,-1
3315,3315,3316,0,7,7
3316,3316,3317,7,0,-7
3317,3317,3318,0,2,2
3318,3318,3319,2,8,6
3319,3319,3320,8,1,-7
3320,3320,3321,1,5,4
3321,3321,3322,5,0,-5
3322,3322,3323,0,8,8
3323,3323,3324,8,8,0
3324,3324,3325,8,0,-8
3325,3325,3326,0,3,3
3326,3326,3327,3,2,-1
3327,3327,3328,2,7,5
3328,3328,3329,7,7,0
3329,3329,3330,7,2,-5
3330,3330,3331,2,6,4
3331,3331,3332,6,4,-2
3332,3332,3333,4,7,3
3333,3333,3334,7,5,-2
3334,3334,3335,5,5,0
3335,3335,3336,5,5,0
3336,3336,3337,5,2,-3
3337,3337,3338,2,9,7
3338,3338,3339,9,2,-7
3339,3339,3340,2,8,6
3340,3340,3341,8,4,-4
3341,3341,3342,4,6,2
3342,3342,3343,6,8,2
3343,3343,3344,8,6,-2
3344,3344,3345,6,5,-1
3345,3345,3346,5,0,-5
3346,3346,3347,0,0,0
3347,3347,3348,0,8,8
3348,3348,3349,8,7,-1
3349,3349,3350,7,6,-1
3350,3350,3351,6,1,-5
3351,3351,3352,1,7,6
3352,3352,3353,7,1,-6
3353,3353,3354,1,1,0
3354,3354,3355,1,2,1
3355,3355,3356,2,7,5
3356,3356,3357,7,4,-3
3357,3357,3358,4,0,-4
3358,3358,3359,0,0,0
3359,3359,3360,0,7,7
3360,3360,3361,7,7,0
3361,3361,3362,7,6,-1
3362,3362,3363,6,3,-3
3363,3363,3364,3,8,5
3364,3364,3365,8,6,-2
3365,3365,3366,6,4,-2
3366,3366,3367,4,2,-2
3367,3367,3368,2,0,-2
3368,3368,3369,0,9,9
3369,3369,3370,9,4,-5
3370,3370,3371,4,0,-4
3371,3371,3372,0,5,5
3372,3372,3373,5,7,2
3373,3373,3374,7,8,1
3374,3374,3375,8,2,-6
3375,3375,3376,2,7,5
3376,3376,3377,7,4,-3
3377,3377,3378,4,7,3
3378,3378,3379,7,1,-6
3379,3379,3380,1,1,0
3380,3380,3381,1,3,2
3381,3381,3382,3,6,3
3382,3382,3383,6,6,0
3383,3383,3384,6,2,-4
3384,3384,3385,2,9,7
3385,3385,3386,9,1,-8
3386,3386,3387,1,9,8
3387,3387,3388,9,4,-5
3388,3388,3389,4,8,4
3389,3389,3390,8,3,-5
3390,3390,3391,3,6,3
3391,3391,3392,6,9,3
3392,3392,3393,9,5,-4
3393,3393,3394,5,9,4
3394,3394,3395,9,6,-3
3395,3395,3396,6,2,-4
3396,3396,3397,2,4,2
3397,3397,3398,4,6,2
3398,3398,3399,6,7,1
3399,3399,3400,7,7,0
3400,3400,3401,7,0,-7
3401,3401,3402,0,6,6
3402,3402,3403,6,6,0
3403,3403,3404,6,9,3
3404,3404,3405,9,4,-5
3405,3405,3406,4,8,4
3406,3406,3407,8,3,-5
3407,3407,3408,3,5,2
3408,3408,3409,5,3,-2
3409,3409,3410,3,4,1
3410,3410,3411,4,9,5
3411,3411,3412,9,0,-9
3412,3412,3413,0,0,0
3413,3413,3414,0,5,5
3414,3414,3415,5,2,-3
3415,3415,3416,2,5,3
3416,3416,3417,5,0,-5
3417,3417,3418,0,7,7
3418,3418,3419,7,1,-6
3419,3419,3420,1,1,0
3420,3420,3421,1,1,0
3421,3421,3422,1,6,5
3422,3422,3423,6,7,1
3423,3423,3424,7,6,-1
3424,3424,3425,6,7,1
3425,3425,3426,7,9,2
3426,3426,3427,9,6,-3
3427,3427,3428,6,6,0
3428,3428,3429,6,4,-2
3429,3429,3430,4,1,-3
3430,3430,3431,1,4,3
3431,3431,3432,4,3,-1
3432,3432,3433,3,1,-2
3433,3433,3434,1,1,0
3434,3434,3435,1,2,1
3435,3435,3436,2,2,0
3436,3436,3437,2,4,2
3437,3437,3438,4,1,-3
3438,3438,3439,1,0,-1
3439,3439,3440,0,8,8
3440,3440,3441,8,7,-1
3441,3441,3442,7,6,-1
3442,3442,3443,6,3,-3
3443,3443,3444,3,4,1
3444,3444,3445,4,0,-4
3445,3445,3446,0,0,0
3446,3446,3447,0,6,6
3447,3447,3448,6,3,-3
3448,3448,3449,3,3,0
3449,3449,3450,3,0,-3
3450,3450,3451,0,7,7
3451,3451,3452,7,1,-6
3452,3452,3453,1,7,6
3453,3453,3454,7,1,-6
3454,3454,3455,1,1,0
3455,3455,3456,1,3,2
3456,3456,3457,3,1,-2
3457,3457,3458,1,0,-1
3458,3458,3459,0,9,9
3459,3459,3460,9,9,0
3460,3460,3461,9,7,-2
3461,3461,3462,7,5,-2
3462,3462,3463,5,4,-1
3463,3463,3464,4,1,-3
3464,3464,3465,1,4,3
3465,3465,3466,4,8,4
3466,3466,3467,8,9,1
3467,3467,3468,9,5,-4
3468,3468,3469,5,3,-2
3469,3469,3470,3,5,2
3470,3470,3471,5,1,-4
3471,3471,3472,1,9,8
3472,3472,3473,9,8,-1
3473,3473,3474,8,2,-6
3474,3474,3475,2,3,1
3475,3475,3476,3,3,0
3476,3476,3477,3,9,6
3477,3477,3478,9,9,0
3478,3478,3479,9,0,-9
3479,3479,3480,0,1,1
3480,3480,3481,1,0,-1
3481,3481,3482,0,2,2
3482,3482,3483,2,9,7
3483,3483,3484,9,3,-6
3484,3484,3485,3,9,6
3485,3485,3486,9,3,-6
3486,3486,3487,3,3,0
3487,3487,3488,3,6,3
3488,3488,3489,6,2,-4
3489,3489,3490,2,4,2
3490,3490,3491,4,9,5
3491,3491,3492,9,8,-1
3492,3492,3493,8,3,-5
3493,3493,3494,3,7,4
3494,3494,3495,7,4,-3
3495,3495,3496,4,0,-4
3496,3496,3497,0,4,4
3497,3497,3498,4,7,3
3498,3498,3499,7,8,1
3499,3499,3500,8,4,-4
3500,3500,3501,4,9,5
3501,3501,3502,9,8,-1
3502,3502,3503,8,9,1
3503,3503,3504,9,9,0
3504,3504,3505,9,7,-2
3505,3505,3506,7,5,-2
3506,3506,3507,5,9,4
3507,3507,3508,9,2,-7
3508,3508,3509,2,8,6
3509,3509,3510,8,2,-6
3510,3510,3511,2,2,0
3511,3511,3512,2,0,-2
3512,3512,3513,0,2,2
3513,3513,3514,2,2,0
3514,3514,3515,2,3,1
3515,3515,3516,3,8,5
3516,3516,3517,8,4,-4
3517,3517,3518,4,6,2
3518,3518,3519,6,8,2
3519,3519,3520,8,6,-2
3520,3520,3521,6,8,2
3521,3521,3522,8,2,-6
3522,3522,3523,2,4,2
3523,3523,3524,4,6,2
3524,3524,3525,6,7,1
3525,3525,3526,7,9,2
3526,3526,3527,9,3,-6
3527,3527,3528,3,3,0
3528,3528,3529,3,9,6
3529,3529,3530,9,4,-5
3530,3530,3531,4,3,-1
3531,3531,3532,3,1,-2
3532,3532,3533,1,4,3
3533,3533,3534,4,4,0
3534,3534,3535,4,7,3
3535,3535,3536,7,0,-7
3536,3536,3537,0,5,5
3537,3537,3538,5,9,4
3538,3538,3539,9,6,-3
3539,3539,3540,6,0,-6
3540,3540,3541,0,4,4
3541,3541,3542,4,4,0
3542,3542,3543,4,4,0
3543,3543,3544,4,4,0
3544,3544,3545,4,6,2
3545,3545,3546,6,1,-5
3546,3546,3547,1,2,1
3547,3547,3548,2,3,1
3548,3548,3549,3,3,0
3549,3549,3550,3,6,3
3550,3550,3551,6,4,-2
3551,3551,3552,4,5,1
3552,3552,3553,5,9,4
3553,3553,3554,9,6,-3
3554,3554,3555,6,8,2
3555,3555,3556,8,5,-3
3556,3556,3557,5,6,1
3557,3557,3558,6,5,-1
3558,3558,3559,5,8,3
3559,3559,3560,8,6,-2
3560,3560,3561,6,4,-2
3561,3561,3562,4,1,-3
3562,3562,3563,1,8,7
3563,3563,3564,8,6,-2
3564,3564,3565,6,5,-1
3565,3565,3566,5,2,-3
3566,3566,3567,2,8,6
3567,3567,3568,8,4,-4
3568,3568,3569,4,5,1
3569,3569,3570,5,5,0
3570,3570,3571,5,4,-1
3571,3571,3572,4,7,3
3572,3572,3573,7,7,0
3573,3573,3574,7,0,-7
3574,3574,3575,0,7,7
3575,3575,3576,7,8,1
3576,3576,3577,8,2,-6
3577,3577,3578,2,2,0
3578,3578,3579,2,3,1
3579,3579,3580,3,7,4
3580,3580,3581,7,0,-7
3581,3581,3582,0,1,1
3582,3582,3583,1,8,7
3583,3583,3584,8,0,-8
3584,3584,3585,0,7,7
3585,3585,3586,7,1,-6
3586,3586,3587,1,9,8
3587,3587,3588,9,8,-1
3588,3588,3589,8,7,-1
3589,3589,3590,7,5,-2
3590,3590,3591,5,5,0
3591,3591,3592,5,9,4
3592,3592,3593,9,1,-8
3593,3593,3594,1,7,6
3594,3594,3595,7,5,-2
3595,3595,3596,5,4,-1
3596,3596,3597,4,9,5
3597,3597,3598,9,1,-8
3598,3598,3599,1,2,1
3599,3599,3600,2,2,0
3600,3600,3601,2,1,-1
3601,3601,3602,1,6,5
3602,3602,3603,6,6,0
3603,3603,3604,6,7,1
3604,3604,3605,7,1,-6
3605,3605,3606,1,1,0
3606,3606,3607,1,4,3
3607,3607,3608,4,0,-4
3608,3608,3609,0,7,7
3609,3609,3610,7,4,-3
3610,3610,3611,4,2,-2
3611,3611,3612,2,4,2
3612,3612,3613,4,0,-4
3613,3613,3614,0,6,6
3614,3614,3615,6,4,-2
3615,3615,3616,4,7,3
3616,3616,3617,7,6,-1
3617,3617,3618,6,9,3
3618,3618,3619,9,5,-4
3619,3619,3620,5,3,-2
3620,3620,3621,3,4,1
3621,3621,3622,4,6,2
3622,3622,3623,6,5,-1
3623,3623,3624,5,0,-5
3624,3624,3625,0,1,1
3625,3625,3626,1,8,7
3626,3626,3627,8,8,0
3627,3627,3628,8,2,-6
3628,3628,3629,2,8,6
3629,3629,3630,8,3,-5
3630,3630,3631,3,5,2
3631,3631,3632,5,7,2
3632,3632,3633,7,8,1
3633,3633,3634,8,0,-8
3634,3634,3635,0,8,8
3635,3635,3636,8,5,-3
3636,3636,3637,5,7,2
3637,3637,3638,7,1,-6
3638,3638,3639,1,1,0
3639,3639,3640,1,0,-1
3640,3640,3641,0,1,1
3641,3641,3642,1,3,2
3642,3642,3643,3,7,4
3643,3643,3644,7,8,1
3644,3644,3645,8,5,-3
3645,3645,3646,5,0,-5
3646,3646,3647,0,7,7
3647,3647,3648,7,1,-6
3648,3648,3649,1,1,0
3649,3649,3650,1,0,-1
3650,3650,3651,0,1,1
3651,3651,3652,1,1,0
3652,3652,3653,1,4,3
3653,3653,3654,4,5,1
3654,3654,3655,5,2,-3
3655,3655,3656,2,7,5
3656,3656,3657,7,6,-1
3657,3657,3658,6,2,-4
3658,3658,3659,2,3,1
3659,3659,3660,3,0,-3
3660,3660,3661,0,2,2
3661,3661,3662,2,8,6
3662,3662,3663,8,5,-3
3663,3663,3664,5,9,4
3664,3664,3665,9,6,-3
3665,3665,3666,6,9,3
3666,3666,3667,9,7,-2
3667,3667,3668,7,2,-5
3668,3668,3669,2,1,-1
3669,3669,3670,1,3,2
3670,3670,3671,3,6,3
3671,3671,3672,6,4,-2
3672,3672,3673,4,1,-3
3673,3673,3674,1,8,7
3674,3674,3675,8,2,-6
3675,3675,3676,2,4,2
3676,3676,3677,4,0,-4
3677,3677,3678,0,5,5
3678,3678,3679,5,1,-4
3679,3679,3680,1,0,-1
3680,3680,3681,0,2,2
3681,3681,3682,2,2,0
3682,3682,3683,2,6,4
3683,3683,3684,6,4,-2
3684,3684,3685,4,4,0
3685,3685,3686,4,3,-1
3686,3686,3687,3,9,6
3687,3687,3688,9,6,-3
3688,3688,3689,6,1,-5
3689,3689,3690,1,6,5
3690,3690,3691,6,5,-1
3691,3691,3692,5,7,2
3692,3692,3693,7,9,2
3693,3693,3694,9,2,-7
3694,3694,3695,2,0,-2
3695,3695,3696,0,2,2
3696,3696,3697,2,6,4
3697,3697,3698,6,0,-6
3698,3698,3699,0,1,1
3699,3699,3700,1,4,3
3700,3700,3701,4,3,-1
3701,3701,3702,3,5,2
3702,3702,3703,5,2,-3
3703,3703,3704,2,8,6
3704,3704,3705,8,8,0
3705,3705,3706,8,0,-8
3706,3706,3707,0,8,8
3707,3707,3708,8,8,0
3708,3708,3709,8,9,1
3709,3709,3710,9,0,-9
3710,3710,3711,0,9,9
3711,3711,3712,9,6,-3
3712,3712,3713,6,7,1
3713,3713,3714,7,6,-1
3714,3714,3715,6,3,-3
3715,3715,3716,3,9,6
3716,3716,3717,9,3,-6
3717,3717,3718,3,4,1
3718,3718,3719,4,7,3
3719,3719,3720,7,7,0
3720,3720,3721,7,7,0
3721,3721,3722,7,4,-3
3722,3722,3723,4,9,5
3723,3723,3724,9,0,-9
3724,3724,3725,0,6,6
3725,3725,3726,6,4,-2
3726,3726,3727,4,8,4
3727,3727,3728,8,4,-4
3728,3728,3729,4,2,-2
3729,3729,3730,2,7,5
3730,3730,3731,7,2,-5
3731,3731,3732,2,8,6
3732,3732,3733,8,1,-7
3733,3733,3734,1,0,-1
3734,3734,3735,0,0,0
3735,3735,3736,0,7,7
3736,3736,3737,7,8,1
3737,3737,3738,8,3,-5
3738,3738,3739,3,3,0
3739,3739,3740,3,3,0
3740,3740,3741,3,1,-2
3741,3741,3742,1,3,2
3742,3742,3743,3,7,4
3743,3743,3744,7,6,-1
3744,3744,3745,6,1,-5
3745,3745,3746,1,3,2
3746,3746,3747,3,1,-2
3747,3747,3748,1,6,5
3748,3748,3749,6,6,0
3749,3749,3750,6,5,-1
3750,3750,3751,5,7,2
3751,3751,3752,7,4,-3
3752,3752,3753,4,7,3
3753,3753,3754,7,5,-2
3754,3754,3755,5,9,4
3755,3755,3756,9,5,-4
3756,3756,3757,5,8,3
3757,3757,3758,8,4,-4
3758,3758,3759,4,9,5
3759,3759,3760,9,9,0
3760,3760,3761,9,1,-8
3761,3761,3762,1,6,5
3762,3762,3763,6,5,-1
3763,3763,3764,5,0,-5
3764,3764,3765,0,1,1
3765,3765,3766,1,3,2
3766,3766,3767,3,7,4
3767,3767,3768,7,0,-7
3768,3768,3769,0,3,3
3769,3769,3770,3,4,1
3770,3770,3771,4,8,4
3771,3771,3772,8,2,-6
3772,3772,3773,2,2,0
3773,3773,3774,2,0,-2
3774,3774,3775,0,2,2
3775,3775,3776,2,5,3
3776,3776,3777,5,1,-4
3777,3777,3778,1,5,4
3778,3778,3779,5,1,-4
3779,3779,3780,1,4,3
3780,3780,3781,4,8,4
3781,3781,3782,8,8,0
3782,3782,3783,8,9,1
3783,3783,3784,9,1,-8
3784,3784,3785,1,2,1
3785,3785,3786,2,1,-1
3786,3786,3787,1,3,2
3787,3787,3788,3,5,2
3788,3788,3789,5,1,-4
3789,3789,3790,1,0,-1
3790,3790,3791,0,9,9
3791,3791,3792,9,4,-5
3792,3792,3793,4,4,0
3793,3793,3794,4,8,4
3794,3794,3795,8,3,-5
3795,3795,3796,3,2,-1
3796,3796,3797,2,5,3
3797,3797,3798,5,9,4
3798,3798,3799,9,7,-2
3799,3799,3800,7,6,-1
3800,3800,3801,6,6,0
3801,3801,3802,6,2,-4
3802,3802,3803,2,0,-2
3803,3803,3804,0,0,0
3804,3804,3805,0,0,0
3805,3805,3806,0,5,5
3806,3806,3807,5,8,3
3807,3807,3808,8,7,-1
3808,3808,3809,7,1,-6
3809,3809,3810,1,5,4
3810,3810,3811,5,2,-3
3811,3811,3812,2,3,1
3812,3812,3813,3,8,5
3813,3813,3814,8,5,-3
3814,3814,3815,5,1,-4
3815,3815,3816,1,8,7
3816,3816,3817,8,2,-6
3817,3817,3818,2,0,-2
3818,3818,3819,0,4,4
3819,3819,3820,4,9,5
3820,3820,3821,9,9,0
3821,3821,3822,9,6,-3
3822,3822,3823,6,2,-4
3823,3823,3824,2,3,1
3824,3824,3825,3,3,0
3825,3825,3826,3,5,2
3826,3826,3827,5,6,1
3827,3827,3828,6,4,-2
3828,3828,3829,4,8,4
3829,3829,3830,8,0,-8
3830,3830,3831,0,9,9
3831,3831,3832,9,2,-7
3832,3832,3833,2,8,6
3833,3833,3834,8,3,-5
3834,3834,3835,3,6,3
3835,3835,3836,6,7,1
3836,3836,3837,7,5,-2
3837,3837,3838,5,7,2
3838,3838,3839,7,2,-5
3839,3839,3840,2,9,7
3840,3840,3841,9,4,-5
3841,3841,3842,4,9,5
3842,3842,3843,9,1,-8
3843,3843,3844,1,2,1
3844,3844,3845,2,8,6
3845,3845,3846,8,6,-2
3846,3846,3847,6,0,-6
3847,3847,3848,0,7,7
3848,3848,3849,7,0,-7
3849,3849,3850,0,9,9
3850,3850,3851,9,1,-8
3851,3851,3852,1,1,0
3852,3852,3853,1,6,5
3853,3853,3854,6,7,1
3854,3854,3855,7,5,-2
3855,3855,3856,5,9,4
3856,3856,3857,9,9,0
3857,3857,3858,9,1,-8
3858,3858,3859,1,9,8
3859,3859,3860,9,5,-4
3860,3860,3861,5,9,4
3861,3861,3862,9,2,-7
3862,3862,3863,2,5,3
3863,3863,3864,5,0,-5
3864,3864,3865,0,4,4
3865,3865,3866,4,1,-3
3866,3866,3867,1,0,-1
3867,3867,3868,0,8,8
3868,3868,3869,8,9,1
3869,3869,3870,9,0,-9
3870,3870,3871,0,8,8
3871,3871,3872,8,9,1
3872,3872,3873,9,8,-1
3873,3873,3874,8,9,1
3874,3874,3875,9,4,-5
3875,3875,3876,4,2,-2
3876,3876,3877,2,5,3
3877,3877,3878,5,7,2
3878,3878,3879,7,9,2
3879,3879,3880,9,8,-1
3880,3880,3881,8,9,1
3881,3881,3882,9,8,-1
3882,3882,3883,8,0,-8
3883,3883,3884,0,9,9
3884,3884,3885,9,9,0
3885,3885,3886,9,6,-3
3886,3886,3887,6,8,2
3887,3887,3888,8,9,1
3888,3888,3889,9,9,0
3889,3889,3890,9,5,-4
3890,3890,3891,5,9,4
3891,3891,3892,9,8,-1
3892,3892,3893,8,5,-3
3893,3893,3894,5,1,-4
3894,3894,3895,1,0,-1
3895,3895,3896,0,3,3
3896,3896,3897,3,3,0
3897,3897,3898,3,5,2
3898,3898,3899,5,2,-3
3899,3899,3900,2,1,-1
3900,3900,3901,1,6,5
3901,3901,3902,6,5,-1
3902,3902,3903,5,0,-5
3903,3903,3904,0,2,2
3904,3904,3905,2,8,6
3905,3905,3906,8,1,-7
3906,3906,3907,1,5,4
3907,3907,3908,5,6,1
3908,3908,3909,6,2,-4
3909,3909,3910,2,3,1
3910,3910,3911,3,0,-3
3911,3911,3912,0,2,2
3912,3912,3913,2,2,0
3913,3913,3914,2,6,4
3914,3914,3915,6,4,-2
3915,3915,3916,4,3,-1
3916,3916,3917,3,5,2
3917,3917,3918,5,5,0
3918,3918,3919,5,1,-4
3919,3919,3920,1,7,6
3920,3920,3921,7,2,-5
3921,3921,3922,2,1,-1
3922,3922,3923,1,6,5
3923,3923,3924,6,9,3
3924,3924,3925,9,1,-8
3925,3925,3926,1,9,8
3926,3926,3927,9,9,0
3927,3927,3928,9,5,-4
3928,3928,3929,5,5,0
3929,3929,3930,5,1,-4
3930,3930,3931,1,6,5
3931,3931,3932,6,2,-4
3932,3932,3933,2,2,0
3933,3933,3934,2,8,6
3934,3934,3935,8,6,-2
3935,3935,3936,6,7,1
3936,3936,3937,7,1,-6
3937,3937,3938,1,4,3
3938,3938,3939,4,6,2
3939,3939,3940,6,0,-6
3940,3940,3941,0,4,4
3941,3941,3942,4,0,-4
3942,3942,3943,0,3,3
3943,3943,3944,3,3,0
3944,3944,3945,3,2,-1
3945,3945,3946,2,2,0
3946,3946,3947,2,3,1
3947,3947,3948,3,6,3
3948,3948,3949,6,8,2
3949,3949,3950,8,9,1
3950,3950,3951,9,8,-1
3951,3951,3952,8,5,-3
3952,3952,3953,5,3,-2
3953,3953,3954,3,8,5
3954,3954,3955,8,5,-3
3955,3955,3956,5,4,-1
3956,3956,3957,4,5,1
3957,3957,3958,5,2,-3
3958,3958,3959,2,0,-2
3959,3959,3960,0,5,5
3960,3960,3961,5,6,1
3961,3961,3962,6,3,-3
3962,3962,3963,3,2,-1
3963,3963,3964,2,8,6
3964,3964,3965,8,3,-5
3965,3965,3966,3,9,6
3966,3966,3967,9,9,0
3967,3967,3968,9,5,-4
3968,3968,3969,5,7,2
3969,3969,3970,7,9,2
3970,3970,3971,9,4,-5
3971,3971,3972,4,6,2
3972,3972,3973,6,7,1
3973,3973,3974,7,1,-6
3974,3974,3975,1,3,2
3975,3975,3976,3,7,4
3976,3976,3977,7,3,-4
3977,3977,3978,3,6,3
3978,3978,3979,6,6,0
3979,3979,3980,6,0,-6
3980,3980,3981,0,9,9
3981,3981,3982,9,0,-9
3982,3982,3983,0,1,1
3983,3983,3984,1,9,8
3984,3984,3985,9,9,0
3985,3985,3986,9,2,-7
3986,3986,3987,2,8,6
3987,3987,3988,8,8,0
3988,3988,3989,8,0,-8
3989,3989,3990,0,1,1
3990,3990,3991,1,6,5
3991,3991,3992,6,9,3
3992,3992,3993,9,7,-2
3993,3993,3994,7,5,-2
3994,3994,3995,5,3,-2
3995,3995,3996,3,4,1
3996,3996,3997,4,7,3
3997,3997,3998,7,4,-3
3998,3998,3999,4,9,5
3999,3999,4000,9,9,0
4000,4000,4001,9,4,-5
4001,4001,4002,4,3,-1
4002,4002,4003,3,6,3
4003,4003,4004,6,3,-3
4004,4004,4005,3,1,-2
4005,4005,4006,1,1,0
4006,4006,4007,1,7,6
4007,4007,4008,7,6,-1
4008,4008,4009,6,9,3
4009,4009,4010,9,1,-8
4010,4010,4011,1,8,7
4011,4011,4012,8,4,-4
4012,4012,4013,4,1,-3
4013,4013,4014,1,1,0
4014,4014,4015,1,9,8
4015,4015,4016,9,9,0
4016,4016,4017,9,4,-5
4017,4017,4018,4,3,-1
4018,4018,4019,3,6,3
4019,4019,4020,6,8,2
4020,4020,4021,8,1,-7
4021,4021,4022,1,6,5
4022,4022,4023,6,0,-6
4023,4023,4024,0,4,4
4024,4024,4025,4,1,-3
4025,4025,4026,1,3,2
4026,4026,4027,3,7,4
4027,4027,4028,7,7,0
4028,4028,4029,7,4,-3
4029,4029,4030,4,9,5
4030,4030,4031,9,5,-4
4031,4031,4032,5,1,-4
4032,4032,4033,1,0,-1
4033,4033,4034,0,0,0
4034,4034,4035,0,1,1
4035,4035,4036,1,1,0
4036,4036,4037,1,6,5
4037,4037,4038,6,2,-4
4038,4038,4039,2,1,-1
4039,4039,4040,1,9,8
4040,4040,4041,9,8,-1
4041,4041,4042,8,4,-4
4042,4042,4043,4,0,-4
4043,4043,4044,0,3,3
4044,4044,4045,3,6,3
4045,4045,4046,6,4,-2
4046,4046,4047,4,9,5
4047,4047,4048,9,0,-9
4048,4048,4049,0,7,7
4049,4049,4050,7,1,-6
4050,4050,4051,1,6,5
4051,4051,4052,6,5,-1
4052,4052,4053,5,7,2
4053,4053,4054,7,5,-2
4054,4054,4055,5,2,-3
4055,4055,4056,2,5,3
4056,4056,4057,5,1,-4
4057,4057,4058,1,8,7
4058,4058,4059,8,5,-3
4059,4059,4060,5,4,-1
4060,4060,4061,4,7,3
4061,4061,4062,7,0,-7
4062,4062,4063,0,6,6
4063,4063,4064,6,7,1
4064,4064,4065,7,0,-7
4065,4065,4066,0,2,2
4066,4066,4067,2,5,3
4067,4067,4068,5,8,3
4068,4068,4069,8,1,-7
4069,4069,4070,1,0,-1
4070,4070,4071,0,4,4
4071,4071,4072,4,5,1
4072,4072,4073,5,7,2
4073,4073,4074,7,1,-6
4074,4074,4075,1,8,7
4075,4075,4076,8,5,-3
4076,4076,4077,5,1,-4
4077,4077,4078,1,9,8
4078,4078,4079,9,0,-9
4079,4079,4080,0,0,0
4080,4080,4081,0,6,6
4081,4081,4082,6,0,-6
4082,4082,4083,0,7,7
4083,4083,4084,7,3,-4
4084,4084,4085,3,1,-2
4085,4085,4086,1,8,7
4086,4086,4087,8,3,-5
4087,4087,4088,3,9,6
4088,4088,4089,9,7,-2
4089,4089,4090,7,0,-7
4090,4090,4091,0,0,0
4091,4091,4092,0,8,8
4092,4092,4093,8,9,1
4093,4093,4094,9,5,-4
4094,4094,4095,5,9,4
4095,4095,4096,9,8,-1
4096,4096,4097,8,3,-5
4097,4097,4098,3,2,-1
4098,4098,4099,2,7,5
4099,4099,4100,7,2,-5
4100,4100,4101,2,9,7
4101,4101,4102,9,7,-2
4102,4102,4103,7,2,-5
4103,4103,4104,2,1,-1
4104,4104,4105,1,1,0
4105,4105,4106,1,3,2
4106,4106,4107,3,7,4
4107,4107,4108,7,5,-2
4108,4108,4109,5,3,-2
4109,4109,4110,3,1,-2
4110,4110,4111,1,9,8
4111,4111,4112,9,8,-1
4112,4112,4113,8,2,-6
4113,4113,4114,2,2,0
4114,4114,4115,2,2,0
4115,4115,4116,2,8,6
4116,4116,4117,8,8,0
4117,4117,4118,8,5,-3
4118,4118,4119,5,7,2
4119,4119,4120,7,3,-4
4120,4120,4121,3,8,5
4121,4121,4122,8,9,1
4122,4122,4123,9,8,-1
4123,4123,4124,8,8,0
4124,4124,4125,8,6,-2
4125,4125,4126,6,8,2
4126,4126,4127,8,2,-6
4127,4127,4128,2,3,1
4128,4128,4129,3,9,6
4129,4129,4130,9,7,-2
4130,4130,4131,7,5,-2
4131,4131,4132,5,6,1
4132,4132,4133,6,2,-4
4133,4133,4134,2,9,7
4134,4134,4135,9,2,-7
4135,4135,4136,2,8,6
4136,4136,4137,8,8,0
4137,4137,4138,8,1,-7
4138,4138,4139,1,6,5
4139,4139,4140,6,8,2
4140,4140,4141,8,8,0
4141,4141,4142,8,7,-1
4142,4142,4143,7,9,2
4143,4143,4144,9,1,-8
4144,4144,4145,1,8,7
4145,4145,4146,8,0,-8
4146,4146,4147,0,1,1
4147,4147,4148,1,7,6
4148,4148,4149,7,2,-5
4149,4149,4150,2,0,-2
4150,4150,4151,0,7,7
4151,4151,4152,7,5,-2
4152,4152,4153,5,1,-4
4153,4153,4154,1,9,8
4154,4154,4155,9,0,-9
4155,4155,4156,0,2,2
4156,4156,4157,2,0,-2
4157,4157,4158,0,9,9
4158,4158,4159,9,8,-1
4159,4159,4160,8,6,-2
4160,4160,4161,6,2,-4
4161,4161,4162,2,3,1
4162,4162,4163,3,9,6
4163,4163,4164,9,3,-6
4164,4164,4165,3,8,5
4165,4165,4166,8,0,-8
4166,4166,4167,0,2,2
4167,4167,4168,2,1,-1
4168,4168,4169,1,1,0
4169,4169,4170,1,1,0
4170,4170,4171,1,1,0
4171,4171,4172,1,4,3
4172,4172,4173,4,2,-2
4173,4173,4174,2,9,7
4174,4174,4175,9,7,-2
4175,4175,4176,7,2,-5
4176,4176,4177,2,5,3
4177,4177,4178,5,1,-4
4178,4178,4179,1,1,0
4179,4179,4180,1,2,1
4180,4180,4181,2,1,-1
4181,4181,4182,1,9,8
4182,4182,4183,9,9,0
4183,4183,4184,9,9,0
4184,4184,4185,9,1,-8
4185,4185,4186,1,0,-1
4186,4186,4187,0,2,2
4187,4187,4188,2,0,-2
4188,4188,4189,0,2,2
4189,4189,4190,2,1,-1
4190,4190,4191,1,1,0
4191,4191,4192,1,4,3
4192,4192,4193,4,6,2
4193,4193,4194,6,4,-2
4194,4194,4195,4,1,-3
4195,4195,4196,1,5,4
4196,4196,4197,5,4,-1
4197,4197,4198,4,9,5
4198,4198,4199,9,7,-2
4199,4199,4200,7,7,0
4200,4200,4201,7,1,-6
4201,4201,4202,1,5,4
4202,4202,4203,5,6,1
4203,4203,4204,6,2,-4
4204,4204,4205,2,2,0
4205,4205,4206,2,2,0
4206,4206,4207,2,8,6
4207,4207,4208,8,0,-8
4208,4208,4209,0,6,6
4209,4209,4210,6,9,3
4210,4210,4211,9,6,-3
4211,4211,4212,6,1,-5
4212,4212,4213,1,9,8
4213,4213,4214,9,7,-2
4214,4214,4215,7,7,0
4215,4215,4216,7,1,-6
4216,4216,4217,1,4,3
4217,4217,4218,4,8,4
4218,4218,4219,8,5,-3
4219,4219,4220,5,3,-2
4220,4220,4221,3,4,1
4221,4221,4222,4,3,-1
4222,4222,4223,3,4,1
4223,4223,4224,4,9,5
4224,4224,4225,9,7,-2
4225,4225,4226,7,5,-2
4226,4226,4227,5,0,-5
4227,4227,4228,0,7,7
4228,4228,4229,7,4,-3
4229,4229,4230,4,8,4
4230,4230,4231,8,8,0
4231,4231,4232,8,1,-7
4232,4232,4233,1,5,4
4233,4233,4234,5,3,-2
4234,4234,4235,3,9,6
4235,4235,4236,9,5,-4
4236,4236,4237,5,9,4
4237,4237,4238,9,7,-2
4238,4238,4239,7,6,-1
4239,4239,4240,6,9,3
4240,4240,4241,9,0,-9
4241,4241,4242,0,3,3
4242,4242,4243,3,6,3
4243,4243,4244,6,3,-3
4244,4244,4245,3,9,6
4245,4245,4246,9,8,-1
4246,4246,4247,8,2,-6
4247,4247,4248,2,2,0
4248,4248,4249,2,1,-1
4249,4249,4250,1,2,1
4250,4250,4251,2,8,6
4251,4251,4252,8,6,-2
4252,4252,4253,6,8,2
4253,4253,4254,8,5,-3
4254,4254,4255,5,5,0
4255,4255,4256,5,3,-2
4256,4256,4257,3,9,6
4257,4257,4258,9,4,-5
4258,4258,4259,4,9,5
4259,4259,4260,9,2,-7
4260,4260,4261,2,5,3
4261,4261,4262,5,1,-4
4262,4262,4263,1,5,4
4263,4263,4264,5,1,-4
4264,4264,4265,1,4,3
4265,4265,4266,4,4,0
4266,4266,4267,4,1,-3
4267,4267,4268,1,4,3
4268,4268,4269,4,4,0
4269,4269,4270,4,3,-1
4270,4270,4271,3,5,2
4271,4271,4272,5,9,4
4272,4272,4273,9,1,-8
4273,4273,4274,1,2,1
4274,4274,4275,2,2,0
4275,4275,4276,2,3,1
4276,4276,4277,3,3,0
4277,4277,4278,3,0,-3
4278,4278,4279,0,2,2
4279,4279,4280,2,9,7
4280,4280,4281,9,0,-9
4281,4281,4282,0,0,0
4282,4282,4283,0,9,9
4283,4283,4284,9,9,0
4284,4284,4285,9,6,-3
4285,4285,4286,6,0,-6
4286,4286,4287,0,9,9
4287,4287,4288,9,3,-6
4288,4288,4289,3,2,-1
4289,4289,4290,2,8,6
4290,4290,4291,8,4,-4
4291,4291,4292,4,1,-3
4292,4292,4293,1,9,8
4293,4293,4294,9,9,0
4294,4294,4295,9,7,-2
4295,4295,4296,7,2,-5
4296,4296,4297,2,7,5
4297,4297,4298,7,9,2
4298,4298,4299,9,9,0
4299,4299,4300,9,5,-4
4300,4300,4301,5,9,4
4301,4301,4302,9,5,-4
4302,4302,4303,5,1,-4
4303,4303,4304,1,1,0
4304,4304,4305,1,8,7
4305,4305,4306,8,3,-5
4306,4306,4307,3,5,2
4307,4307,4308,5,1,-4
4308,4308,4309,1,9,8
4309,4309,4310,9,5,-4
4310,4310,4311,5,3,-2
4311,4311,4312,3,5,2
4312,4312,4313,5,4,-1
4313,4313,4314,4,9,5
4314,4314,4315,9,5,-4
4315,4315,4316,5,9,4
4316,4316,4317,9,3,-6
4317,4317,4318,3,1,-2
4318,4318,4319,1,9,8
4319,4319,4320,9,0,-9
4320,4320,4321,0,9,9
4321,4321,4322,9,7,-2
4322,4322,4323,7,5,-2
4323,4323,4324,5,4,-1
4324,4324,4325,4,9,5
4325,4325,4326,9,2,-7
4326,4326,4327,2,0,-2
4327,4327,4328,0,1,1
4328,4328,4329,1,0,-1
4329,4329,4330,0,5,5
4330,4330,4331,5,1,-4
4331,4331,4332,1,4,3
4332,4332,4333,4,9,5
4333,4333,4334,9,3,-6
4334,4334,4335,3,3,0
4335,4335,4336,3,6,3
4336,4336,4337,6,1,-5
4337,4337,4338,1,5,4
4338,4338,4339,5,2,-3
4339,4339,4340,2,5,3
4340,4340,4341,5,2,-3
4341,4341,4342,2,2,0
4342,4342,4343,2,0,-2
4343,4343,4344,0,9,9
4344,4344,4345,9,2,-7
4345,4345,4346,2,6,4
4346,4346,4347,6,6,0
4347,4347,4348,6,0,-6
4348,4348,4349,0,1,1
4349,4349,4350,1,2,1
4350,4350,4351,2,0,-2
4351,4351,4352,0,3,3
4352,4352,4353,3,0,-3
4353,4353,4354,0,2,2
4354,4354,4355,2,5,3
4355,4355,4356,5,5,0
4356,4356,4357,5,7,2
4357,4357,4358,7,9,2
4358,4358,4359,9,5,-4
4359,4359,4360,5,5,0
4360,4360,4361,5,0,-5
4361,4361,4362,0,8,8
4362,4362,4363,8,9,1
4363,4363,4364,9,5,-4
4364,4364,4365,5,0,-5
4365,4365,4366,0,3,3
4366,4366,4367,3,2,-1
4367,4367,4368,2,5,3
4368,4368,4369,5,9,4
4369,4369,4370,9,0,-9
4370,4370,4371,0,8,8
4371,4371,4372,8,8,0
4372,4372,4373,8,4,-4
4373,4373,4374,4,5,1
4374,4374,4375,5,8,3
4375,4375,4376,8,8,0
4376,4376,4377,8,4,-4
4377,4377,4378,4,5,1
4378,4378,4379,5,4,-1
4379,4379,4380,4,8,4
4380,4380,4381,8,5,-3
4381,4381,4382,5,4,-1
4382,4382,4383,4,9,5
4383,4383,4384,9,2,-7
4384,4384,4385,2,2,0
4385,4385,4386,2,1,-1
4386,4386,4387,1,2,1
4387,4387,4388,2,6,4
4388,4388,4389,6,8,2
4389,4389,4390,8,8,0
4390,4390,4391,8,7,-1
4391,4391,4392,7,0,-7
4392,4392,4393,0,3,3
4393,4393,4394,3,6,3
4394,4394,4395,6,6,0
4395,4395,4396,6,4,-2
4396,4396,4397,4,3,-1
4397,4397,4398,3,8,5
4398,4398,4399,8,8,0
4399,4399,4400,8,7,-1
4400,4400,4401,7,2,-5
4401,4401,4402,2,2,0
4402,4402,4403,2,0,-2
4403,4403,4404,0,0,0
4404,4404,4405,0,9,9
4405,4405,4406,9,3,-6
4406,4406,4407,3,9,6
4407,4407,4408,9,9,0
4408,4408,4409,9,1,-8
4409,4409,4410,1,9,8
4410,4410,4411,9,8,-1
4411,4411,4412,8,6,-2
4412,4412,4413,6,6,0
4413,4413,4414,6,4,-2
4414,4414,4415,4,2,-2
4415,4415,4416,2,6,4
4416,4416,4417,6,9,3
4417,4417,4418,9,2,-7
4418,4418,4419,2,8,6
4419,4419,4420,8,5,-3
4420,4420,4421,5,4,-1
4421,4421,4422,4,5,1
4422,4422,4423,5,7,2
4423,4423,4424,7,9,2
4424,4424,4425,9,9,0
4425,4425,4426,9,9,0
4426,4426,4427,9,2,-7
4427,4427,4428,2,1,-1
4428,4428,4429,1,8,7
4429,4429,4430,8,3,-5
4430,4430,4431,3,4,1
4431,4431,4432,4,0,-4
4432,4432,4433,0,7,7
4433,4433,4434,7,8,1
4434,4434,4435,8,3,-5
4435,4435,4436,3,9,6
4436,4436,4437,9,3,-6
4437,4437,4438,3,4,1
4438,4438,4439,4,6,2
4439,4439,4440,6,5,-1
4440,4440,4441,5,6,1
4441,4441,4442,6,2,-4
4442,4442,4443,2,3,1
4443,4443,4444,3,9,6
4444,4444,4445,9,2,-7
4445,4445,4446,2,6,4
4446,4446,4447,6,0,-6
4447,4447,4448,0,0,0
4448,4448,4449,0,6,6
4449,4449,4450,6,1,-5
4450,4450,4451,1,2,1
4451,4451,4452,2,8,6
4452,4452,4453,8,7,-1
4453,4453,4454,7,9,2
4454,4454,4455,9,8,-1
4455,4455,4456,8,2,-6
4456,4456,4457,2,0,-2
4457,4457,4458,0,4,4
4458,4458,4459,4,7,3
4459,4459,4460,7,7,0
4460,4460,4461,7,5,-2
4461,4461,4462,5,0,-5
4462,4462,4463,0,5,5
4463,4463,4464,5,6,1
4464,4464,4465,6,4,-2
4465,4465,4466,4,6,2
4466,4466,4467,6,7,1
4467,4467,4468,7,4,-3
4468,4468,4469,4,3,-1
4469,4469,4470,3,0,-3
4470,4470,4471,0,7,7
4471,4471,4472,7,5,-2
4472,4472,4473,5,0,-5
4473,4473,4474,0,7,7
4474,4474,4475,7,4,-3
4475,4475,4476,4,2,-2
4476,4476,4477,2,0,-2
4477,4477,4478,0,8,8
4478,4478,4479,8,9,1
4479,4479,4480,9,9,0
4480,4480,4481,9,4,-5
4481,4481,4482,4,2,-2
4482,4482,4483,2,4,2
4483,4483,4484,4,6,2
4484,4484,4485,6,7,1
4485,4485,4486,7,8,1
4486,4486,4487,8,7,-1
4487,4487,4488,7,6,-1
4488,4488,4489,6,9,3
4489,4489,4490,9,4,-5
4490,4490,4491,4,1,-3
4491,4491,4492,1,3,2
4492,4492,4493,3,7,4
4493,4493,4494,7,3,-4
4494,4494,4495,3,0,-3
4495,4495,4496,0,8,8
4496,4496,4497,8,8,0
4497,4497,4498,8,7,-1
4498,4498,4499,7,6,-1
4499,4499,4500,6,9,3
4500,4500,4501,9,3,-6
4501,4501,4502,3,9,6
4502,4502,4503,9,2,-7
4503,4503,4504,2,2,0
4504,4504,4505,2,9,7
4505,4505,4506,9,2,-7
4506,4506,4507,2,1,-1
4507,4507,4508,1,8,7
4508,4508,4509,8,3,-5
4509,4509,4510,3,2,-1
4510,4510,4511,2,9,7
4511,4511,4512,9,6,-3
4512,4512,4513,6,8,2
4513,4513,4514,8,4,-4
4514,4514,4515,4,0,-4
4515,4515,4516,0,1,1
4516,4516,4517,1,2,1
4517,4517,4518,2,8,6
4518,4518,4519,8,4,-4
4519,4519,4520,4,5,1
4520,4520,4521,5,2,-3
4521,4521,4522,2,7,5
4522,4522,4523,7,8,1
4523,4523,4524,8,1,-7
4524,4524,4525,1,1,0
4525,4525,4526,1,3,2
4526,4526,4527,3,0,-3
4527,4527,4528,0,3,3
4528,4528,4529,3,5,2
4529,4529,4530,5,7,2
4530,4530,4531,7,0,-7
4531,4531,4532,0,3,3
4532,4532,4533,3,1,-2
4533,4533,4534,1,9,8
4534,4534,4535,9,3,-6
4535,4535,4536,3,6,3
4536,4536,4537,6,3,-3
4537,4537,4538,3,1,-2
4538,4538,4539,1,7,6
4539,4539,4540,7,7,0
4540,4540,4541,7,3,-4
4541,4541,4542,3,0,-3
4542,4542,4543,0,8,8
4543,4543,4544,8,4,-4
4544,4544,4545,4,8,4
4545,4545,4546,8,2,-6
4546,4546,4547,2,6,4
4547,4547,4548,6,5,-1
4548,4548,4549,5,2,-3
4549,4549,4550,2,9,7
4550,4550,4551,9,7,-2
4551,4551,4552,7,3,-4
4552,4552,4553,3,9,6
4553,4553,4554,9,0,-9
4554,4554,4555,0,9,9
4555,4555,4556,9,9,0
4556,4556,4557,9,6,-3
4557,4557,4558,6,4,-2
4558,4558,4559,4,2,-2
4559,4559,4560,2,9,7
4560,4560,4561,9,7,-2
4561,4561,4562,7,2,-5
4562,4562,4563,2,1,-1
4563,4563,4564,1,1,0
4564,4564,4565,1,6,5
4565,4565,4566,6,7,1
4566,4566,4567,7,4,-3
4567,4567,4568,4,7,3
4568,4568,4569,7,5,-2
4569,4569,4570,5,9,4
4570,4570,4571,9,6,-3
4571,4571,4572,6,8,2
4572,4572,4573,8,2,-6
4573,4573,4574,2,1,-1
4574,4574,4575,1,4,3
4575,4575,4576,4,4,0
4576,4576,4577,4,5,1
4577,4577,4578,5,7,2
4578,4578,4579,7,6,-1
4579,4579,4580,6,1,-5
4580,4580,4581,1,3,2
4581,4581,4582,3,2,-1
4582,4582,4583,2,5,3
4583,4583,4584,5,9,4
4584,4584,4585,9,9,0
4585,4585,4586,9,3,-6
4586,4586,4587,3,6,3
4587,4587,4588,6,1,-5
4588,4588,4589,1,1,0
4589,4589,4590,1,4,3
4590,4590,4591,4,6,2
4591,4591,4592,6,9,3
4592,4592,4593,9,7,-2
4593,4593,4594,7,2,-5
4594,4594,4595,2,1,-1
4595,4595,4596,1,5,4
4596,4596,4597,5,1,-4
4597,4597,4598,1,4,3
4598,4598,4599,4,6,2
4599,4599,4600,6,3,-3
4600,4600,4601,3,8,5
4601,4601,4602,8,1,-7
4602,4602,4603,1,1,0
4603,4603,4604,1,0,-1
4604,4604,4605,0,3,3
4605,4605,4606,3,1,-2
4606,4606,4607,1,6,5
4607,4607,4608,6,8,2
4608,4608,4609,8,4,-4
4609,4609,4610,4,9,5
4610,4610,4611,9,0,-9
4611,4611,4612,0,7,7
4612,4612,4613,7,3,-4
4613,4613,4614,3,0,-3
4614,4614,4615,0,2,2
4615,4615,4616,2,9,7
4616,4616,4617,9,0,-9
4617,4617,4618,0,6,6
4618,4618,4619,6,6,0
4619,4619,4620,6,6,0
4620,4620,4621,6,3,-3
4621,4621,4622,3,6,3
4622,4622,4623,6,7,1
4623,4623,4624,7,7,0
4624,4624,4625,7,2,-5
4625,4625,4626,2,8,6
4626,4626,4627,8,6,-2
4627,4627,4628,6,0,-6
4628,4628,4629,0,8,8
4629,4629,4630,8,3,-5
4630,4630,4631,3,0,-3
4631,4631,4632,0,2,2
4632,4632,4633,2,9,7
4633,4633,4634,9,8,-1
4634,4634,4635,8,3,-5
4635,4635,4636,3,2,-1
4636,4636,4637,2,5,3
4637,4637,4638,5,3,-2
4638,4638,4639,3,8,5
4639,4639,4640,8,8,0
4640,4640,4641,8,0,-8
4641,4641,4642,0,0,0
4642,4642,4643,0,1,1
4643,4643,4644,1,9,8
4644,4644,4645,9,5,-4
4645,4645,4646,5,1,-4
4646,4646,4647,1,3,2
4647,4647,4648,3,9,6
4648,4648,4649,9,6,-3
4649,4649,4650,6,0,-6
4650,4650,4651,0,1,1
4651,4651,4652,1,4,3
4652,4652,4653,4,1,-3
4653,4653,4654,1,7,6
4654,4654,4655,7,1,-6
4655,4655,4656,1,2,1
4656,4656,4657,2,3,1
4657,4657,4658,3,7,4
4658,4658,4659,7,9,2
4659,4659,4660,9,7,-2
4660,4660,4661,7,4,-3
4661,4661,4662,4,9,5
4662,4662,4663,9,9,0
4663,4663,4664,9,3,-6
4664,4664,4665,3,9,6
4665,4665,4666,9,2,-7
4666,4666,4667,2,8,6
4667,4667,4668,8,2,-6
4668,4668,4669,2,7,5
4669,4669,4670,7,1,-6
4670,4670,4671,1,8,7
4671,4671,4672,8,0,-8
4672,4672,4673,0,9,9
4673,4673,4674,9,1,-8
4674,4674,4675,1,0,-1
4675,4675,4676,0,1,1
4676,4676,4677,1,7,6
4677,4677,4678,7,7,0
4678,4678,4679,7,9,2
4679,4679,4680,9,6,-3
4680,4680,4681,6,9,3
4681,4681,4682,9,9,0
4682,4682,4683,9,9,0
4683,4683,4684,9,2,-7
4684,4684,4685,2,1,-1
4685,4685,4686,1,6,5
4686,4686,4687,6,1,-5
4687,4687,4688,1,3,2
4688,4688,4689,3,5,2
4689,4689,4690,5,7,2
4690,4690,4691,7,1,-6
4691,4691,4692,1,9,8
4692,4692,4693,9,7,-2
4693,4693,4694,7,6,-1
4694,4694,4695,6,4,-2
4695,4695,4696,4,5,1
4696,4696,4697,5,7,2
4697,4697,4698,7,6,-1
4698,4698,4699,6,6,0
4699,4699,4700,6,9,3
4700,4700,4701,9,9,0
4701,4701,4702,9,6,-3
4702,4702,4703,6,3,-3
4703,4703,4704,3,6,3
4704,4704,4705,6,2,-4
4705,4705,4706,2,9,7
4706,4706,4707,9,8,-1
4707,4707,4708,8,1,-7
4708,4708,4709,1,2,1
4709,4709,4710,2,2,0
4710,4710,4711,2,5,3
4711,4711,4712,5,5,0
4712,4712,4713,5,2,-3
4713,4713,4714,2,3,1
4714,4714,4715,3,7,4
4715,4715,4716,7,2,-5
4716,4716,4717,2,1,-1
4717,4717,4718,1,0,-1
4718,4718,4719,0,1,1
4719,4719,4720,1,0,-1
4720,4720,4721,0,4,4
4721,4721,4722,4,5,1
4722,4722,4723,5,2,-3
4723,4723,4724,2,8,6
4724,4724,4725,8,2,-6
4725,4725,4726,2,8,6
4726,4726,4727,8,3,-5
4727,4727,4728,3,5,2
4728,4728,4729,5,1,-4
4729,4729,4730,1,7,6
4730,4730,4731,7,8,1
4731,4731,4732,8,1,-7
4732,4732,4733,1,1,0
4733,4733,4734,1,2,1
4734,4734,4735,2,9,7
4735,4735,4736,9,7,-2
4736,4736,4737,7,8,1
4737,4737,4738,8,4,-4
4738,4738,4739,4,0,-4
4739,4739,4740,0,3,3
4740,4740,4741,3,0,-3
4741,4741,4742,0,7,7
4742,4742,4743,7,8,1
4743,4743,4744,8,8,0
4744,4744,4745,8,4,-4
4745,4745,4746,4,7,3
4746,4746,4747,7,7,0
4747,4747,4748,7,8,1
4748,4748,4749,8,5,-3
4749,4749,4750,5,8,3
4750,4750,4751,8,4,-4
4751,4751,4752,4,9,5
4752,4752,4753,9,8,-1
4753,4753,4754,8,1,-7
4754,4754,4755,1,3,2
4755,4755,4756,3,8,5
4756,4756,4757,8,0,-8
4757,4757,4758,0,3,3
4758,4758,4759,3,1,-2
4759,4759,4760,1,7,6
4760,4760,4761,7,9,2
4761,4761,4762,9,5,-4
4762,4762,4763,5,5,0
4763,4763,4764,5,1,-4
4764,4764,4765,1,6,5
4765,4765,4766,6,5,-1
4766,4766,4767,5,7,2
4767,4767,4768,7,4,-3
4768,4768,4769,4,9,5
4769,4769,4770,9,3,-6
4770,4770,4771,3,5,2
4771,4771,4772,5,4,-1
4772,4772,4773,4,7,3
4773,4773,4774,7,1,-6
4774,4774,4775,1,2,1
4775,4775,4776,2,0,-2
4776,4776,4777,0,8,8
4777,4777,4778,8,1,-7
4778,4778,4779,1,6,5
4779,4779,4780,6,0,-6
4780,4780,4781,0,7,7
4781,4781,4782,7,3,-4
4782,4782,4783,3,4,1
4783,4783,4784,4,7,3
4784,4784,4785,7,3,-4
4785,4785,4786,3,9,6
4786,4786,4787,9,6,-3
4787,4787,4788,6,0,-6
4788,4788,4789,0,8,8
4789,4789,4790,8,6,-2
4790,4790,4791,6,4,-2
4791,4791,4792,4,8,4
4792,4792,4793,8,7,-1
4793,4793,4794,7,7,0
4794,4794,4795,7,9,2
4795,4795,4796,9,3,-6
4796,4796,4797,3,8,5
4797,4797,4798,8,6,-2
4798,4798,4799,6,9,3
4799,4799,4800,9,7,-2
4800,4800,4801,7,2,-5
4801,4801,4802,2,3,1
4802,4802,4803,3,4,1
4803,4803,4804,4,0,-4
4804,4804,4805,0,2,2
4805,4805,4806,2,1,-1
4806,4806,4807,1,8,7
4807,4807,4808,8,3,-5
4808,4808,4809,3,5,2
4809,4809,4810,5,5,0
4810,4810,4811,5,7,2
4811,4811,4812,7,2,-5
4812,4812,4813,2,4,2
4813,4813,4814,4,6,2
4814,4814,4815,6,7,1
4815,4815,4816,7,2,-5
4816,4816,4817,2,8,6
4817,4817,4818,8,3,-5
4818,4818,4819,3,0,-3
4819,4819,4820,0,8,8
4820,4820,4821,8,7,-1
4821,4821,4822,7,8,1
4822,4822,4823,8,9,1
4823,4823,4824,9,0,-9
4824,4824,4825,0,8,8
4825,4825,4826,8,4,-4
4826,4826,4827,4,4,0
4827,4827,4828,4,5,1
4828,4828,4829,5,8,3
4829,4829,4830,8,5,-3
4830,4830,4831,5,6,1
4831,4831,4832,6,6,0
4832,4832,4833,6,3,-3
4833,4833,4834,3,0,-3
4834,4834,4835,0,9,9
4835,4835,4836,9,3,-6
4836,4836,4837,3,7,4
4837,4837,4838,7,6,-1
4838,4838,4839,6,8,2
4839,4839,4840,8,9,1
4840,4840,4841,9,3,-6
4841,4841,4842,3,4,1
4842,4842,4843,4,9,5
4843,4843,4844,9,5,-4
4844,4844,4845,5,8,3
4845,4845,4846,8,9,1
4846,4846,4847,9,1,-8
4847,4847,4848,1,2,1
4848,4848,4849,2,8,6
4849,4849,4850,8,8,0
4850,4850,4851,8,6,-2
4851,4851,4852,6,8,2
4852,4852,4853,8,1,-7
4853,4853,4854,1,3,2
4854,4854,4855,3,7,4
4855,4855,4856,7,9,2
4856,4856,4857,9,0,-9
4857,4857,4858,0,1,1
4858,4858,4859,1,1,0
4859,4859,4860,1,4,3
4860,4860,4861,4,7,3
4861,4861,4862,7,0,-7
4862,4862,4863,0,8,8
4863,4863,4864,8,1,-7
4864,4864,4865,1,7,6
4865,4865,4866,7,4,-3
4866,4866,4867,4,5,1
4867,4867,4868,5,7,2
4868,4868,4869,7,1,-6
4869,4869,4870,1,2,1
4870,4870,4871,2,1,-1
4871,4871,4872,1,1,0
4872,4872,4873,1,3,2
4873,4873,4874,3,9,6
4874,4874,4875,9,6,-3
4875,4875,4876,6,2,-4
4876,4876,4877,2,1,-1
4877,4877,4878,1,2,1
4878,4878,4879,2,8,6
4879,4879,4880,8,0,-8
4880,4880,4881,0,7,7
4881,4881,4882,7,6,-1
4882,4882,4883,6,6,0
4883,4883,4884,6,9,3
4884,4884,4885,9,3,-6
4885,4885,4886,3,7,4
4886,4886,4887,7,0,-7
4887,4887,4888,0,5,5
4888,4888,4889,5,2,-3
4889,4889,4890,2,8,6
4890,4890,4891,8,0,-8
4891,4891,4892,0,5,5
4892,4892,4893,5,4,-1
4893,4893,4894,4,3,-1
4894,4894,4895,3,8,5
4895,4895,4896,8,4,-4
4896,4896,4897,4,6,2
4897,4897,4898,6,6,0
4898,4898,4899,6,2,-4
4899,4899,4900,2,7,5
4900,4900,4901,7,9,2
4901,4901,4902,9,5,-4
4902,4902,4903,5,1,-4
4903,4903,4904,1,3,2
4904,4904,4905,3,2,-1
4905,4905,4906,2,4,2
4906,4906,4907,4,3,-1
4907,4907,4908,3,6,3
4908,4908,4909,6,1,-5
4909,4909,4910,1,9,8
4910,4910,4911,9,4,-5
4911,4911,4912,4,4,0
4912,4912,4913,4,7,3
4913,4913,4914,7,6,-1
4914,4914,4915,6,5,-1
4915,4915,4916,5,4,-1
4916,4916,4917,4,1,-3
4917,4917,4918,1,9,8
4918,4918,4919,9,9,0
4919,4919,4920,9,2,-7
4920,4920,4921,2,7,5
4921,4921,4922,7,8,1
4922,4922,4923,8,0,-8
4923,4923,4924,0,1,1
4924,4924,4925,1,3,2
4925,4925,4926,3,6,3
4926,4926,4927,6,1,-5
4927,4927,4928,1,3,2
4928,4928,4929,3,4,1
4929,4929,4930,4,1,-3
4930,4930,4931,1,1,0
4931,4931,4932,1,1,0
4932,4932,4933,1,5,4
4933,4933,4934,5,6,1
4934,4934,4935,6,0,-6
4935,4935,4936,0,7,7
4936,4936,4937,7,0,-7
4937,4937,4938,0,7,7
4938,4938,4939,7,2,-5
4939,4939,4940,2,3,1
4940,4940,4941,3,2,-1
4941,4941,4942,2,5,3
4942,4942,4943,5,2,-3
4943,4943,4944,2,2,0
4944,4944,4945,2,9,7
4945,4945,4946,9,4,-5
4946,4946,4947,4,9,5
4947,4947,4948,9,8,-1
4948,4948,4949,8,1,-7
4949,4949,4950,1,2,1
4950,4950,4951,2,1,-1
4951,4951,4952,1,6,5
4952,4952,4953,6,1,-5
4953,4953,4954,1,2,1
4954,4954,4955,2,7,5
4955,4955,4956,7,8,1
4956,4956,4957,8,0,-8
4957,4957,4958,0,0,0
4958,4958,4959,0,0,0
4959,4959,4960,0,8,8
4960,4960,4961,8,2,-6
4961,4961,4962,2,2,0
4962,4962,4963,2,9,7
4963,4963,4964,9,2,-7
4964,4964,4965,2,2,0
4965,4965,4966,2,7,5
4966,4966,4967,7,9,2
4967,4967,4968,9,9,0
4968,4968,4969,9,2,-7
4969,4969,4970,2,7,5
4970,4970,4971,7,5,-2
4971,4971,4972,5,1,-4
4972,4972,4973,1,3,2
4973,4973,4974,3,4,1
4974,4974,4975,4,9,5
4975,4975,4976,9,4,-5
4976,4976,4977,4,1,-3
4977,4977,4978,1,8,7
4978,4978,4979,8,5,-3
4979,4979,4980,5,6,1
4980,4980,4981,6,2,-4
4981,4981,4982,2,8,6
4982,4982,4983,8,3,-5
4983,4983,4984,3,1,-2
4984,4984,4985,1,2,1
4985,4985,4986,2,8,6
4986,4986,4987,8,4,-4
4987,4987,4988,4,9,5
4988,4988,4989,9,9,0
4989,4989,4990,9,3,-6
4990,4990,4991,3,7,4
4991,4991,4992,7,0,-7
4992,4992,4993,0,7,7
4993,4993,4994,7,7,0
4994,4994,4995,7,2,-5
4995,4995,4996,2,3,1
4996,4996,4997,3,2,-1
4997,4997,4998,2,4,2
4998,4998,4999,4,0,-4
4999,4999,5000,0,3,3
5000,5000,5001,3,9,6
5001,5001,5002,9,9,0
5002,5002,5003,9,8,-1
5003,5003,5004,8,4,-4
5004,5004,5005,4,1,-3
5005,5005,5006,1,0,-1
5006,5006,5007,0,6,6
5007,5007,5008,6,0,-6
5008,5008,5009,0,9,9
5009,5009,5010,9,6,-3
5010,5010,5011,6,8,2
5011,5011,5012,8,6,-2
5012,5012,5013,6,1,-5
5013,5013,5014,1,1,0
5014,5014,5015,1,9,8
5015,5015,5016,9,8,-1
5016,5016,5017,8,9,1
5017,5017,5018,9,2,-7
5018,5018,5019,2,3,1
5019,5019,5020,3,5,2
5020,5020,5021,5,5,0
5021,5021,5022,5,9,4
5022,5022,5023,9,4,-5
5023,5023,5024,4,2,-2
5024,5024,5025,2,1,-1
5025,5025,5026,1,9,8
5026,5026,5027,9,4,-5
5027,5027,5028,4,3,-1
5028,5028,5029,3,9,6
5029,5029,5030,9,6,-3
5030,5030,5031,6,0,-6
5031,5031,5032,0,4,4
5032,5032,5033,4,0,-4
5033,5033,5034,0,6,6
5034,5034,5035,6,0,-6
5035,5035,5036,0,1,1
5036,5036,5037,1,2,1
5037,5037,5038,2,3,1
5038,5038,5039,3,4,1
5039,5039,5040,4,7,3
5040,5040,5041,7,8,1
5041,5041,5042,8,9,1
5042,5042,5043,9,0,-9
5043,5043,5044,0,1,1
5044,5044,5045,1,2,1
5045,5045,5046,2,3,1
5046,5046,5047,3,4,1
5047,5047,5048,4,7,3
5048,5048,5049,7,8,1
5049,5049,5050,8,9,1
5050,5050,5051,9,0,-9
5051,5051,5052,0,1,1
5052,5052,5053,1,2,1
5053,5053,5054,2,3,1
5054,5054,5055,3,4,1
5055,5055,5056,4,5,1
5056,5056,5057,5,6,1
5057,5057,5058,6,7,1
5058,5058,5059,7,8,1
5059,5059,5060,8,9,1
5060,5060,5061,9,8,-1
5061,5061,5062,8,3,-5
5062,5062,5063,3,4,1
5063,5063,5064,4,7,3
5064,5064,5065,7,8,1
5065,5065,5066,8,6,-2
5066,5066,5067,6,3,-3
5067,5067,5068,3,4,1
5068,5068,5069,4,0,-4
5069,5069,5070,0,9,9
5070,5070,5071,9,7,-2
5071,5071,5072,7,1,-6
5072,5072,5073,1,9,8
5073,5073,5074,9,3,-6
5074,5074,5075,3,8,5
5075,5075,5076,8,4,-4
5076,5076,5077,4,7,3
5077,5077,5078,7,3,-4
5078,5078,5079,3,0,-3
5079,5079,5080,0,9,9
5080,5080,5081,9,1,-8
5081,5081,5082,1,4,3
5082,5082,5083,4,5,1
5083,5083,5084,5,4,-1
5084,5084,5085,4,6,2
5085,5085,5086,6,2,-4
5086,5086,5087,2,0,-2
5087,5087,5088,0,6,6
5088,5088,5089,6,2,-4
5089,5089,5090,2,1,-1
5090,5090,5091,1,1,0
5091,5091,5092,1,1,0
5092,5092,5093,1,1,0
5093,5093,5094,1,7,6
5094,5094,5095,7,2,-5
5095,5095,5096,2,4,2
5096,5096,5097,4,7,3
5097,5097,5098,7,5,-2
5098,5098,5099,5,2,-3
5099,5099,5100,2,9,7
5100,5100,5101,9,4,-5
5101,5101,5102,4,5,1
5102,5102,5103,5,8,3
5103,5103,5104,8,4,-4
5104,5104,5105,4,2,-2
5105,5105,5106,2,9,7
5106,5106,5107,9,7,-2
5107,5107,5108,7,0,-7
5108,5108,5109,0,0,0
5109,5109,5110,0,7,7
5110,5110,5111,7,5,-2
5111,5111,5112,5,1,-4
5112,5112,5113,1,1,0
5113,5113,5114,1,7,6
5114,5114,5115,7,6,-1
5115,5115,5116,6,6,0
5116,5116,5117,6,6,0
5117,5117,5118,6,8,2
5118,5118,5119,8,2,-6
5119,5119,5120,2,2,0
5120,5120,5121,2,7,5
5121,5121,5122,7,7,0
5122,5122,5123,7,4,-3
5123,5123,5124,4,0,-4
5124,5124,5125,0,2,2
5125,5125,5126,2,4,2
5126,5126,5127,4,2,-2
5127,5127,5128,2,1,-1
5128,5128,5129,1,8,7
5129,5129,5130,8,9,1
5130,5130,5131,9,6,-3
5131,5131,5132,6,1,-5
5132,5132,5133,1,0,-1
5133,5133,5134,0,5,5
5134,5134,5135,5,9,4
5135,5135,5136,9,6,-3
5136,5136,5137,6,9,3
5137,5137,5138,9,8,-1
5138,5138,5139,8,0,-8
5139,5139,5140,0,3,3
5140,5140,5141,3,0,-3
5141,5141,5142,0,8,8
5142,5142,5143,8,3,-5
5143,5143,5144,3,9,6
5144,5144,5145,9,6,-3
5145,5145,5146,6,3,-3
5146,5146,5147,3,0,-3
5147,5147,5148,0,1,1
5148,5148,5149,1,2,1
5149,5149,5150,2,3,1
5150,5150,5151,3,4,1
5151,5151,5152,4,5,1
5152,5152,5153,5,6,1
5153,5153,5154,6,7,1
5154,5154,5155,7,0,-7
5155,5155,5156,0,1,1
5156,5156,5157,1,2,1
5157,5157,5158,2,3,1
5158,5158,5159,3,4,1
5159,5159,5160,4,5,1
5160,5160,5161,5,6,1
5161,5161,5162,6,7,1
5162,5162,5163,7,8,1
5163,5163,5164,8,9,1
5164,5164,5165,9,0,-9
5165,5165,5166,0,1,1
5166,5166,5167,1,2,1
5167,5167,5168,2,3,1
5168,5168,5169,3,4,1
5169,5169,5170,4,5,1
5170,5170,5171,5,6,1
5171,5171,5172,6,7,1
5172,5172,5173,7,8,1
5173,5173,5174,8,5,-3
5174,5174,5175,5,4,-1
5175,5175,5176,4,8,4
5176,5176,5177,8,7,-1
5177,5177,5178,7,4,-3
5178,5178,5179,4,7,3
5179,5179,5180,7,7,0
5180,5180,5181,7,3,-4
5181,5181,5182,3,9,6
5182,5182,5183,9,8,-1
5183,5183,5184,8,8,0
5184,5184,5185,8,3,-5
5185,5185,5186,3,1,-2
5186,5186,5187,1,5,4
5187,5187,5188,5,8,3
5188,5188,5189,8,2,-6
5189,5189,5190,2,7,5
5190,5190,5191,7,4,-3
5191,5191,5192,4,2,-2
5192,5192,5193,2,1,-1
5193,5193,5194,1,5,4
5194,5194,5195,5,4,-1
5195,5195,5196,4,5,1
5196,5196,5197,5,5,0
5197,5197,5198,5,8,3
5198,5198,5199,8,6,-2
5199,5199,5200,6,4,-2
5200,5200,5201,4,4,0
5201,5201,5202,4,4,0
5202,5202,5203,4,1,-3
5203,5203,5204,1,8,7
5204,5204,5205,8,7,-1
5205,5205,5206,7,5,-2
5206,5206,5207,5,5,0
5207,5207,5208,5,1,-4
5208,5208,5209,1,8,7
5209,5209,5210,8,9,1
5210,5210,5211,9,1,-8
5211,5211,5212,1,3,2
5212,5212,5213,3,6,3
5213,5213,5214,6,3,-3
5214,5214,5215,3,3,0
5215,5215,5216,3,2,-1
5216,5216,5217,2,2,0
5217,5217,5218,2,6,4
5218,5218,5219,6,9,3
5219,5219,5220,9,9,0
5220,5220,5221,9,6,-3
5221,5221,5222,6,5,-1
5222,5222,5223,5,5,0
5223,5223,5224,5,3,-2
5224,5224,5225,3,3,0
5225,5225,5226,3,8,5
5226,5226,5227,8,1,-7
5227,5227,5228,1,6,5
5228,5228,5229,6,5,-1
5229,5229,5230,5,6,1
5230,5230,5231,6,8,2
5231,5231,5232,8,1,-7
5232,5232,5233,1,9,8
5233,5233,5234,9,7,-2
5234,5234,5235,7,6,-1
5235,5235,5236,6,8,2
5236,5236,5237,8,3,-5
5237,5237,5238,3,7,4
5238,5238,5239,7,4,-3
5239,5239,5240,4,7,3
5240,5240,5241,7,0,-7
5241,5241,5242,0,9,9
5242,5242,5243,9,0,-9
5243,5243,5244,0,0,0
5244,5244,5245,0,3,3
5245,5245,5246,3,7,4
5246,5246,5247,7,9,2
5247,5247,5248,9,3,-6
5248,5248,5249,3,0,-3
5249,5249,5250,0,2,2
5250,5250,5251,2,0,-2
5251,5251,5252,0,1,1
5252,5252,5253,1,0,-1
5253,5253,5254,0,1,1
5254,5254,5255,1,0,-1
5255,5255,5256,0,4,4
5256,5256,5257,4,0,-4
5257,5257,5258,0,1,1
5258,5258,5259,1,0,-1
5259,5259,5260,0,4,4
5260,5260,5261,4,7,3
5261,5261,5262,7,9,2
5262,5262,5263,9,6,-3
5263,5263,5264,6,2,-4
5264,5264,5265,2,6,4
5265,5265,5266,6,2,-4
5266,5266,5267,2,2,0
5267,5267,5268,2,9,7
5268,5268,5269,9,9,0
5269,5269,5270,9,0,-9
5270,5270,5271,0,1,1
5271,5271,5272,1,2,1
5272,5272,5273,2,3,1
5273,5273,5274,3,4,1
5274,5274,5275,4,5,1
5275,5275,5276,5,6,1
5276,5276,5277,6,7,1
5277,5277,5278,7,8,1
5278,5278,5279,8,9,1
5279,5279,5280,9,0,-9
5280,5280,5281,0,1,1
5281,5281,5282,1,2,1
5282,5282,5283,2,3,1
5283,5283,5284,3,4,1
5284,5284,5285,4,5,1
5285,5285,5286,5,6,1
5286,5286,5287,6,7,1
5287,5287,5288,7,8,1
5288,5288,5289,8,9,1
5289,5289,5290,9,0,-9
5290,5290,5291,0,1,1
5291,5291,5292,1,2,1
5292,5292,5293,2,3,1
5293,5293,5294,3,4,1
5294,5294,5295,4,5,1
5295,5295,5296,5,6,1
5296,5296,5297,6,7,1
5297,5297,5298,7,8,1
5298,5298,5299,8,9,1
5299,5299,5300,9,8,-1
5300,5300,5301,8,0,-8
5301,5301,5302,0,5,5
5302,5302,5303,5,6,1
5303,5303,5304,6,6,0
5304,5304,5305,6,0,-6
5305,5305,5306,0,8,8
5306,5306,5307,8,0,-8
5307,5307,5308,0,2,2
5308,5308,5309,2,3,1
5309,5309,5310,3,7,4
5310,5310,5311,7,9,2
5311,5311,5312,9,4,-5
5312,5312,5313,4,7,3
5313,5313,5314,7,1,-6
5314,5314,5315,1,9,8
5315,5315,5316,9,1,-8
5316,5316,5317,1,7,6
5317,5317,5318,7,1,-6
5318,5318,5319,1,4,3
5319,5319,5320,4,0,-4
5320,5320,5321,0,0,0
5321,5321,5322,0,4,4
5322,5322,5323,4,1,-3
5323,5323,5324,1,7,6
5324,5324,5325,7,5,-2
5325,5325,5326,5,7,2
5326,5326,5327,7,1,-6
5327,5327,5328,1,3,2
5328,5328,5329,3,3,0
5329,5329,5330,3,3,0
5330,5330,5331,3,1,-2
5331,5331,5332,1,6,5
5332,5332,5333,6,9,3
5333,5333,5334,9,7,-2
5334,5334,5335,7,4,-3
5335,5335,5336,4,3,-1
5336,5336,5337,3,0,-3
5337,5337,5338,0,2,2
5338,5338,5339,2,5,3
5339,5339,5340,5,2,-3
5340,5340,5341,2,6,4
5341,5341,5342,6,0,-6
5342,5342,5343,0,8,8
5343,5343,5344,8,9,1
5344,5344,5345,9,4,-5
5345,5345,5346,4,3,-1
5346,5346,5347,3,5,2
5347,5347,5348,5,4,-1
5348,5348,5349,4,8,4
5349,5349,5350,8,1,-7
5350,5350,5351,1,5,4
5351,5351,5352,5,9,4
5352,5352,5353,9,0,-9
5353,5353,5354,0,6,6
5354,5354,5355,6,4,-2
5355,5355,5356,4,3,-1
5356,5356,5357,3,6,3
5357,5357,5358,6,3,-3
5358,5358,5359,3,3,0
5359,5359,5360,3,8,5
5360,5360,5361,8,1,-7
5361,5361,5362,1,4,3
5362,5362,5363,4,7,3
5363,5363,5364,7,5,-2
5364,5364,5365,5,7,2
5365,5365,5366,7,2,-5
5366,5366,5367,2,2,0
5367,5367,5368,2,0,-2
5368,5368,5369,0,0,0
5369,5369,5370,0,1,1
5370,5370,5371,1,7,6
5371,5371,5372,7,7,0
5372,5372,5373,7,9,2
5373,5373,5374,9,5,-4
5374,5374,5375,5,9,4
5375,5375,5376,9,8,-1
5376,5376,5377,8,9,1
5377,5377,5378,9,6,-3
5378,5378,5379,6,8,2
5379,5379,5380,8,8,0
5380,5380,5381,8,2,-6
5381,5381,5382,2,3,1
5382,5382,5383,3,6,3
5383,5383,5384,6,1,-5
5384,5384,5385,1,2,1
5385,5385,5386,2,9,7
5386,5386,5387,9,8,-1
5387,5387,5388,8,9,1
5388,5388,5389,9,5,-4
5389,5389,5390,5,2,-3
5390,5390,5391,2,6,4
5391,5391,5392,6,2,-4
5392,5392,5393,2,4,2
5393,5393,5394,4,8,4
5394,5394,5395,8,4,-4
5395,5395,5396,4,6,2
5396,5396,5397,6,5,-1
5397,5397,5398,5,0,-5
5398,5398,5399,0,1,1
5399,5399,5400,1,5,4
5400,5400,5401,5,6,1
5401,5401,5402,6,7,1
5402,5402,5403,7,8,1
5403,5403,5404,8,9,1
5404,5404,5405,9,0,-9
5405,5405,5406,0,1,1
5406,5406,5407,1,2,1
5407,5407,5408,2,3,1
5408,5408,5409,3,4,1
5409,5409,5410,4,5,1
5410,5410,5411,5,6,1
5411,5411,5412,6,7,1
5412,5412,5413,7,8,1
5413,5413,5414,8,9,1
5414,5414,5415,9,0,-9
5415,5415,5416,0,1,1
5416,5416,5417,1,2,1
5417,5417,5418,2,3,1
5418,5418,5419,3,4,1
5419,5419,5420,4,5,1
5420,5420,5421,5,6,1
5421,5421,5422,6,7,1
5422,5422,5423,7,8,1
5423,5423,5424,8,9,1
5424,5424,5425,9,7,-2
5425,5425,5426,7,4,-3
5426,5426,5427,4,2,-2
5427,5427,5428,2,0,-2
5428,5428,5429,0,9,9
5429,5429,5430,9,0,-9
5430,5430,5431,0,1,1
5431,5431,5432,1,5,4
5432,5432,5433,5,8,3
5433,5433,5434,8,8,0
5434,5434,5435,8,0,-8
5435,5435,5436,0,2,2
5436,5436,5437,2,7,5
5437,5437,5438,7,8,1
5438,5438,5439,8,4,-4
5439,5439,5440,4,4,0
5440,5440,5441,4,6,2
5441,5441,5442,6,1,-5
5442,5442,5443,1,0,-1
5443,5443,5444,0,4,4
5444,5444,5445,4,5,1
5445,5445,5446,5,3,-2
5446,5446,5447,3,9,6
5447,5447,5448,9,4,-5
5448,5448,5449,4,2,-2
5449,5449,5450,2,0,-2
5450,5450,5451,0,5,5
5451,5451,5452,5,0,-5
5452,5452,5453,0,1,1
5453,5453,5454,1,3,2
5454,5454,5455,3,2,-1
5455,5455,5456,2,9,7
5456,5456,5457,9,1,-8
5457,5457,5458,1,6,5
5458,5458,5459,6,0,-6
5459,5459,5460,0,1,1
5460,5460,5461,1,1,0
5461,5461,5462,1,8,7
5462,5462,5463,8,0,-8
5463,5463,5464,0,4,4
5464,5464,5465,4,7,3
5465,5465,5466,7,7,0
5466,5466,5467,7,6,-1
5467,5467,5468,6,3,-3
5468,5468,5469,3,6,3
5469,5469,5470,6,0,-6
5470,5470,5471,0,7,7
5471,5471,5472,7,3,-4
5472,5472,5473,3,5,2
5473,5473,5474,5,4,-1
5474,5474,5475,4,2,-2
5475,5475,5476,2,4,2
5476,5476,5477,4,1,-3
5477,5477,5478,1,8,7
5478,5478,5479,8,3,-5
5479,5479,5480,3,5,2
5480,5480,5481,5,6,1
5481,5481,5482,6,7,1
5482,5482,5483,7,0,-7
5483,5483,5484,0,6,6
5484,5484,5485,6,7,1
5485,5485,5486,7,1,-6
5486,5486,5487,1,2,1
5487,5487,5488,2,5,3
5488,5488,5489,5,8,3
5489,5489,5490,8,1,-7
5490,5490,5491,1,9,8
5491,5491,5492,9,3,-6
5492,5492,5493,3,8,5
5493,5493,5494,8,2,-6
5494,5494,5495,2,8,6
5495,5495,5496,8,7,-1
5496,5496,5497,7,6,-1
5497,5497,5498,6,7,1
5498,5498,5499,7,1,-6
5499,5499,5500,1,4,3
5500,5500,5501,4,6,2
5501,5501,5502,6,2,-4
5502,5502,5503,2,9,7
5503,5503,5504,9,3,-6
5504,5504,5505,3,0,-3
5505,5505,5506,0,1,1
5506,5506,5507,1,2,1
5507,5507,5508,2,3,1
5508,5508,5509,3,4,1
5509,5509,5510,4,5,1
5510,5510,5511,5,6,1
5511,5511,5512,6,7,1
5512,5512,5513,7,0,-7
5513,5513,5514,0,1,1
5514,5514,5515,1,2,1
5515,5515,5516,2,3,1
5516,5516,5517,3,4,1
5517,5517,5518,4,5,1
5518,5518,5519,5,0,-5
5519,5519,5520,0,1,1
5520,5520,5521,1,2,1
5521,5521,5522,2,8,6
5522,5522,5523,8,9,1
5523,5523,5524,9,1,-8
5524,5524,5525,1,4,3
5525,5525,5526,4,0,-4
5526,5526,5527,0,9,9
5527,5527,5528,9,5,-4
5528,5528,5529,5,0,-5
5529,5529,5530,0,8,8
5530,5530,5531,8,0,-8
5531,5531,5532,0,7,7
5532,5532,5533,7,7,0
5533,5533,5534,7,1,-6
5534,5534,5535,1,1,0
5535,5535,5536,1,2,1
5536,5536,5537,2,9,7
5537,5537,5538,9,3,-6
5538,5538,5539,3,6,3
5539,5539,5540,6,7,1
5540,5540,5541,7,2,-5
5541,5541,5542,2,3,1
5542,5542,5543,3,8,5
5543,5543,5544,8,1,-7
5544,5544,5545,1,2,1
5545,5545,5546,2,9,7
5546,5546,5547,9,8,-1
5547,5547,5548,8,8,0
5548,5548,5549,8,7,-1
5549,5549,5550,7,1,-6
5550,5550,5551,1,7,6
5551,5551,5552,7,1,-6
5552,5552,5553,1,1,0
5553,5553,5554,1,0,-1
5554,5554,5555,0,3,3
5555,5555,5556,3,4,1
5556,5556,5557,4,2,-2
5557,5557,5558,2,6,4
5558,5558,5559,6,4,-2
5559,5559,5560,4,7,3
5560,5560,5561,7,4,-3
5561,5561,5562,4,2,-2
5562,5562,5563,2,7,5
5563,5563,5564,7,4,-3
5564,5564,5565,4,9,5
5565,5565,5566,9,1,-8
5566,5566,5567,1,0,-1
5567,5567,5568,0,6,6
5568,5568,5569,6,8,2
5569,5569,5570,8,5,-3
5570,5570,5571,5,5,0
5571,5571,5572,5,5,0
5572,5572,5573,5,3,-2
5573,5573,5574,3,5,2
5574,5574,5575,5,9,4
5575,5575,5576,9,7,-2
5576,5576,5577,7,4,-3
5577,5577,5578,4,8,4
5578,5578,5579,8,5,-3
5579,5579,5580,5,9,4
5580,5580,5581,9,6,-3
5581,5581,5582,6,9,3
5582,5582,5583,9,3,-6
5583,5583,5584,3,0,-3
5584,5584,5585,0,3,3
5585,5585,5586,3,8,5
5586,5586,5587,8,9,1
5587,5587,5588,9,1,-8
5588,5588,5589,1,8,7
5589,5589,5590,8,1,-7
5590,5590,5591,1,6,5
5591,5591,5592,6,0,-6
5592,5592,5593,0,0,0
5593,5593,5594,0,1,1
5594,5594,5595,1,2,1
5595,5595,5596,2,3,1
5596,5596,5597,3,4,1
5597,5597,5598,4,5,1
5598,5598,5599,5,6,1
5599,5599,5600,6,7,1
5600,5600,5601,7,8,1
5601,5601,5602,8,9,1
5602,5602,5603,9,0,-9
5603,5603,5604,0,1,1
5604,5604,5605,1,2,1
5605,5605,5606,2,3,1
5606,5606,5607,3,4,1
5607,5607,5608,4,5,1
5608,5608,5609,5,6,1
5609,5609,5610,6,7,1
5610,5610,5611,7,8,1
5611,5611,5612,8,9,1
5612,5612,5613,9,0,-9
5613,5613,5614,0,1,1
5614,5614,5615,1,2,1
5615,5615,5616,2,3,1
5616,5616,5617,3,4,1
5617,5617,5618,4,5,1
5618,5618,5619,5,6,1
5619,5619,5620,6,7,1
5620,5620,5621,7,8,1
5621,5621,5622,8,9,1
5622,5622,5623,9,3,-6
5623,5623,5624,3,5,2
5624,5624,5625,5,3,-2
5625,5625,5626,3,2,-1
5626,5626,5627,2,9,7
5627,5627,5628,9,3,-6
5628,5628,5629,3,2,-1
5629,5629,5630,2,1,-1
5630,5630,5631,1,4,3
5631,5631,5632,4,5,1
5632,5632,5633,5,5,0
5633,5633,5634,5,2,-3
5634,5634,5635,2,3,1
5635,5635,5636,3,2,-1
5636,5636,5637,2,1,-1
5637,5637,5638,1,3,2
5638,5638,5639,3,9,6
5639,5639,5640,9,7,-2
5640,5640,5641,7,2,-5
5641,5641,5642,2,1,-1
5642,5642,5643,1,2,1
5643,5643,5644,2,8,6
5644,5644,5645,8,9,1
5645,5645,5646,9,1,-8
5646,5646,5647,1,8,7
5647,5647,5648,8,8,0
5648,5648,5649,8,7,-1
5649,5649,5650,7,8,1
5650,5650,5651,8,1,-7
5651,5651,5652,1,0,-1
5652,5652,5653,0,0,0
5653,5653,5654,0,7,7
5654,5654,5655,7,7,0
5655,5655,5656,7,8,1
5656,5656,5657,8,7,-1
5657,5657,5658,7,5,-2
5658,5658,5659,5,0,-5
5659,5659,5660,0,6,6
5660,5660,5661,6,1,-5
5661,5661,5662,1,5,4
5662,5662,5663,5,7,2
5663,5663,5664,7,4,-3
5664,5664,5665,4,6,2
5665,5665,5666,6,1,-5
5666,5666,5667,1,2,1
5667,5667,5668,2,5,3
5668,5668,5669,5,0,-5
5669,5669,5670,0,7,7
5670,5670,5671,7,9,2
5671,5671,5672,9,9,0
5672,5672,5673,9,0,-9
5673,5673,5674,0,3,3
5674,5674,5675,3,8,5
5675,5675,5676,8,4,-4
5676,5676,5677,4,4,0
5677,5677,5678,4,8,4
5678,5678,5679,8,1,-7
5679,5679,5680,1,8,7
5680,5680,5681,8,6,-2
5681,5681,5682,6,5,-1
5682,5682,5683,5,9,4
5683,5683,5684,9,0,-9
5684,5684,5685,0,0,0
5685,5685,5686,0,0,0
5686,5686,5687,0,3,3
5687,5687,5688,3,7,4
5688,5688,5689,7,1,-6
5689,5689,5690,1,6,5
5690,5690,5691,6,4,-2
5691,5691,5692,4,2,-2
5692,5692,5693,2,6,4
5693,5693,5694,6,6,0
5694,5694,5695,6,0,-6
5695,5695,5696,0,4,4
5696,5696,5697,4,5,1
5697,5697,5698,5,4,-1
5698,5698,5699,4,1,-3
5699,5699,5700,1,3,2
5700,5700,5701,3,8,5
5701,5701,5702,8,6,-2
5702,5702,5703,6,3,-3
5703,5703,5704,3,9,6
5704,5704,5705,9,9,0
5705,5705,5706,9,5,-4
5706,5706,5707,5,9,4
5707,5707,5708,9,3,-6
5708,5708,5709,3,7,4
5709,5709,5710,7,8,1
5710,5710,5711,8,5,-3
5711,5711,5712,5,6,1
5712,5712,5713,6,4,-2
5713,5713,5714,4,7,3
5714,5714,5715,7,6,-1
5715,5715,5716,6,2,-4
5716,5716,5717,2,2,0
5717,5717,5718,2,0,-2
5718,5718,5719,0,9,9
5719,5719,5720,9,4,-5
5720,5720,5721,4,0,-4
5721,5721,5722,0,1,1
5722,5722,5723,1,2,1
5723,5723,5724,2,3,1
5724,5724,5725,3,4,1
5725,5725,5726,4,5,1
5726,5726,5727,5,6,1
5727,5727,5728,6,7,1
5728,5728,5729,7,8,1
5729,5729,5730,8,9,1
5730,5730,5731,9,0,-9
5731,5731,5732,0,1,1
5732,5732,5733,1,2,1
5733,5733,5734,2,3,1
5734,5734,5735,3,5,2
5735,5735,5736,5,6,1
5736,5736,5737,6,0,-6
5737,5737,5738,0,1,1
5738,5738,5739,1,2,1
5739,5739,5740,2,3,1
5740,5740,5741,3,4,1
5741,5741,5742,4,5,1
5742,5742,5743,5,6,1
5743,5743,5744,6,8,2
5744,5744,5745,8,7,-1
5745,5745,5746,7,1,-6
5746,5746,5747,1,3,2
5747,5747,5748,3,2,-1
5748,5748,5749,2,8,6
5749,5749,5750,8,0,-8
5750,5750,5751,0,7,7
5751,5751,5752,7,5,-2
5752,5752,5753,5,9,4
5753,5753,5754,9,9,0
5754,5754,5755,9,6,-3
5755,5755,5756,6,0,-6
5756,5756,5757,0,9,9
5757,5757,5758,9,4,-5
5758,5758,5759,4,1,-3
5759,5759,5760,1,3,2
5760,5760,5761,3,2,-1
5761,5761,5762,2,1,-1
5762,5762,5763,1,2,1
5763,5763,5764,2,3,1
5764,5764,5765,3,8,5
5765,5765,5766,8,3,-5
5766,5766,5767,3,2,-1
5767,5767,5768,2,6,4
5768,5768,5769,6,5,-1
5769,5769,5770,5,6,1
5770,5770,5771,6,8,2
5771,5771,5772,8,2,-6
5772,5772,5773,2,7,5
5773,5773,5774,7,4,-3
5774,5774,5775,4,8,4
5775,5775,5776,8,1,-7
5776,5776,5777,1,8,7
5777,5777,5778,8,0,-8
5778,5778,5779,0,5,5
5779,5779,5780,5,3,-2
5780,5780,5781,3,9,6
5781,5781,5782,9,4,-5
5782,5782,5783,4,1,-3
5783,5783,5784,1,9,8
5784,5784,5785,9,2,-7
5785,5785,5786,2,1,-1
5786,5786,5787,1,9,8
5787,5787,5788,9,6,-3
5788,5788,5789,6,7,1
5789,5789,5790,7,9,2
5790,5790,5791,9,0,-9
5791,5791,5792,0,4,4
5792,5792,5793,4,6,2
5793,5793,5794,6,1,-5
5794,5794,5795,1,7,6
5795,5795,5796,7,3,-4
5796,5796,5797,3,8,5
5797,5797,5798,8,7,-1
5798,5798,5799,7,2,-5
5799,5799,5800,2,9,7
5800,5800,5801,9,6,-3
5801,5801,5802,6,5,-1
5802,5802,5803,5,8,3
5803,5803,5804,8,3,-5
5804,5804,5805,3,9,6
5805,5805,5806,9,0,-9
5806,5806,5807,0,5,5
5807,5807,5808,5,7,2
5808,5808,5809,7,1,-6
5809,5809,5810,1,6,5
5810,5810,5811,6,1,-5
5811,5811,5812,1,0,-1
5812,5812,5813,0,9,9
5813,5813,5814,9,3,-6
5814,5814,5815,3,3,0
5815,5815,5816,3,4,1
5816,5816,5817,4,4,0
5817,5817,5818,4,0,-4
5818,5818,5819,0,6,6
5819,5819,5820,6,2,-4
5820,5820,5821,2,5,3
5821,5821,5822,5,4,-1
5822,5822,5823,4,2,-2
5823,5823,5824,2,3,1
5824,5824,5825,3,4,1
5825,5825,5826,4,6,2
5826,5826,5827,6,0,-6
5827,5827,5828,0,0,0
5828,5828,5829,0,2,2
5829,5829,5830,2,0,-2
5830,5830,5831,0,1,1
5831,5831,5832,1,4,3
5832,5832,5833,4,5,1
5833,5833,5834,5,6,1
5834,5834,5835,6,7,1
5835,5835,5836,7,8,1
5836,5836,5837,8,9,1
5837,5837,5838,9,0,-9
5838,5838,5839,0,1,1
5839,5839,5840,1,2,1
5840,5840,5841,2,3,1
5841,5841,5842,3,4,1
5842,5842,5843,4,5,1
5843,5843,5844,5,6,1
5844,5844,5845,6,7,1
5845,5845,5846,7,8,1
5846,5846,5847,8,0,-8
5847,5847,5848,0,1,1
5848,5848,5849,1,2,1
5849,5849,5850,2,3,1
5850,5850,5851,3,4,1
5851,5851,5852,4,5,1
5852,5852,5853,5,6,1
5853,5853,5854,6,7,1
5854,5854,5855,7,8,1
5855,5855,5856,8,9,1
5856,5856,5857,9,8,-1
5857,5857,5858,8,7,-1
5858,5858,5859,7,1,-6
5859,5859,5860,1,3,2
5860,5860,5861,3,7,4
5861,5861,5862,7,5,-2
5862,5862,5863,5,2,-3
5863,5863,5864,2,8,6
5864,5864,5865,8,0,-8
5865,5865,5866,0,7,7
5866,5866,5867,7,5,-2
5867,5867,5868,5,9,4
5868,5868,5869,9,9,0
5869,5869,5870,9,0,-9
5870,5870,5871,0,9,9
5871,5871,5872,9,1,-8
5872,5872,5873,1,1,0
5873,5873,5874,1,5,4
5874,5874,5875,5,8,3
5875,5875,5876,8,8,0
5876,5876,5877,8,6,-2
5877,5877,5878,6,3,-3
5878,5878,5879,3,2,-1
5879,5879,5880,2,1,-1
5880,5880,5881,1,8,7
5881,5881,5882,8,3,-5
5882,5882,5883,3,2,-1
5883,5883,5884,2,6,4
5884,5884,5885,6,5,-1
5885,5885,5886,5,6,1
5886,5886,5887,6,7,1
5887,5887,5888,7,4,-3
5888,5888,5889,4,1,-3
5889,5889,5890,1,0,-1
5890,5890,5891,0,5,5
5891,5891,5892,5,3,-2
5892,5892,5893,3,1,-2
5893,5893,5894,1,9,8
5894,5894,5895,9,2,-7
5895,5895,5896,2,1,-1
5896,5896,5897,1,9,8
5897,5897,5898,9,6,-3
5898,5898,5899,6,0,-6
5899,5899,5900,0,4,4
5900,5900,5901,4,6,2
5901,5901,5902,6,1,-5
5902,5902,5903,1,7,6
5903,5903,5904,7,3,-4
5904,5904,5905,3,8,5
5905,5905,5906,8,7,-1
5906,5906,5907,7,2,-5
5907,5907,5908,2,9,7
5908,5908,5909,9,6,-3
5909,5909,5910,6,5,-1
5910,5910,5911,5,8,3
5911,5911,5912,8,3,-5
5912,5912,5913,3,5,2
5913,5913,5914,5,7,2
5914,5914,5915,7,1,-6
5915,5915,5916,1,6,5
5916,5916,5917,6,1,-5
5917,5917,5918,1,0,-1
5918,5918,5919,0,9,9
5919,5919,5920,9,6,-3
5920,5920,5921,6,2,-4
5921,5921,5922,2,5,3
5922,5922,5923,5,4,-1
5923,5923,5924,4,2,-2
5924,5924,5925,2,3,1
5925,5925,5926,3,4,1
5926,5926,5927,4,4,0
5927,5927,5928,4,6,2
5928,5928,5929,6,0,-6
5929,5929,5930,0,0,0
5930,5930,5931,0,2,2
5931,5931,5932,2,0,-2
5932,5932,5933,0,1,1
5933,5933,5934,1,2,1
5934,5934,5935,2,3,1
5935,5935,5936,3,4,1
5936,5936,5937,4,5,1
5937,5937,5938,5,6,1
5938,5938,5939,6,7,1
5939,5939,5940,7,8,1
5940,5940,5941,8,9,1
5941,5941,5942,9,0,-9
5942,5942,5943,0,1,1
5943,5943,5944,1,2,1
5944,5944,5945,2,3,1
5945,5945,5946,3,4,1
5946,5946,5947,4,5,1
5947,5947,5948,5,6,1
5948,5948,5949,6,7,1
5949,5949,5950,7,8,1
5950,5950,5951,8,9,1
5951,5951,5952,9,0,-9
5952,5952,5953,0,1,1
5953,5953,5954,1,2,1
5954,5954,5955,2,3,1
5955,5955,5956,3,4,1
5956,5956,5957,4,5,1
5957,5957,5958,5,6,1
5958,5958,5959,6,7,1
5959,5959,5960,7,8,1
5960,5960,5961,8,9,1
5961,5961,5962,9,8,-1
5962,5962,5963,8,6,-2
5963,5963,5964,6,5,-1
5964,5964,5965,5,0,-5
5965,5965,5966,0,6,6
5966,5966,5967,6,8,2
5967,5967,5968,8,9,1
5968,5968,5969,9,4,-5
5969,5969,5970,4,1,-3
5970,5970,5971,1,9,8
5971,5971,5972,9,5,-4
5972,5972,5973,5,3,-2
5973,5973,5974,3,0,-3
5974,5974,5975,0,4,4
5975,5975,5976,4,8,4
5976,5976,5977,8,9,1
5977,5977,5978,9,1,-8
5978,5978,5979,1,4,3
5979,5979,5980,4,0,-4
5980,5980,5981,0,5,5
5981,5981,5982,5,5,0
5982,5982,5983,5,2,-3
5983,5983,5984,2,1,-1
5984,5984,5985,1,5,4
5985,5985,5986,5,4,-1
5986,5986,5987,4,0,-4
5987,5987,5988,0,7,7
5988,5988,5989,7,6,-1
5989,5989,5990,6,0,-6
5990,5990,5991,0,1,1
5991,5991,5992,1,7,6
5992,5992,5993,7,0,-7
5993,5993,5994,0,6,6
5994,5994,5995,6,8,2
5995,5995,5996,8,9,1
5996,5996,5997,9,5,-4
5997,5997,5998,5,1,-4
5998,5998,5999,1,7,6
5999,5999,6000,7,9,2
6000,6000,6001,9,8,-1
6001,6001,6002,8,6,-2
6002,6002,6003,6,0,-6
6003,6003,6004,0,8,8
6004,6004,6005,8,1,-7
6005,6005,6006,1,7,6
6006,6006,6007,7,7,0
6007,6007,6008,7,1,-6
6008,6008,6009,1,3,2
6009,6009,6010,3,2,-1
6010,6010,6011,2,3,1
6011,6011,6012,3,1,-2
6012,6012,6013,1,4,3
6013,6013,6014,4,2,-2
6014,6014,6015,2,0,-2
6015,6015,6016,0,0,0
6016,6016,6017,0,7,7
6017,6017,6018,7,8,1
6018,6018,6019,8,4,-4
6019,6019,6020,4,6,2
6020,6020,6021,6,4,-2
6021,6021,6022,4,9,5
6022,6022,6023,9,3,-6
6023,6023,6024,3,8,5
6024,6024,6025,8,4,-4
6025,6025,6026,4,7,3
6026,6026,6027,7,2,-5
6027,6027,6028,2,5,3
6028,6028,6029,5,6,1
6029,6029,6030,6,3,-3
6030,6030,6031,3,6,3
6031,6031,6032,6,9,3
6032,6032,6033,9,6,-3
6033,6033,6034,6,3,-3
6034,6034,6035,3,2,-1
6035,6035,6036,2,2,0
6036,6036,6037,2,4,2
6037,6037,6038,4,6,2
6038,6038,6039,6,9,3
6039,6039,6040,9,0,-9
6040,6040,6041,0,2,2
6041,6041,6042,2,5,3
6042,6042,6043,5,5,0
6043,6043,6044,5,1,-4
6044,6044,6045,1,3,2
6045,6045,6046,3,3,0
6046,6046,6047,3,9,6
6047,6047,6048,9,7,-2
6048,6048,6049,7,8,1
6049,6049,6050,8,7,-1
6050,6050,6051,7,2,-5
6051,6051,6052,2,2,0
6052,6052,6053,2,5,3
6053,6053,6054,5,7,2
6054,6054,6055,7,9,2
6055,6055,6056,9,8,-1
6056,6056,6057,8,2,-6
6057,6057,6058,2,1,-1
6058,6058,6059,1,3,2
6059,6059,6060,3,1,-2
6060,6060,6061,1,3,2
6061,6061,6062,3,0,-3
6062,6062,6063,0,1,1
6063,6063,6064,1,2,1
6064,6064,6065,2,3,1
6065,6065,6066,3,4,1
6066,6066,6067,4,5,1
6067,6067,6068,5,6,1
6068,6068,6069,6,7,1
6069,6069,6070,7,8,1
6070,6070,6071,8,9,1
6071,6071,6072,9,0,-9
6072,6072,6073,0,1,1
6073,6073,6074,1,2,1
6074,6074,6075,2,3,1
6075,6075,6076,3,4,1
6076,6076,6077,4,5,1
6077,6077,6078,5,6,1
6078,6078,6079,6,7,1
6079,6079,6080,7,8,1
6080,6080,6081,8,9,1
6081,6081,6082,9,0,-9
6082,6082,6083,0,1,1
6083,6083,6084,1,2,1
6084,6084,6085,2,3,1
6085,6085,6086,3,4,1
6086,6086,6087,4,5,1
6087,6087,6088,5,6,1
6088,6088,6089,6,7,1
6089,6089,6090,7,8,1
6090,6090,6091,8,9,1
6091,6091,6092,9,1,-8
6092,6092,6093,1,2,1
6093,6093,6094,2,6,4
6094,6094,6095,6,5,-1
6095,6095,6096,5,3,-2
6096,6096,6097,3,0,-3
6097,6097,6098,0,7,7
6098,6098,6099,7,0,-7
6099,6099,6100,0,4,4
6100,6100,6101,4,1,-3
6101,6101,6102,1,4,3
6102,6102,6103,4,3,-1
6103,6103,6104,3,6,3
6104,6104,6105,6,7,1
6105,6105,6106,7,2,-5
6106,6106,6107,2,3,1
6107,6107,6108,3,1,-2
6108,6108,6109,1,2,1
6109,6109,6110,2,1,-1
6110,6110,6111,1,2,1
6111,6111,6112,2,9,7
6112,6112,6113,9,6,-3
6113,6113,6114,6,0,-6
6114,6114,6115,0,1,1
6115,6115,6116,1,3,2
6116,6116,6117,3,0,-3
6117,6117,6118,0,2,2
6118,6118,6119,2,7,5
6119,6119,6120,7,5,-2
6120,6120,6121,5,7,2
6121,6121,6122,7,6,-1
6122,6122,6123,6,2,-4
6123,6123,6124,2,9,7
6124,6124,6125,9,1,-8
6125,6125,6126,1,9,8
6126,6126,6127,9,0,-9
6127,6127,6128,0,6,6
6128,6128,6129,6,0,-6
6129,6129,6130,0,6,6
6130,6130,6131,6,0,-6
6131,6131,6132,0,2,2
6132,6132,6133,2,0,-2
6133,6133,6134,0,6,6
6134,6134,6135,6,1,-5
6135,6135,6136,1,5,4
6136,6136,6137,5,8,3
6137,6137,6138,8,4,-4
6138,6138,6139,4,3,-1
6139,6139,6140,3,0,-3
6140,6140,6141,0,1,1
6141,6141,6142,1,5,4
6142,6142,6143,5,4,-1
6143,6143,6144,4,4,0
6144,6144,6145,4,8,4
6145,6145,6146,8,5,-3
6146,6146,6147,5,7,2
6147,6147,6148,7,5,-2
6148,6148,6149,5,7,2
6149,6149,6150,7,8,1
6150,6150,6151,8,3,-5
6151,6151,6152,3,4,1
6152,6152,6153,4,8,4
6153,6153,6154,8,8,0
6154,6154,6155,8,5,-3
6155,6155,6156,5,2,-3
6156,6156,6157,2,9,7
6157,6157,6158,9,7,-2
6158,6158,6159,7,1,-6
6159,6159,6160,1,3,2
6160,6160,6161,3,8,5
6161,6161,6162,8,1,-7
6162,6162,6163,1,0,-1
6163,6163,6164,0,7,7
6164,6164,6165,7,5,-2
6165,6165,6166,5,9,4
6166,6166,6167,9,6,-3
6167,6167,6168,6,9,3
6168,6168,6169,9,4,-5
6169,6169,6170,4,7,3
6170,6170,6171,7,7,0
6171,6171,6172,7,9,2
6172,6172,6173,9,9,0
6173,6173,6174,9,3,-6
6174,6174,6175,3,4,1
6175,6175,6176,4,4,0
6176,6176,6177,4,3,-1
6177,6177,6178,3,8,5
6178,6178,6179,8,6,-2
6179,6179,6180,6,2,-4
6180,6180,6181,2,0,-2
6181,6181,6182,0,1,1
6182,6182,6183,1,2,1
6183,6183,6184,2,3,1
6184,6184,6185,3,4,1
6185,6185,6186,4,5,1
6186,6186,6187,5,6,1
6187,6187,6188,6,7,1
6188,6188,6189,7,8,1
6189,6189,6190,8,9,1
6190,6190,6191,9,0,-9
6191,6191,6192,0,1,1
6192,6192,6193,1,2,1
6193,6193,6194,2,3,1
6194,6194,6195,3,4,1
6195,6195,6196,4,5,1
6196,6196,6197,5,6,1
6197,6197,6198,6,7,1
6198,6198,6199,7,8,1
6199,6199,6200,8,9,1
6200,6200,6201,9,0,-9
6201,6201,6202,0,1,1
6202,6202,6203,1,2,1
6203,6203,6204,2,3,1
6204,6204,6205,3,4,1
6205,6205,6206,4,5,1
6206,6206,6207,5,6,1
6207,6207,6208,6,7,1
6208,6208,6209,7,8,1
6209,6209,6210,8,9,1
6210,6210,6211,9,0,-9
6211,6211,6212,0,8,8
6212,6212,6213,8,3,-5
6213,6213,6214,3,9,6
6214,6214,6215,9,5,-4
6215,6215,6216,5,5,0
6216,6216,6217,5,2,-3
6217,6217,6218,2,6,4
6218,6218,6219,6,8,2
6219,6219,6220,8,4,-4
6220,6220,6221,4,9,5
6221,6221,6222,9,1,-8
6222,6222,6223,1,7,6
6223,6223,6224,7,1,-6
6224,6224,6225,1,2,1
6225,6225,6226,2,3,1
6226,6226,6227,3,5,2
6227,6227,6228,5,9,4
6228,6228,6229,9,6,-3
6229,6229,6230,6,9,3
6230,6230,6231,9,1,-8
6231,6231,6232,1,1,0
6232,6232,6233,1,1,0
6233,6233,6234,1,2,1
6234,6234,6235,2,9,7
6235,6235,6236,9,5,-4
6236,6236,6237,5,6,1
6237,6237,6238,6,8,2
6238,6238,6239,8,1,-7
6239,6239,6240,1,2,1
6240,6240,6241,2,0,-2
6241,6241,6242,0,7,7
6242,6242,6243,7,7,0
6243,6243,6244,7,5,-2
6244,6244,6245,5,8,3
6245,6245,6246,8,2,-6
6246,6246,6247,2,9,7
6247,6247,6248,9,8,-1
6248,6248,6249,8,9,1
6249,6249,6250,9,0,-9
6250,6250,6251,0,4,4
6251,6251,6252,4,6,2
6252,6252,6253,6,7,1
6253,6253,6254,7,1,-6
6254,6254,6255,1,3,2
6255,6255,6256,3,4,1
6256,6256,6257,4,5,1
6257,6257,6258,5,6,1
6258,6258,6259,6,0,-6
6259,6259,6260,0,3,3
6260,6260,6261,3,6,3
6261,6261,6262,6,8,2
6262,6262,6263,8,7,-1
6263,6263,6264,7,0,-7
6264,6264,6265,0,4,4
6265,6265,6266,4,2,-2
6266,6266,6267,2,7,5
6267,6267,6268,7,4,-3
6268,6268,6269,4,7,3
6269,6269,6270,7,5,-2
6270,6270,6271,5,4,-1
6271,6271,6272,4,3,-1
6272,6272,6273,3,4,1
6273,6273,6274,4,2,-2
6274,6274,6275,2,8,6
6275,6275,6276,8,1,-7
6276,6276,6277,1,5,4
6277,6277,6278,5,1,-4
6278,6278,6279,1,2,1
6279,6279,6280,2,0,-2
6280,6280,6281,0,2,2
6281,6281,6282,2,5,3
6282,6282,6283,5,6,1
6283,6283,6284,6,4,-2
6284,6284,6285,4,3,-1
6285,6285,6286,3,0,-3
6286,6286,6287,0,0,0
6287,6287,6288,0,0,0
6288,6288,6289,0,3,3
6289,6289,6290,3,3,0
6290,6290,6291,3,5,2
6291,6291,6292,5,7,2
6292,6292,6293,7,0,-7
6293,6293,6294,0,6,6
6294,6294,6295,6,4,-2
6295,6295,6296,4,8,4
6296,6296,6297,8,8,0
6297,6297,6298,8,6,-2
6298,6298,6299,6,3,-3
6299,6299,6300,3,4,1
6300,6300,6301,4,6,2
6301,6301,6302,6,9,3
6302,6302,6303,9,9,0
6303,6303,6304,9,8,-1
6304,6304,6305,8,2,-6
6305,6305,6306,2,7,5
6306,6306,6307,7,7,0
6307,6307,6308,7,1,-6
6308,6308,6309,1,0,-1
6309,6309,6310,0,1,1
6310,6310,6311,1,2,1
6311,6311,6312,2,3,1
6312,6312,6313,3,4,1
6313,6313,6314,4,5,1
6314,6314,6315,5,6,1
6315,6315,6316,6,7,1
6316,6316,6317,7,8,1
6317,6317,6318,8,9,1
6318,6318,6319,9,0,-9
6319,6319,6320,0,1,1
6320,6320,6321,1,2,1
6321,6321,6322,2,3,1
6322,6322,6323,3,4,1
6323,6323,6324,4,5,1
6324,6324,6325,5,6,1
6325,6325,6326,6,7,1
6326,6326,6327,7,8,1
6327,6327,6328,8,0,-8
6328,6328,6329,0,1,1
6329,6329,6330,1,2,1
6330,6330,6331,2,3,1
6331,6331,6332,3,4,1
6332,6332,6333,4,5,1
6333,6333,6334,5,6,1
6334,6334,6335,6,7,1
6335,6335,6336,7,8,1
6336,6336,6337,8,2,-6
6337,6337,6338,2,1,-1
6338,6338,6339,1,7,6
6339,6339,6340,7,2,-5
6340,6340,6341,2,5,3
6341,6341,6342,5,0,-5
6342,6342,6343,0,8,8
6343,6343,6344,8,0,-8
6344,6344,6345,0,2,2
6345,6345,6346,2,7,5
6346,6346,6347,7,8,1
6347,6347,6348,8,8,0
6348,6348,6349,8,3,-5
6349,6349,6350,3,6,3
6350,6350,6351,6,0,-6
6351,6351,6352,0,2,2
6352,6352,6353,2,7,5
6353,6353,6354,7,6,-1
6354,6354,6355,6,6,0
6355,6355,6356,6,1,-5
6356,6356,6357,1,2,1
6357,6357,6358,2,8,6
6358,6358,6359,8,8,0
6359,6359,6360,8,7,-1
6360,6360,6361,7,7,0
6361,6361,6362,7,4,-3
6362,6362,6363,4,7,3
6363,6363,6364,7,7,0
6364,6364,6365,7,3,-4
6365,6365,6366,3,7,4
6366,6366,6367,7,4,-3
6367,6367,6368,4,5,1
6368,6368,6369,5,4,-1
6369,6369,6370,4,3,-1
6370,6370,6371,3,3,0
6371,6371,6372,3,8,5
6372,6372,6373,8,4,-4
6373,6373,6374,4,1,-3
6374,6374,6375,1,1,0
6375,6375,6376,1,9,8
6376,6376,6377,9,7,-2
6377,6377,6378,7,4,-3
6378,6378,6379,4,3,-1
6379,6379,6380,3,7,4
6380,6380,6381,7,3,-4
6381,6381,6382,3,3,0
6382,6382,6383,3,0,-3
6383,6383,6384,0,2,2
6384,6384,6385,2,5,3
6385,6385,6386,5,5,0
6386,6386,6387,5,6,1
6387,6387,6388,6,6,0
6388,6388,6389,6,3,-3
6389,6389,6390,3,5,2
6390,6390,6391,5,2,-3
6391,6391,6392,2,5,3
6392,6392,6393,5,9,4
6393,6393,6394,9,9,0
6394,6394,6395,9,8,-1
6395,6395,6396,8,4,-4
6396,6396,6397,4,1,-3
6397,6397,6398,1,0,-1
6398,6398,6399,0,6,6
6399,6399,6400,6,0,-6
6400,6400,6401,0,9,9
6401,6401,6402,9,6,-3
6402,6402,6403,6,8,2
6403,6403,6404,8,8,0
6404,6404,6405,8,5,-3
6405,6405,6406,5,6,1
6406,6406,6407,6,1,-5
6407,6407,6408,1,1,0
6408,6408,6409,1,9,8
6409,6409,6410,9,8,-1
6410,6410,6411,8,9,1
6411,6411,6412,9,2,-7
6412,6412,6413,2,3,1
6413,6413,6414,3,5,2
6414,6414,6415,5,5,0
6415,6415,6416,5,9,4
6416,6416,6417,9,4,-5
6417,6417,6418,4,2,-2
6418,6418,6419,2,1,-1
6419,6419,6420,1,9,8
6420,6420,6421,9,3,-6
6421,6421,6422,3,9,6
6422,6422,6423,9,2,-7
6423,6423,6424,2,0,-2
6424,6424,6425,0,6,6
6425,6425,6426,6,0,-6
6426,6426,6427,0,4,4
6427,6427,6428,4,0,-4
6428,6428,6429,0,0,0
6429,6429,6430,0,1,1
6430,6430,6431,1,2,1
6431,6431,6432,2,3,1
6432,6432,6433,3,4,1
6433,6433,6434,4,7,3
6434,6434,6435,7,8,1
6435,6435,6436,8,9,1
6436,6436,6437,9,0,-9
6437,6437,6438,0,1,1
6438,6438,6439,1,2,1
6439,6439,6440,2,3,1
6440,6440,6441,3,7,4
6441,6441,6442,7,8,1
6442,6442,6443,8,9,1
6443,6443,6444,9,0,-9
6444,6444,6445,0,1,1
6445,6445,6446,1,2,1
6446,6446,6447,2,3,1
6447,6447,6448,3,4,1
6448,6448,6449,4,7,3
6449,6449,6450,7,8,1
6450,6450,6451,8,9,1
6451,6451,6452,9,7,-2
6452,6452,6453,7,3,-4
6453,6453,6454,3,0,-3
6454,6454,6455,0,3,3
6455,6455,6456,3,1,-2
6456,6456,6457,1,8,7
6457,6457,6458,8,7,-1
6458,6458,6459,7,6,-1
6459,6459,6460,6,4,-2
6460,6460,6461,4,0,-4
6461,6461,6462,0,2,2
6462,6462,6463,2,6,4
6463,6463,6464,6,8,2
6464,6464,6465,8,3,-5
6465,6465,6466,3,2,-1
6466,6466,6467,2,8,6
6467,6467,6468,8,1,-7
6468,6468,6469,1,2,1
6469,6469,6470,2,0,-2
6470,6470,6471,0,7,7
6471,6471,6472,7,1,-6
6472,6472,6473,1,0,-1
6473,6473,6474,0,4,4
6474,6474,6475,4,4,0
6475,6475,6476,4,5,1
6476,6476,6477,5,8,3
6477,6477,6478,8,0,-8
6478,6478,6479,0,6,6
6479,6479,6480,6,2,-4
6480,6480,6481,2,3,1
6481,6481,6482,3,1,-2
6482,6482,6483,1,5,4
6483,6483,6484,5,1,-4
6484,6484,6485,1,8,7
6485,6485,6486,8,5,-3
6486,6486,6487,5,9,4
6487,6487,6488,9,4,-5
6488,6488,6489,4,0,-4
6489,6489,6490,0,7,7
6490,6490,6491,7,5,-2
6491,6491,6492,5,8,3
6492,6492,6493,8,8,0
6493,6493,6494,8,3,-5
6494,6494,6495,3,8,5
6495,6495,6496,8,9,1
6496,6496,6497,9,2,-7
6497,6497,6498,2,6,4
6498,6498,6499,6,2,-4
6499,6499,6500,2,5,3
6500,6500,6501,5,3,-2
6501,6501,6502,3,1,-2
6502,6502,6503,1,7,6
6503,6503,6504,7,3,-4
6504,6504,6505,3,9,6
6505,6505,6506,9,1,-8
6506,6506,6507,1,9,8
6507,6507,6508,9,9,0
6508,6508,6509,9,6,-3
6509,6509,6510,6,0,-6
6510,6510,6511,0,3,3
6511,6511,6512,3,9,6
6512,6512,6513,9,2,-7
6513,6513,6514,2,8,6
6514,6514,6515,8,1,-7
6515,6515,6516,1,4,3
6516,6516,6517,4,3,-1
6517,6517,6518,3,5,2
6518,6518,6519,5,2,-3
6519,6519,6520,2,9,7
6520,6520,6521,9,2,-7
6521,6521,6522,2,5,3
6522,6522,6523,5,8,3
6523,6523,6524,8,9,1
6524,6524,6525,9,5,-4
6525,6525,6526,5,0,-5
6526,6526,6527,0,1,1
6527,6527,6528,1,2,1
6528,6528,6529,2,4,2
6529,6529,6530,4,5,1
6530,6530,6531,5,6,1
6531,6531,6532,6,0,-6
6532,6532,6533,0,1,1
6533,6533,6534,1,2,1
6534,6534,6535,2,3,1
6535,6535,6536,3,4,1
6536,6536,6537,4,5,1
6537,6537,6538,5,6,1
6538,6538,6539,6,7,1
6539,6539,6540,7,1,-6
6540,6540,6541,1,2,1
6541,6541,6542,2,3,1
6542,6542,6543,3,4,1
6543,6543,6544,4,5,1
6544,6544,6545,5,1,-4
6545,6545,6546,1,0,-1
6546,6546,6547,0,4,4
6547,6547,6548,4,5,1
6548,6548,6549,5,6,1
6549,6549,6550,6,6,0
6550,6550,6551,6,3,-3
6551,6551,6552,3,4,1
6552,6552,6553,4,4,0
6553,6553,6554,4,2,-2
6554,6554,6555,2,8,6
6555,6555,6556,8,1,-7
6556,6556,6557,1,0,-1
6557,6557,6558,0,6,6
6558,6558,6559,6,4,-2
6559,6559,6560,4,9,5
6560,6560,6561,9,7,-2
6561,6561,6562,7,2,-5
6562,6562,6563,2,3,1
6563,6563,6564,3,3,0
6564,6564,6565,3,9,6
6565,6565,6566,9,2,-7
6566,6566,6567,2,0,-2
6567,6567,6568,0,9,9
6568,6568,6569,9,3,-6
6569,6569,6570,3,3,0
6570,6570,6571,3,9,6
6571,6571,6572,9,1,-8
6572,6572,6573,1,5,4
6573,6573,6574,5,2,-3
6574,6574,6575,2,3,1
6575,6575,6576,3,7,4
6576,6576,6577,7,7,0
6577,6577,6578,7,8,1
6578,6578,6579,8,4,-4
6579,6579,6580,4,0,-4
6580,6580,6581,0,2,2
6581,6581,6582,2,4,2
6582,6582,6583,4,0,-4
6583,6583,6584,0,2,2
6584,6584,6585,2,4,2
6585,6585,6586,4,7,3
6586,6586,6587,7,8,1
6587,6587,6588,8,0,-8
6588,6588,6589,0,7,7
6589,6589,6590,7,0,-7
6590,6590,6591,0,6,6
6591,6591,6592,6,9,3
6592,6592,6593,9,3,-6
6593,6593,6594,3,2,-1
6594,6594,6595,2,8,6
6595,6595,6596,8,6,-2
6596,6596,6597,6,0,-6
6597,6597,6598,0,5,5
6598,6598,6599,5,7,2
6599,6599,6600,7,5,-2
6600,6600,6601,5,1,-4
6601,6601,6602,1,0,-1
6602,6602,6603,0,8,8
6603,6603,6604,8,1,-7
6604,6604,6605,1,6,5
6605,6605,6606,6,7,1
6606,6606,6607,7,2,-5
6607,6607,6608,2,9,7
6608,6608,6609,9,7,-2
6609,6609,6610,7,9,2
6610,6610,6611,9,5,-4
6611,6611,6612,5,8,3
6612,6612,6613,8,6,-2
6613,6613,6614,6,2,-4
6614,6614,6615,2,6,4
6615,6615,6616,6,2,-4
6616,6616,6617,2,8,6
6617,6617,6618,8,1,-7
6618,6618,6619,1,7,6
6619,6619,6620,7,5,-2
6620,6620,6621,5,0,-5
6621,6621,6622,0,1,1
6622,6622,6623,1,1,0
6623,6623,6624,1,3,2
6624,6624,6625,3,8,5
6625,6625,6626,8,4,-4
6626,6626,6627,4,9,5
6627,6627,6628,9,1,-8
6628,6628,6629,1,8,7
6629,6629,6630,8,6,-2
6630,6630,6631,6,8,2
6631,6631,6632,8,9,1
6632,6632,6633,9,0,-9
6633,6633,6634,0,1,1
6634,6634,6635,1,2,1
6635,6635,6636,2,3,1
6636,6636,6637,3,4,1
6637,6637,6638,4,5,1
6638,6638,6639,5,6,1
6639,6639,6640,6,7,1
6640,6640,6641,7,8,1
6641,6641,6642,8,9,1
6642,6642,6643,9,0,-9
6643,6643,6644,0,1,1
6644,6644,6645,1,2,1
6645,6645,6646,2,3,1
6646,6646,6647,3,4,1
6647,6647,6648,4,7,3
6648,6648,6649,7,8,1
6649,6649,6650,8,9,1
6650,6650,6651,9,0,-9
6651,6651,6652,0,1,1
6652,6652,6653,1,7,6
6653,6653,6654,7,8,1
6654,6654,6655,8,9,1
6655,6655,6656,9,9,0
6656,6656,6657,9,8,-1
6657,6657,6658,8,9,1
6658,6658,6659,9,8,-1
6659,6659,6660,8,4,-4
6660,6660,6661,4,1,-3
6661,6661,6662,1,7,6
6662,6662,6663,7,7,0
6663,6663,6664,7,3,-4
6664,6664,6665,3,3,0
6665,6665,6666,3,7,4
6666,6666,6667,7,6,-1
6667,6667,6668,6,6,0
6668,6668,6669,6,6,0
6669,6669,6670,6,1,-5
6670,6670,6671,1,9,8
6671,6671,6672,9,0,-9
6672,6672,6673,0,1,1
6673,6673,6674,1,7,6
6674,6674,6675,7,6,-1
6675,6675,6676,6,3,-3
6676,6676,6677,3,2,-1
6677,6677,6678,2,1,-1
6678,6678,6679,1,7,6
6679,6679,6680,7,1,-6
6680,6680,6681,1,3,2
6681,6681,6682,3,9,6
6682,6682,6683,9,1,-8
6683,6683,6684,1,7,6
6684,6684,6685,7,6,-1
6685,6685,6686,6,8,2
6686,6686,6687,8,4,-4
6687,6687,6688,4,1,-3
6688,6688,6689,1,4,3
6689,6689,6690,4,3,-1
6690,6690,6691,3,6,3
6691,6691,6692,6,9,3
6692,6692,6693,9,6,-3
6693,6693,6694,6,1,-5
6694,6694,6695,1,4,3
6695,6695,6696,4,4,0
6696,6696,6697,4,7,3
6697,6697,6698,7,2,-5
6698,6698,6699,2,4,2
6699,6699,6700,4,4,0
6700,6700,6701,4,0,-4
6701,6701,6702,0,1,1
6702,6702,6703,1,2,1
6703,6703,6704,2,3,1
6704,6704,6705,3,4,1
6705,6705,6706,4,5,1
6706,6706,6707,5,6,1
6707,6707,6708,6,7,1
6708,6708,6709,7,8,1
6709,6709,6710,8,9,1
6710,6710,6711,9,0,-9
6711,6711,6712,0,1,1
6712,6712,6713,1,2,1
6713,6713,6714,2,3,1
6714,6714,6715,3,4,1
6715,6715,6716,4,5,1
6716,6716,6717,5,6,1
6717,6717,6718,6,9,3
6718,6718,6719,9,0,-9
6719,6719,6720,0,1,1
6720,6720,6721,1,2,1
6721,6721,6722,2,3,1
6722,6722,6723,3,4,1
6723,6723,6724,4,7,3
6724,6724,6725,7,8,1
6725,6725,6726,8,1,-7
6726,6726,6727,1,3,2
6727,6727,6728,3,5,2
6728,6728,6729,5,1,-4
6729,6729,6730,1,7,6
6730,6730,6731,7,7,0
6731,6731,6732,7,2,-5
6732,6732,6733,2,1,-1
6733,6733,6734,1,4,3
6734,6734,6735,4,8,4
6735,6735,6736,8,3,-5
6736,6736,6737,3,4,1
6737,6737,6738,4,4,0
6738,6738,6739,4,3,-1
6739,6739,6740,3,9,6
6740,6740,6741,9,7,-2
6741,6741,6742,7,4,-3
6742,6742,6743,4,1,-3
6743,6743,6744,1,2,1
6744,6744,6745,2,3,1
6745,6745,6746,3,5,2
6746,6746,6747,5,9,4
6747,6747,6748,9,1,-8
6748,6748,6749,1,6,5
6749,6749,6750,6,0,-6
6750,6750,6751,0,1,1
6751,6751,6752,1,0,-1
6752,6752,6753,0,0,0
6753,6753,6754,0,2,2
6754,6754,6755,2,8,6
6755,6755,6756,8,7,-1
6756,6756,6757,7,1,-6
6757,6757,6758,1,1,0
6758,6758,6759,1,4,3
6759,6759,6760,4,0,-4
6760,6760,6761,0,4,4
6761,6761,6762,4,7,3
6762,6762,6763,7,3,-4
6763,6763,6764,3,6,3
6764,6764,6765,6,8,2
6765,6765,6766,8,0,-8
6766,6766,6767,0,3,3
6767,6767,6768,3,7,4
6768,6768,6769,7,4,-3
6769,6769,6770,4,0,-4
6770,6770,6771,0,6,6
6771,6771,6772,6,9,3
6772,6772,6773,9,2,-7
6773,6773,6774,2,6,4
6774,6774,6775,6,5,-1
6775,6775,6776,5,8,3
6776,6776,6777,8,6,-2
6777,6777,6778,6,9,3
6778,6778,6779,9,0,-9
6779,6779,6780,0,4,4
6780,6780,6781,4,0,-4
6781,6781,6782,0,6,6
6782,6782,6783,6,1,-5
6783,6783,6784,1,9,8
6784,6784,6785,9,2,-7
6785,6785,6786,2,0,-2
6786,6786,6787,0,9,9
6787,6787,6788,9,5,-4
6788,6788,6789,5,1,-4
6789,6789,6790,1,3,2
6790,6790,6791,3,7,4
6791,6791,6792,7,6,-1
6792,6792,6793,6,9,3
6793,6793,6794,9,3,-6
6794,6794,6795,3,0,-3
6795,6795,6796,0,2,2
6796,6796,6797,2,2,0
6797,6797,6798,2,0,-2
6798,6798,6799,0,1,1
6799,6799,6800,1,2,1
6800,6800,6801,2,3,1
6801,6801,6802,3,4,1
6802,6802,6803,4,5,1
6803,6803,6804,5,6,1
6804,6804,6805,6,7,1
6805,6805,6806,7,8,1
6806,6806,6807,8,9,1
6807,6807,6808,9,0,-9
6808,6808,6809,0,1,1
6809,6809,6810,1,2,1
6810,6810,6811,2,3,1
6811,6811,6812,3,4,1
6812,6812,6813,4,5,1
6813,6813,6814,5,6,1
6814,6814,6815,6,7,1
6815,6815,6816,7,8,1
6816,6816,6817,8,9,1
6817,6817,6818,9,0,-9
6818,6818,6819,0,1,1
6819,6819,6820,1,2,1
6820,6820,6821,2,3,1
6821,6821,6822,3,4,1
6822,6822,6823,4,5,1
6823,6823,6824,5,6,1
6824,6824,6825,6,7,1
6825,6825,6826,7,8,1
6826,6826,6827,8,9,1
6827,6827,6828,9,2,-7
6828,6828,6829,2,1,-1
6829,6829,6830,1,7,6
6830,6830,6831,7,2,-5
6831,6831,6832,2,5,3
6832,6832,6833,5,0,-5
6833,6833,6834,0,8,8
6834,6834,6835,8,0,-8
6835,6835,6836,0,2,2
6836,6836,6837,2,7,5
6837,6837,6838,7,8,1
6838,6838,6839,8,8,0
6839,6839,6840,8,3,-5
6840,6840,6841,3,0,-3
6841,6841,6842,0,6,6
6842,6842,6843,6,0,-6
6843,6843,6844,0,2,2
6844,6844,6845,2,7,5
6845,6845,6846,7,6,-1
6846,6846,6847,6,6,0
6847,6847,6848,6,1,-5
6848,6848,6849,1,2,1
6849,6849,6850,2,8,6
6850,6850,6851,8,8,0
6851,6851,6852,8,7,-1
6852,6852,6853,7,7,0
6853,6853,6854,7,4,-3
6854,6854,6855,4,7,3
6855,6855,6856,7,7,0
6856,6856,6857,7,3,-4
6857,6857,6858,3,7,4
6858,6858,6859,7,4,-3
6859,6859,6860,4,5,1
6860,6860,6861,5,4,-1
6861,6861,6862,4,3,-1
6862,6862,6863,3,3,0
6863,6863,6864,3,8,5
6864,6864,6865,8,4,-4
6865,6865,6866,4,5,1
6866,6866,6867,5,4,-1
6867,6867,6868,4,1,-3
6868,6868,6869,1,1,0
6869,6869,6870,1,9,8
6870,6870,6871,9,7,-2
6871,6871,6872,7,4,-3
6872,6872,6873,4,3,-1
6873,6873,6874,3,7,4
6874,6874,6875,7,3,-4
6875,6875,6876,3,3,0
6876,6876,6877,3,0,-3
6877,6877,6878,0,2,2
6878,6878,6879,2,5,3
6879,6879,6880,5,5,0
6880,6880,6881,5,6,1
6881,6881,6882,6,3,-3
6882,6882,6883,3,1,-2
6883,6883,6884,1,5,4
6884,6884,6885,5,2,-3
6885,6885,6886,2,5,3
6886,6886,6887,5,9,4
6887,6887,6888,9,9,0
6888,6888,6889,9,8,-1
6889,6889,6890,8,4,-4
6890,6890,6891,4,1,-3
6891,6891,6892,1,0,-1
6892,6892,6893,0,6,6
6893,6893,6894,6,0,-6
6894,6894,6895,0,9,9
6895,6895,6896,9,6,-3
6896,6896,6897,6,8,2
6897,6897,6898,8,8,0
6898,6898,6899,8,5,-3
6899,6899,6900,5,6,1
6900,6900,6901,6,1,-5
6901,6901,6902,1,1,0
6902,6902,6903,1,9,8
6903,6903,6904,9,8,-1
6904,6904,6905,8,9,1
6905,6905,6906,9,2,-7
6906,6906,6907,2,3,1
6907,6907,6908,3,5,2
6908,6908,6909,5,5,0
6909,6909,6910,5,9,4
6910,6910,6911,9,4,-5
6911,6911,6912,4,2,-2
6912,6912,6913,2,1,-1
6913,6913,6914,1,9,8
6914,6914,6915,9,4,-5
6915,6915,6916,4,9,5
6916,6916,6917,9,1,-8
6917,6917,6918,1,3,2
6918,6918,6919,3,9,6
6919,6919,6920,9,2,-7
6920,6920,6921,2,0,-2
6921,6921,6922,0,6,6
6922,6922,6923,6,0,-6
6923,6923,6924,0,4,4
6924,6924,6925,4,0,-4
6925,6925,6926,0,6,6
6926,6926,6927,6,0,-6
6927,6927,6928,0,1,1
6928,6928,6929,1,2,1
6929,6929,6930,2,3,1
6930,6930,6931,3,4,1
6931,6931,6932,4,5,1
6932,6932,6933,5,6,1
6933,6933,6934,6,7,1
6934,6934,6935,7,8,1
6935,6935,6936,8,9,1
6936,6936,6937,9,0,-9
6937,6937,6938,0,1,1
6938,6938,6939,1,2,1
6939,6939,6940,2,3,1
6940,6940,6941,3,4,1
6941,6941,6942,4,5,1
6942,6942,6943,5,6,1
6943,6943,6944,6,7,1
6944,6944,6945,7,8,1
6945,6945,6946,8,9,1
6946,6946,6947,9,0,-9
6947,6947,6948,0,1,1
6948,6948,6949,1,2,1
6949,6949,6950,2,3,1
6950,6950,6951,3,4,1
6951,6951,6952,4,5,1
6952,6952,6953,5,6,1
6953,6953,6954,6,7,1
6954,6954,6955,7,8,1
6955,6955,6956,8,9,1
6956,6956,6957,9,3,-6
6957,6957,6958,3,8,5
6958,6958,6959,8,0,-8
6959,6959,6960,0,7,7
6960,6960,6961,7,1,-6
6961,6961,6962,1,0,-1
6962,6962,6963,0,7,7
6963,6963,6964,7,5,-2
6964,6964,6965,5,5,0
6965,6965,6966,5,6,1
6966,6966,6967,6,9,3
6967,6967,6968,9,0,-9
6968,6968,6969,0,1,1
6969,6969,6970,1,0,-1
6970,6970,6971,0,0,0
6971,6971,6972,0,8,8
6972,6972,6973,8,3,-5
6973,6973,6974,3,4,1
6974,6974,6975,4,3,-1
6975,6975,6976,3,1,-2
6976,6976,6977,1,5,4
6977,6977,6978,5,0,-5
6978,6978,6979,0,0,0
6979,6979,6980,0,9,9
6980,6980,6981,9,5,-4
6981,6981,6982,5,3,-2
6982,6982,6983,3,4,1
6983,6983,6984,4,9,5
6984,6984,6985,9,3,-6
6985,6985,6986,3,7,4
6986,6986,6987,7,6,-1
6987,6987,6988,6,9,3
6988,6988,6989,9,2,-7
6989,6989,6990,2,4,2
6990,6990,6991,4,5,1
6991,6991,6992,5,7,2
6992,6992,6993,7,2,-5
6993,6993,6994,2,6,4
6994,6994,6995,6,4,-2
6995,6995,6996,4,9,5
6996,6996,6997,9,4,-5
6997,6997,6998,4,9,5
6998,6998,6999,9,4,-5
6999,6999,7000,4,1,-3
7000,7000,7001,1,2,1
7001,7001,7002,2,2,0
7002,7002,7003,2,5,3
7003,7003,7004,5,8,3
7004,7004,7005,8,1,-7
7005,7005,7006,1,3,2
7006,7006,7007,3,2,-1
7007,7007,7008,2,9,7
7008,7008,7009,9,4,-5
7009,7009,7010,4,3,-1
7010,7010,7011,3,8,5
7011,7011,7012,8,2,-6
7012,7012,7013,2,2,0
7013,7013,7014,2,1,-1
7014,7014,7015,1,2,1
7015,7015,7016,2,8,6
7016,7016,7017,8,6,-2
7017,7017,7018,6,5,-1
7018,7018,7019,5,1,-4
7019,7019,7020,1,6,5
7020,7020,7021,6,7,1
7021,7021,7022,7,2,-5
7022,7022,7023,2,1,-1
7023,7023,7024,1,3,2
7024,7024,7025,3,9,6
7025,7025,7026,9,3,-6
7026,7026,7027,3,8,5
7027,7027,7028,8,7,-1
7028,7028,7029,7,5,-2
7029,7029,7030,5,7,2
7030,7030,7031,7,0,-7
7031,7031,7032,0,7,7
7032,7032,7033,7,4,-3
7033,7033,7034,4,8,4
7034,7034,7035,8,8,0
7035,7035,7036,8,5,-3
7036,7036,7037,5,0,-5
7037,7037,7038,0,6,6
7038,7038,7039,6,6,0
7039,7039,7040,6,3,-3
7040,7040,7041,3,7,4
7041,7041,7042,7,6,-1
7042,7042,7043,6,9,3
7043,7043,7044,9,9,0
7044,7044,7045,9,4,-5
7045,7045,7046,4,8,4
7046,7046,7047,8,4,-4
7047,7047,7048,4,1,-3
7048,7048,7049,1,0,-1
7049,7049,7050,0,6,6
7050,7050,7051,6,6,0
7051,7051,7052,6,0,-6
7052,7052,7053,0,1,1
7053,7053,7054,1,2,1
7054,7054,7055,2,3,1
7055,7055,7056,3,4,1
7056,7056,7057,4,5,1
7057,7057,7058,5,6,1
7058,7058,7059,6,7,1
7059,7059,7060,7,8,1
7060,7060,7061,8,9,1
7061,7061,7062,9,0,-9
7062,7062,7063,0,1,1
7063,7063,7064,1,2,1
7064,7064,7065,2,3,1
7065,7065,7066,3,4,1
7066,7066,7067,4,5,1
7067,7067,7068,5,6,1
7068,7068,7069,6,7,1
7069,7069,7070,7,8,1
7070,7070,7071,8,9,1
7071,7071,7072,9,0,-9
7072,7072,7073,0,1,1
7073,7073,7074,1,2,1
7074,7074,7075,2,3,1
7075,7075,7076,3,4,1
7076,7076,7077,4,5,1
7077,7077,7078,5,6,1
7078,7078,7079,6,7,1
7079,7079,7080,7,8,1
7080,7080,7081,8,9,1
7081,7081,7082,9,7,-2
7082,7082,7083,7,4,-3
7083,7083,7084,4,0,-4
7084,7084,7085,0,4,4
7085,7085,7086,4,0,-4
7086,7086,7087,0,1,1
7087,7087,7088,1,7,6
7088,7088,7089,7,9,2
7089,7089,7090,9,5,-4
7090,7090,7091,5,1,-4
7091,7091,7092,1,4,3
7092,7092,7093,4,2,-2
7093,7093,7094,2,8,6
7094,7094,7095,8,9,1
7095,7095,7096,9,4,-5
7096,7096,7097,4,3,-1
7097,7097,7098,3,7,4
7098,7098,7099,7,8,1
7099,7099,7100,8,2,-6
7100,7100,7101,2,4,2
7101,7101,7102,4,4,0
7102,7102,7103,4,3,-1
7103,7103,7104,3,3,0
7104,7104,7105,3,6,3
7105,7105,7106,6,9,3
7106,7106,7107,9,9,0
7107,7107,7108,9,5,-4
7108,7108,7109,5,8,3
7109,7109,7110,8,6,-2
7110,7110,7111,6,7,1
7111,7111,7112,7,0,-7
7112,7112,7113,0,6,6
7113,7113,7114,6,8,2
7114,7114,7115,8,2,-6
7115,7115,7116,2,6,4
7116,7116,7117,6,3,-3
7117,7117,7118,3,9,6
7118,7118,7119,9,3,-6
7119,7119,7120,3,2,-1
7120,7120,7121,2,8,6
7121,7121,7122,8,6,-2
7122,7122,7123,6,1,-5
7123,7123,7124,1,7,6
7124,7124,7125,7,4,-3
7125,7125,7126,4,8,4
7126,7126,7127,8,8,0
7127,7127,7128,8,9,1
7128,7128,7129,9,0,-9
7129,7129,7130,0,3,3
7130,7130,7131,3,3,0
7131,7131,7132,3,9,6
7132,7132,7133,9,0,-9
7133,7133,7134,0,5,5
7134,7134,7135,5,2,-3
7135,7135,7136,2,9,7
7136,7136,7137,9,4,-5
7137,7137,7138,4,1,-3
7138,7138,7139,1,0,-1
7139,7139,7140,0,3,3
7140,7140,7141,3,7,4
7141,7141,7142,7,5,-2
7142,7142,7143,5,8,3
7143,7143,7144,8,7,-1
7144,7144,7145,7,7,0
7145,7145,7146,7,8,1
7146,7146,7147,8,2,-6
7147,7147,7148,2,9,7
7148,7148,7149,9,7,-2
7149,7149,7150,7,1,-6
7150,7150,7151,1,2,1
7151,7151,7152,2,6,4
7152,7152,7153,6,4,-2
7153,7153,7154,4,2,-2
7154,7154,7155,2,5,3
7155,7155,7156,5,2,-3
7156,7156,7157,2,3,1
7157,7157,7158,3,6,3
7158,7158,7159,6,6,0
7159,7159,7160,6,5,-1
7160,7160,7161,5,0,-5
7161,7161,7162,0,0,0
7162,7162,7163,0,2,2
7163,7163,7164,2,8,6
7164,7164,7165,8,1,-7
7165,7165,7166,1,6,5
7166,7166,7167,6,1,-5
7167,7167,7168,1,0,-1
7168,7168,7169,0,4,4
7169,7169,7170,4,3,-1
7170,7170,7171,3,1,-2
7171,7171,7172,1,6,5
7172,7172,7173,6,1,-5
7173,7173,7174,1,9,8
7174,7174,7175,9,0,-9
7175,7175,7176,0,1,1
7176,7176,7177,1,4,3
7177,7177,7178,4,5,1
7178,7178,7179,5,6,1
7179,7179,7180,6,7,1
7180,7180,7181,7,8,1
7181,7181,7182,8,9,1
7182,7182,7183,9,1,-8
7183,7183,7184,1,2,1
7184,7184,7185,2,3,1
7185,7185,7186,3,4,1
7186,7186,7187,4,5,1
7187,7187,7188,5,6,1
7188,7188,7189,6,7,1
7189,7189,7190,7,0,-7
7190,7190,7191,0,1,1
7191,7191,7192,1,2,1
7192,7192,7193,2,3,1
7193,7193,7194,3,4,1
7194,7194,7195,4,5,1
7195,7195,7196,5,6,1
7196,7196,7197,6,7,1
7197,7197,7198,7,8,1
7198,7198,7199,8,9,1
7199,7199,7200,9,8,-1
7200,7200,7201,8,4,-4
7201,7201,7202,4,0,-4
7202,7202,7203,0,0,0
7203,7203,7204,0,7,7
7204,7204,7205,7,2,-5
7205,7205,7206,2,4,2
7206,7206,7207,4,3,-1
7207,7207,7208,3,8,5
7208,7208,7209,8,6,-2
7209,7209,7210,6,6,0
7210,7210,7211,6,3,-3
7211,7211,7212,3,2,-1
7212,7212,7213,2,6,4
7213,7213,7214,6,3,-3
7214,7214,7215,3,3,0
7215,7215,7216,3,0,-3
7216,7216,7217,0,1,1
7217,7217,7218,1,4,3
7218,7218,7219,4,7,3
7219,7219,7220,7,8,1
7220,7220,7221,8,0,-8
7221,7221,7222,0,3,3
7222,7222,7223,3,1,-2
7223,7223,7224,1,9,8
7224,7224,7225,9,0,-9
7225,7225,7226,0,1,1
7226,7226,7227,1,9,8
7227,7227,7228,9,1,-8
7228,7228,7229,1,2,1
7229,7229,7230,2,7,5
7230,7230,7231,7,0,-7
7231,7231,7232,0,1,1
7232,7232,7233,1,3,2
7233,7233,7234,3,8,5
7234,7234,7235,8,2,-6
7235,7235,7236,2,9,7
7236,7236,7237,9,2,-7
7237,7237,7238,2,7,5
7238,7238,7239,7,6,-1
7239,7239,7240,6,5,-1
7240,7240,7241,5,5,0
7241,7241,7242,5,9,4
7242,7242,7243,9,9,0
7243,7243,7244,9,8,-1
7244,7244,7245,8,2,-6
7245,7245,7246,2,9,7
7246,7246,7247,9,1,-8
7247,7247,7248,1,3,2
7248,7248,7249,3,2,-1
7249,7249,7250,2,3,1
7250,7250,7251,3,4,1
7251,7251,7252,4,3,-1
7252,7252,7253,3,1,-2
7253,7253,7254,1,9,8
7254,7254,7255,9,0,-9
7255,7255,7256,0,9,9
7256,7256,7257,9,3,-6
7257,7257,7258,3,6,3
7258,7258,7259,6,8,2
7259,7259,7260,8,7,-1
7260,7260,7261,7,0,-7
7261,7261,7262,0,1,1
7262,7262,7263,1,0,-1
7263,7263,7264,0,5,5
7264,7264,7265,5,8,3
7265,7265,7266,8,2,-6
7266,7266,7267,2,7,5
7267,7267,7268,7,7,0
7268,7268,7269,7,0,-7
7269,7269,7270,0,1,1
7270,7270,7271,1,2,1
7271,7271,7272,2,3,1
7272,7272,7273,3,4,1
7273,7273,7274,4,5,1
7274,7274,7275,5,6,1
7275,7275,7276,6,7,1
7276,7276,7277,7,8,1
7277,7277,7278,8,9,1
7278,7278,7279,9,0,-9
7279,7279,7280,0,1,1
7280,7280,7281,1,2,1
7281,7281,7282,2,3,1
7282,7282,7283,3,4,1
7283,7283,7284,4,5,1
7284,7284,7285,5,6,1
7285,7285,7286,6,7,1
7286,7286,7287,7,8,1
7287,7287,7288,8,9,1
7288,7288,7289,9,0,-9
7289,7289,7290,0,1,1
7290,7290,7291,1,2,1
7291,7291,7292,2,3,1
7292,7292,7293,3,4,1
7293,7293,7294,4,5,1
7294,7294,7295,5,6,1
7295,7295,7296,6,7,1
7296,7296,7297,7,8,1
7297,7297,7298,8,9,1
7298,7298,7299,9,1,-8
7299,7299,7300,1,7,6
7300,7300,7301,7,4,-3
7301,7301,7302,4,8,4
7302,7302,7303,8,1,-7
7303,7303,7304,1,5,4
7304,7304,7305,5,6,1
7305,7305,7306,6,5,-1
7306,7306,7307,5,7,2
7307,7307,7308,7,2,-5
7308,7308,7309,2,8,6
7309,7309,7310,8,6,-2
7310,7310,7311,6,3,-3
7311,7311,7312,3,3,0
7312,7312,7313,3,8,5
7313,7313,7314,8,6,-2
7314,7314,7315,6,5,-1
7315,7315,7316,5,4,-1
7316,7316,7317,4,0,-4
7317,7317,7318,0,9,9
7318,7318,7319,9,1,-8
7319,7319,7320,1,7,6
7320,7320,7321,7,2,-5
7321,7321,7322,2,9,7
7322,7322,7323,9,1,-8
7323,7323,7324,1,5,4
7324,7324,7325,5,1,-4
7325,7325,7326,1,3,2
7326,7326,7327,3,2,-1
7327,7327,7328,2,2,0
7328,7328,7329,2,3,1
7329,7329,7330,3,0,-3
7330,7330,7331,0,6,6
7331,7331,7332,6,4,-2
7332,7332,7333,4,3,-1
7333,7333,7334,3,7,4
7334,7334,7335,7,6,-1
7335,7335,7336,6,9,3
7336,7336,7337,9,0,-9
7337,7337,7338,0,4,4
7338,7338,7339,4,8,4
7339,7339,7340,8,1,-7
7340,7340,7341,1,4,3
7341,7341,7342,4,0,-4
7342,7342,7343,0,6,6
7343,7343,7344,6,1,-5
7344,7344,7345,1,2,1
7345,7345,7346,2,6,4
7346,7346,7347,6,9,3
7347,7347,7348,9,2,-7
7348,7348,7349,2,2,0
7349,7349,7350,2,3,1
7350,7350,7351,3,5,2
7351,7351,7352,5,5,0
7352,7352,7353,5,1,-4
7353,7353,7354,1,0,-1
7354,7354,7355,0,7,7
7355,7355,7356,7,7,0
7356,7356,7357,7,9,2
7357,7357,7358,9,6,-3
7358,7358,7359,6,2,-4
7359,7359,7360,2,9,7
7360,7360,7361,9,4,-5
7361,7361,7362,4,7,3
7362,7362,7363,7,0,-7
7363,7363,7364,0,2,2
7364,7364,7365,2,3,1
7365,7365,7366,3,4,1
7366,7366,7367,4,0,-4
7367,7367,7368,0,0,0
7368,7368,7369,0,8,8
7369,7369,7370,8,8,0
7370,7370,7371,8,8,0
7371,7371,7372,8,5,-3
7372,7372,7373,5,1,-4
7373,7373,7374,1,3,2
7374,7374,7375,3,7,4
7375,7375,7376,7,4,-3
7376,7376,7377,4,9,5
7377,7377,7378,9,8,-1
7378,7378,7379,8,8,0
7379,7379,7380,8,9,1
7380,7380,7381,9,0,-9
7381,7381,7382,0,9,9
7382,7382,7383,9,8,-1
7383,7383,7384,8,9,1
7384,7384,7385,9,0,-9
7385,7385,7386,0,2,2
7386,7386,7387,2,6,4
7387,7387,7388,6,5,-1
7388,7388,7389,5,6,1
7389,7389,7390,6,7,1
7390,7390,7391,7,4,-3
7391,7391,7392,4,7,3
7392,7392,7393,7,5,-2
7393,7393,7394,5,4,-1
7394,7394,7395,4,1,-3
7395,7395,7396,1,3,2
7396,7396,7397,3,5,2
7397,7397,7398,5,3,-2
7398,7398,7399,3,1,-2
7399,7399,7400,1,2,1
7400,7400,7401,2,3,1
7401,7401,7402,3,4,1
7402,7402,7403,4,5,1
7403,7403,7404,5,6,1
7404,7404,7405,6,1,-5
7405,7405,7406,1,2,1
7406,7406,7407,2,3,1
7407,7407,7408,3,4,1
7408,7408,7409,4,6,2
7409,7409,7410,6,0,-6
7410,7410,7411,0,1,1
7411,7411,7412,1,2,1
7412,7412,7413,2,4,2
7413,7413,7414,4,5,1
7414,7414,7415,5,6,1
7415,7415,7416,6,7,1
7416,7416,7417,7,8,1
7417,7417,7418,8,1,-7
7418,7418,7419,1,7,6
7419,7419,7420,7,2,-5
7420,7420,7421,2,4,2
7421,7421,7422,4,1,-3
7422,7422,7423,1,4,3
7423,7423,7424,4,1,-3
7424,7424,7425,1,4,3
7425,7425,7426,4,9,5
7426,7426,7427,9,6,-3
7427,7427,7428,6,8,2
7428,7428,7429,8,4,-4
7429,7429,7430,4,5,1
7430,7430,7431,5,3,-2
7431,7431,7432,3,7,4
7432,7432,7433,7,8,1
7433,7433,7434,8,4,-4
7434,7434,7435,4,3,-1
7435,7435,7436,3,3,0
7436,7436,7437,3,5,2
7437,7437,7438,5,6,1
7438,7438,7439,6,7,1
7439,7439,7440,7,0,-7
7440,7440,7441,0,6,6
7441,7441,7442,6,1,-5
7442,7442,7443,1,6,5
7443,7443,7444,6,8,2
7444,7444,7445,8,7,-1
7445,7445,7446,7,0,-7
7446,7446,7447,0,1,1
7447,7447,7448,1,5,4
7448,7448,7449,5,0,-5
7449,7449,7450,0,8,8
7450,7450,7451,8,5,-3
7451,7451,7452,5,0,-5
7452,7452,7453,0,1,1
7453,7453,7454,1,5,4
7454,7454,7455,5,8,3
7455,7455,7456,8,4,-4
7456,7456,7457,4,2,-2
7457,7457,7458,2,3,1
7458,7458,7459,3,9,6
7459,7459,7460,9,7,-2
7460,7460,7461,7,6,-1
7461,7461,7462,6,9,3
7462,7462,7463,9,1,-8
7463,7463,7464,1,9,8
7464,7464,7465,9,0,-9
7465,7465,7466,0,6,6
7466,7466,7467,6,7,1
7467,7467,7468,7,1,-6
7468,7468,7469,1,2,1
7469,7469,7470,2,3,1
7470,7470,7471,3,9,6
7471,7471,7472,9,2,-7
7472,7472,7473,2,4,2
7473,7473,7474,4,5,1
7474,7474,7475,5,5,0
7475,7475,7476,5,3,-2
7476,7476,7477,3,7,4
7477,7477,7478,7,5,-2
7478,7478,7479,5,3,-2
7479,7479,7480,3,1,-2
7480,7480,7481,1,8,7
7481,7481,7482,8,2,-6
7482,7482,7483,2,2,0
7483,7483,7484,2,3,1
7484,7484,7485,3,0,-3
7485,7485,7486,0,2,2
7486,7486,7487,2,9,7
7487,7487,7488,9,4,-5
7488,7488,7489,4,9,5
7489,7489,7490,9,7,-2
7490,7490,7491,7,0,-7
7491,7491,7492,0,2,2
7492,7492,7493,2,7,5
7493,7493,7494,7,4,-3
7494,7494,7495,4,9,5
7495,7495,7496,9,9,0
7496,7496,7497,9,2,-7
7497,7497,7498,2,5,3
7498,7498,7499,5,9,4
7499,7499,7500,9,8,-1
7500,7500,7501,8,3,-5
7501,7501,7502,3,8,5
7502,7502,7503,8,6,-2
7503,7503,7504,6,7,1
7504,7504,7505,7,0,-7
7505,7505,7506,0,0,0
7506,7506,7507,0,1,1
7507,7507,7508,1,2,1
7508,7508,7509,2,3,1
7509,7509,7510,3,4,1
7510,7510,7511,4,5,1
7511,7511,7512,5,6,1
7512,7512,7513,6,7,1
7513,7513,7514,7,8,1
7514,7514,7515,8,9,1
7515,7515,7516,9,0,-9
7516,7516,7517,0,1,1
7517,7517,7518,1,2,1
7518,7518,7519,2,3,1
7519,7519,7520,3,4,1
7520,7520,7521,4,5,1
7521,7521,7522,5,6,1
7522,7522,7523,6,7,1
7523,7523,7524,7,8,1
7524,7524,7525,8,9,1
7525,7525,7526,9,0,-9
7526,7526,7527,0,1,1
7527,7527,7528,1,2,1
7528,7528,7529,2,3,1
7529,7529,7530,3,4,1
7530,7530,7531,4,5,1
7531,7531,7532,5,6,1
7532,7532,7533,6,7,1
7533,7533,7534,7,8,1
7534,7534,7535,8,9,1
7535,7535,7536,9,0,-9
7536,7536,7537,0,0,0
7537,7537,7538,0,7,7
7538,7538,7539,7,2,-5
7539,7539,7540,2,6,4
7540,7540,7541,6,5,-1
7541,7541,7542,5,5,0
7542,7542,7543,5,3,-2
7543,7543,7544,3,7,4
7544,7544,7545,7,8,1
7545,7545,7546,8,6,-2
7546,7546,7547,6,6,0
7547,7547,7548,6,6,0
7548,7548,7549,6,6,0
7549,7549,7550,6,4,-2
7550,7550,7551,4,3,-1
7551,7551,7552,3,8,5
7552,7552,7553,8,8,0
7553,7553,7554,8,3,-5
7554,7554,7555,3,0,-3
7555,7555,7556,0,1,1
7556,7556,7557,1,9,8
7557,7557,7558,9,0,-9
7558,7558,7559,0,5,5
7559,7559,7560,5,4,-1
7560,7560,7561,4,1,-3
7561,7561,7562,1,9,8
7562,7562,7563,9,1,-8
7563,7563,7564,1,2,1
7564,7564,7565,2,7,5
7565,7565,7566,7,0,-7
7566,7566,7567,0,1,1
7567,7567,7568,1,3,2
7568,7568,7569,3,8,5
7569,7569,7570,8,2,-6
7570,7570,7571,2,9,7
7571,7571,7572,9,2,-7
7572,7572,7573,2,7,5
7573,7573,7574,7,4,-3
7574,7574,7575,4,2,-2
7575,7575,7576,2,6,4
7576,7576,7577,6,5,-1
7577,7577,7578,5,5,0
7578,7578,7579,5,9,4
7579,7579,7580,9,9,0
7580,7580,7581,9,1,-8
7581,7581,7582,1,1,0
7582,7582,7583,1,5,4
7583,7583,7584,5,7,2
7584,7584,7585,7,6,-1
7585,7585,7586,6,8,2
7586,7586,7587,8,2,-6
7587,7587,7588,2,9,7
7588,7588,7589,9,4,-5
7589,7589,7590,4,3,-1
7590,7590,7591,3,1,-2
7591,7591,7592,1,9,8
7592,7592,7593,9,0,-9
7593,7593,7594,0,9,9
7594,7594,7595,9,3,-6
7595,7595,7596,3,6,3
7596,7596,7597,6,8,2
7597,7597,7598,8,7,-1
7598,7598,7599,7,0,-7
7599,7599,7600,0,1,1
7600,7600,7601,1,0,-1
7601,7601,7602,0,5,5
7602,7602,7603,5,8,3
7603,7603,7604,8,2,-6
7604,7604,7605,2,7,5
7605,7605,7606,7,7,0
7606,7606,7607,7,0,-7
7607,7607,7608,0,1,1
7608,7608,7609,1,2,1
7609,7609,7610,2,3,1
7610,7610,7611,3,4,1
7611,7611,7612,4,5,1
7612,7612,7613,5,6,1
7613,7613,7614,6,7,1
7614,7614,7615,7,8,1
7615,7615,7616,8,9,1
7616,7616,7617,9,0,-9
7617,7617,7618,0,1,1
7618,7618,7619,1,2,1
7619,7619,7620,2,3,1
7620,7620,7621,3,4,1
7621,7621,7622,4,5,1
7622,7622,7623,5,8,3
7623,7623,7624,8,9,1
7624,7624,7625,9,0,-9
7625,7625,7626,0,1,1
7626,7626,7627,1,2,1
7627,7627,7628,2,3,1
7628,7628,7629,3,4,1
7629,7629,7630,4,5,1
7630,7630,7631,5,6,1
7631,7631,7632,6,7,1
7632,7632,7633,7,8,1
7633,7633,7634,8,9,1
7634,7634,7635,9,2,-7
7635,7635,7636,2,1,-1
7636,7636,7637,1,2,1
7637,7637,7638,2,1,-1
7638,7638,7639,1,3,2
7639,7639,7640,3,9,6
7640,7640,7641,9,9,0
7641,7641,7642,9,8,-1
7642,7642,7643,8,5,-3
7643,7643,7644,5,3,-2
7644,7644,7645,3,7,4
7645,7645,7646,7,0,-7
7646,7646,7647,0,7,7
7647,7647,7648,7,7,0
7648,7648,7649,7,5,-2
7649,7649,7650,5,7,2
7650,7650,7651,7,9,2
7651,7651,7652,9,9,0
7652,7652,7653,9,4,-5
7653,7653,7654,4,7,3
7654,7654,7655,7,0,-7
7655,7655,7656,0,3,3
7656,7656,7657,3,4,1
7657,7657,7658,4,1,-3
7658,7658,7659,1,5,4
7659,7659,7660,5,8,3
7660,7660,7661,8,1,-7
7661,7661,7662,1,4,3
7662,7662,7663,4,8,4
7663,7663,7664,8,4,-4
7664,7664,7665,4,1,-3
7665,7665,7666,1,8,7
7666,7666,7667,8,6,-2
7667,7667,7668,6,6,0
7668,7668,7669,6,4,-2
7669,7669,7670,4,6,2
7670,7670,7671,6,0,-6
7671,7671,7672,0,5,5
7672,7672,7673,5,5,0
7673,7673,7674,5,3,-2
7674,7674,7675,3,3,0
7675,7675,7676,3,5,2
7676,7676,7677,5,7,2
7677,7677,7678,7,2,-5
7678,7678,7679,2,5,3
7679,7679,7680,5,9,4
7680,7680,7681,9,6,-3
7681,7681,7682,6,9,3
7682,7682,7683,9,2,-7
7683,7683,7684,2,6,4
7684,7684,7685,6,2,-4
7685,7685,7686,2,1,-1
7686,7686,7687,1,2,1
7687,7687,7688,2,0,-2
7688,7688,7689,0,8,8
7689,7689,7690,8,3,-5
7690,7690,7691,3,8,5
7691,7691,7692,8,3,-5
7692,7692,7693,3,0,-3
7693,7693,7694,0,8,8
7694,7694,7695,8,7,-1
7695,7695,7696,7,4,-3
7696,7696,7697,4,9,5
7697,7697,7698,9,5,-4
7698,7698,7699,5,0,-5
7699,7699,7700,0,9,9
7700,7700,7701,9,7,-2
7701,7701,7702,7,0,-7
7702,7702,7703,0,0,0
7703,7703,7704,0,4,4
7704,7704,7705,4,6,2
7705,7705,7706,6,0,-6
7706,7706,7707,0,9,9
7707,7707,7708,9,1,-8
7708,7708,7709,1,6,5
7709,7709,7710,6,2,-4
7710,7710,7711,2,7,5
7711,7711,7712,7,6,-1
7712,7712,7713,6,8,2
7713,7713,7714,8,3,-5
7714,7714,7715,3,5,2
7715,7715,7716,5,2,-3
7716,7716,7717,2,1,-1
7717,7717,7718,1,8,7
7718,7718,7719,8,3,-5
7719,7719,7720,3,8,5
7720,7720,7721,8,6,-2
7721,7721,7722,6,1,-5
7722,7722,7723,1,0,-1
7723,7723,7724,0,2,2
7724,7724,7725,2,1,-1
7725,7725,7726,1,4,3
7726,7726,7727,4,0,-4
7727,7727,7728,0,1,1
7728,7728,7729,1,2,1
7729,7729,7730,2,3,1
7730,7730,7731,3,4,1
7731,7731,7732,4,5,1
7732,7732,7733,5,6,1
7733,7733,7734,6,7,1
7734,7734,7735,7,8,1
7735,7735,7736,8,9,1
7736,7736,7737,9,0,-9
7737,7737,7738,0,1,1
7738,7738,7739,1,2,1
7739,7739,7740,2,3,1
7740,7740,7741,3,4,1
7741,7741,7742,4,5,1
7742,7742,7743,5,6,1
7743,7743,7744,6,7,1
7744,7744,7745,7,8,1
7745,7745,7746,8,9,1
7746,7746,7747,9,0,-9
7747,7747,7748,0,1,1
7748,7748,7749,1,2,1
7749,7749,7750,2,3,1
7750,7750,7751,3,4,1
7751,7751,7752,4,5,1
7752,7752,7753,5,6,1
7753,7753,7754,6,7,1
7754,7754,7755,7,8,1
7755,7755,7756,8,9,1
7756,7756,7757,9,7,-2
7757,7757,7758,7,6,-1
7758,7758,7759,6,4,-2
7759,7759,7760,4,7,3
7760,7760,7761,7,6,-1
7761,7761,7762,6,2,-4
7762,7762,7763,2,3,1
7763,7763,7764,3,4,1
7764,7764,7765,4,8,4
7765,7765,7766,8,7,-1
7766,7766,7767,7,8,1
7767,7767,7768,8,6,-2
7768,7768,7769,6,9,3
7769,7769,7770,9,8,-1
7770,7770,7771,8,3,-5
7771,7771,7772,3,2,-1
7772,7772,7773,2,2,0
7773,7773,7774,2,8,6
7774,7774,7775,8,4,-4
7775,7775,7776,4,8,4
7776,7776,7777,8,5,-3
7777,7777,7778,5,6,1
7778,7778,7779,6,5,-1
7779,7779,7780,5,0,-5
7780,7780,7781,0,2,2
7781,7781,7782,2,0,-2
7782,7782,7783,0,1,1
7783,7783,7784,1,1,0
7784,7784,7785,1,2,1
7785,7785,7786,2,9,7
7786,7786,7787,9,6,-3
7787,7787,7788,6,8,2
7788,7788,7789,8,2,-6
7789,7789,7790,2,1,-1
7790,7790,7791,1,0,-1
7791,7791,7792,0,6,6
7792,7792,7793,6,5,-1
7793,7793,7794,5,2,-3
7794,7794,7795,2,9,7
7795,7795,7796,9,7,-2
7796,7796,7797,7,5,-2
7797,7797,7798,5,3,-2
7798,7798,7799,3,9,6
7799,7799,7800,9,3,-6
7800,7800,7801,3,7,4
7801,7801,7802,7,1,-6
7802,7802,7803,1,8,7
7803,7803,7804,8,3,-5
7804,7804,7805,3,8,5
7805,7805,7806,8,1,-7
7806,7806,7807,1,9,8
7807,7807,7808,9,5,-4
7808,7808,7809,5,5,0
7809,7809,7810,5,0,-5
7810,7810,7811,0,1,1
7811,7811,7812,1,1,0
7812,7812,7813,1,9,8
7813,7813,7814,9,8,-1
7814,7814,7815,8,2,-6
7815,7815,7816,2,6,4
7816,7816,7817,6,0,-6
7817,7817,7818,0,4,4
7818,7818,7819,4,5,1
7819,7819,7820,5,0,-5
7820,7820,7821,0,3,3
7821,7821,7822,3,1,-2
7822,7822,7823,1,8,7
7823,7823,7824,8,6,-2
7824,7824,7825,6,7,1
7825,7825,7826,7,5,-2
7826,7826,7827,5,9,4
7827,7827,7828,9,9,0
7828,7828,7829,9,3,-6
7829,7829,7830,3,0,-3
7830,7830,7831,0,3,3
7831,7831,7832,3,1,-2
7832,7832,7833,1,4,3
7833,7833,7834,4,4,0
7834,7834,7835,4,0,-4
7835,7835,7836,0,4,4
7836,7836,7837,4,9,5
7837,7837,7838,9,0,-9
7838,7838,7839,0,1,1
7839,7839,7840,1,2,1
7840,7840,7841,2,3,1
7841,7841,7842,3,5,2
7842,7842,7843,5,6,1
7843,7843,7844,6,7,1
7844,7844,7845,7,8,1
7845,7845,7846,8,0,-8
7846,7846,7847,0,1,1
7847,7847,7848,1,2,1
7848,7848,7849,2,3,1
7849,7849,7850,3,5,2
7850,7850,7851,5,6,1
7851,7851,7852,6,7,1
7852,7852,7853,7,8,1
7853,7853,7854,8,9,1
7854,7854,7855,9,0,-9
7855,7855,7856,0,1,1
7856,7856,7857,1,2,1
7857,7857,7858,2,3,1
7858,7858,7859,3,5,2
7859,7859,7860,5,6,1
7860,7860,7861,6,7,1
7861,7861,7862,7,8,1
7862,7862,7863,8,9,1
7863,7863,7864,9,9,0
7864,7864,7865,9,7,-2
7865,7865,7866,7,0,-7
7866,7866,7867,0,9,9
7867,7867,7868,9,0,-9
7868,7868,7869,0,1,1
7869,7869,7870,1,5,4
7870,7870,7871,5,8,3
7871,7871,7872,8,8,0
7872,7872,7873,8,0,-8
7873,7873,7874,0,9,9
7874,7874,7875,9,3,-6
7875,7875,7876,3,2,-1
7876,7876,7877,2,7,5
7877,7877,7878,7,8,1
7878,7878,7879,8,4,-4
7879,7879,7880,4,6,2
7880,7880,7881,6,1,-5
7881,7881,7882,1,0,-1
7882,7882,7883,0,4,4
7883,7883,7884,4,9,5
7884,7884,7885,9,4,-5
7885,7885,7886,4,2,-2
7886,7886,7887,2,0,-2
7887,7887,7888,0,5,5
7888,7888,7889,5,0,-5
7889,7889,7890,0,1,1
7890,7890,7891,1,6,5
7891,7891,7892,6,9,3
7892,7892,7893,9,3,-6
7893,7893,7894,3,2,-1
7894,7894,7895,2,9,7
7895,7895,7896,9,1,-8
7896,7896,7897,1,6,5
7897,7897,7898,6,0,-6
7898,7898,7899,0,1,1
7899,7899,7900,1,1,0
7900,7900,7901,1,8,7
7901,7901,7902,8,7,-1
7902,7902,7903,7,7,0
7903,7903,7904,7,6,-1
7904,7904,7905,6,3,-3
7905,7905,7906,3,6,3
7906,7906,7907,6,0,-6
7907,7907,7908,0,7,7
7908,7908,7909,7,2,-5
7909,7909,7910,2,4,2
7910,7910,7911,4,1,-3
7911,7911,7912,1,7,6
7912,7912,7913,7,0,-7
7913,7913,7914,0,6,6
7914,7914,7915,6,7,1
7915,7915,7916,7,1,-6
7916,7916,7917,1,2,1
7917,7917,7918,2,5,3
7918,7918,7919,5,8,3
7919,7919,7920,8,1,-7
7920,7920,7921,1,8,7
7921,7921,7922,8,2,-6
7922,7922,7923,2,8,6
7923,7923,7924,8,7,-1
7924,7924,7925,7,6,-1
7925,7925,7926,6,8,2
7926,7926,7927,8,7,-1
7927,7927,7928,7,1,-6
7928,7928,7929,1,6,5
7929,7929,7930,6,2,-4
7930,7930,7931,2,9,7
7931,7931,7932,9,3,-6
7932,7932,7933,3,0,-3
7933,7933,7934,0,1,1
7934,7934,7935,1,2,1
7935,7935,7936,2,3,1
7936,7936,7937,3,4,1
7937,7937,7938,4,5,1
7938,7938,7939,5,6,1
7939,7939,7940,6,7,1
7940,7940,7941,7,8,1
7941,7941,7942,8,9,1
7942,7942,7943,9,0,-9
7943,7943,7944,0,1,1
7944,7944,7945,1,2,1
7945,7945,7946,2,3,1
7946,7946,7947,3,4,1
7947,7947,7948,4,5,1
7948,7948,7949,5,6,1
7949,7949,7950,6,7,1
7950,7950,7951,7,8,1
7951,7951,7952,8,9,1
7952,7952,7953,9,0,-9
7953,7953,7954,0,1,1
7954,7954,7955,1,2,1
7955,7955,7956,2,3,1
7956,7956,7957,3,4,1
7957,7957,7958,4,5,1
7958,7958,7959,5,6,1
7959,7959,7960,6,7,1
7960,7960,7961,7,8,1
7961,7961,7962,8,9,1
7962,7962,7963,9,8,-1
7963,7963,7964,8,9,1
7964,7964,7965,9,5,-4
7965,7965,7966,5,7,2
7966,7966,7967,7,0,-7
7967,7967,7968,0,3,3
7968,7968,7969,3,1,-2
7969,7969,7970,1,6,5
7970,7970,7971,6,8,2
7971,7971,7972,8,4,-4
7972,7972,7973,4,1,-3
7973,7973,7974,1,5,4
7974,7974,7975,5,6,1
7975,7975,7976,6,4,-2
7976,7976,7977,4,2,-2
7977,7977,7978,2,7,5
7978,7978,7979,7,8,1
7979,7979,7980,8,1,-7
7980,7980,7981,1,3,2
7981,7981,7982,3,4,1
7982,7982,7983,4,3,-1
7983,7983,7984,3,4,1
7984,7984,7985,4,7,3
7985,7985,7986,7,2,-5
7986,7986,7987,2,0,-2
7987,7987,7988,0,5,5
7988,7988,7989,5,0,-5
7989,7989,7990,0,1,1
7990,7990,7991,1,9,8
7991,7991,7992,9,2,-7
7992,7992,7993,2,3,1
7993,7993,7994,3,2,-1
7994,7994,7995,2,3,1
7995,7995,7996,3,5,2
7996,7996,7997,5,5,0
7997,7997,7998,5,7,2
7998,7998,7999,7,8,1
7999,7999,8000,8,4,-4
8000,8000,8001,4,9,5
8001,8001,8002,9,9,0
8002,8002,8003,9,7,-2
8003,8003,8004,7,1,-6
8004,8004,8005,1,1,0
8005,8005,8006,1,9,8
8006,8006,8007,9,0,-9
8007,8007,8008,0,7,7
8008,8008,8009,7,8,1
8009,8009,8010,8,3,-5
8010,8010,8011,3,4,1
8011,8011,8012,4,8,4
8012,8012,8013,8,6,-2
8013,8013,8014,6,3,-3
8014,8014,8015,3,8,5
8015,8015,8016,8,0,-8
8016,8016,8017,0,9,9
8017,8017,8018,9,6,-3
8018,8018,8019,6,2,-4
8019,8019,8020,2,1,-1
8020,8020,8021,1,0,-1
8021,8021,8022,0,1,1
8022,8022,8023,1,0,-1
8023,8023,8024,0,6,6
8024,8024,8025,6,2,-4
8025,8025,8026,2,3,1
8026,8026,8027,3,8,5
8027,8027,8028,8,9,1
8028,8028,8029,9,0,-9
8029,8029,8030,0,7,7
8030,8030,8031,7,2,-5
8031,8031,8032,2,3,1
8032,8032,8033,3,4,1
8033,8033,8034,4,5,1
8034,8034,8035,5,5,0
8035,8035,8036,5,2,-3
8036,8036,8037,2,8,6
8037,8037,8038,8,5,-3
8038,8038,8039,5,4,-1
8039,8039,8040,4,6,2
8040,8040,8041,6,6,0
8041,8041,8042,6,6,0
8042,8042,8043,6,7,1
8043,8043,8044,7,9,2
8044,8044,8045,9,1,-8
8045,8045,8046,1,8,7
8046,8046,8047,8,2,-6
8047,8047,8048,2,1,-1
8048,8048,8049,1,5,4
8049,8049,8050,5,3,-2
8050,8050,8051,3,4,1
8051,8051,8052,4,7,3
8052,8052,8053,7,9,2
8053,8053,8054,9,4,-5
8054,8054,8055,4,0,-4
8055,8055,8056,0,0,0
8056,8056,8057,0,0,0
8057,8057,8058,0,1,1
8058,8058,8059,1,2,1
8059,8059,8060,2,3,1
8060,8060,8061,3,4,1
8061,8061,8062,4,5,1
8062,8062,8063,5,6,1
8063,8063,8064,6,7,1
8064,8064,8065,7,8,1
8065,8065,8066,8,9,1
8066,8066,8067,9,0,-9
8067,8067,8068,0,1,1
8068,8068,8069,1,2,1
8069,8069,8070,2,3,1
8070,8070,8071,3,4,1
8071,8071,8072,4,5,1
8072,8072,8073,5,6,1
8073,8073,8074,6,7,1
8074,8074,8075,7,8,1
8075,8075,8076,8,9,1
8076,8076,8077,9,0,-9
8077,8077,8078,0,1,1
8078,8078,8079,1,2,1
8079,8079,8080,2,3,1
8080,8080,8081,3,4,1
8081,8081,8082,4,5,1
8082,8082,8083,5,6,1
8083,8083,8084,6,9,3
8084,8084,8085,9,0,-9
8085,8085,8086,0,1,1
8086,8086,8087,1,3,2
8087,8087,8088,3,1,-2
8088,8088,8089,1,5,4
8089,8089,8090,5,1,-4
8090,8090,8091,1,2,1
8091,8091,8092,2,4,2
8092,8092,8093,4,9,5
8093,8093,8094,9,2,-7
8094,8094,8095,2,4,2
8095,8095,8096,4,6,2
8096,8096,8097,6,8,2
8097,8097,8098,8,0,-8
8098,8098,8099,0,1,1
8099,8099,8100,1,1,0
8100,8100,8101,1,9,8
8101,8101,8102,9,2,-7
8102,8102,8103,2,6,4
8103,8103,8104,6,6,0
8104,8104,8105,6,8,2
8105,8105,8106,8,7,-1
8106,8106,8107,7,4,-3
8107,8107,8108,4,2,-2
8108,8108,8109,2,9,7
8109,8109,8110,9,7,-2
8110,8110,8111,7,0,-7
8111,8111,8112,0,2,2
8112,8112,8113,2,1,-1
8113,8113,8114,1,0,-1
8114,8114,8115,0,3,3
8115,8115,8116,3,6,3
8116,8116,8117,6,0,-6
8117,8117,8118,0,1,1
8118,8118,8119,1,2,1
8119,8119,8120,2,3,1
8120,8120,8121,3,4,1
8121,8121,8122,4,5,1
8122,8122,8123,5,6,1
8123,8123,8124,6,7,1
8124,8124,8125,7,8,1
8125,8125,8126,8,9,1
8126,8126,8127,9,0,-9
8127,8127,8128,0,1,1
8128,8128,8129,1,2,1
8129,8129,8130,2,3,1
8130,8130,8131,3,4,1
8131,8131,8132,4,5,1
8132,8132,8133,5,6,1
8133,8133,8134,6,7,1
8134,8134,8135,7,8,1
8135,8135,8136,8,9,1
8136,8136,8137,9,0,-9
8137,8137,8138,0,1,1
8138,8138,8139,1,2,1
8139,8139,8140,2,3,1
8140,8140,8141,3,4,1
8141,8141,8142,4,5,1
8142,8142,8143,5,6,1
8143,8143,8144,6,7,1
8144,8144,8145,7,8,1
8145,8145,8146,8,9,1
8146,8146,8147,9,8,-1
8147,8147,8148,8,6,-2
8148,8148,8149,6,5,-1
8149,8149,8150,5,9,4
8150,8150,8151,9,7,-2
8151,8151,8152,7,0,-7
8152,8152,8153,0,2,2
8153,8153,8154,2,3,1
8154,8154,8155,3,4,1
8155,8155,8156,4,3,-1
8156,8156,8157,3,8,5
8157,8157,8158,8,5,-3
8158,8158,8159,5,1,-4
8159,8159,8160,1,5,4
8160,8160,8161,5,2,-3
8161,8161,8162,2,3,1
8162,8162,8163,3,0,-3
8163,8163,8164,0,1,1
8164,8164,8165,1,2,1
8165,8165,8166,2,1,-1
8166,8166,8167,1,3,2
8167,8167,8168,3,2,-1
8168,8168,8169,2,6,4
8169,8169,8170,6,5,-1
8170,8170,8171,5,3,-2
8171,8171,8172,3,0,-3
8172,8172,8173,0,7,7
8173,8173,8174,7,2,-5
8174,8174,8175,2,7,5
8175,8175,8176,7,4,-3
8176,8176,8177,4,6,2
8177,8177,8178,6,4,-2
8178,8178,8179,4,0,-4
8179,8179,8180,0,5,5
8180,8180,8181,5,9,4
8181,8181,8182,9,9,0
8182,8182,8183,9,8,-1
8183,8183,8184,8,9,1
8184,8184,8185,9,5,-4
8185,8185,8186,5,3,-2
8186,8186,8187,3,1,-2
8187,8187,8188,1,7,6
8188,8188,8189,7,4,-3
8189,8189,8190,4,7,3
8190,8190,8191,7,6,-1
8191,8191,8192,6,5,-1
8192,8192,8193,5,4,-1
8193,8193,8194,4,0,-4
8194,8194,8195,0,0,0
8195,8195,8196,0,6,6
8196,8196,8197,6,6,0
8197,8197,8198,6,2,-4
8198,8198,8199,2,0,-2
8199,8199,8200,0,6,6
8200,8200,8201,6,3,-3
8201,8201,8202,3,7,4
8202,8202,8203,7,7,0
8203,8203,8204,7,4,-3
8204,8204,8205,4,4,0
8205,8205,8206,4,3,-1
8206,8206,8207,3,9,6
8207,8207,8208,9,2,-7
8208,8208,8209,2,8,6
8209,8209,8210,8,9,1
8210,8210,8211,9,6,-3
8211,8211,8212,6,0,-6
8212,8212,8213,0,9,9
8213,8213,8214,9,5,-4
8214,8214,8215,5,3,-2
8215,8215,8216,3,8,5
8216,8216,8217,8,8,0
8217,8217,8218,8,7,-1
8218,8218,8219,7,1,-6
8219,8219,8220,1,4,3
8220,8220,8221,4,0,-4
8221,8221,8222,0,4,4
8222,8222,8223,4,8,4
8223,8223,8224,8,5,-3
8224,8224,8225,5,2,-3
8225,8225,8226,2,3,1
8226,8226,8227,3,9,6
8227,8227,8228,9,0,-9
8228,8228,8229,0,1,1
8229,8229,8230,1,9,8
8230,8230,8231,9,1,-8
8231,8231,8232,1,5,4
8232,8232,8233,5,1,-4
8233,8233,8234,1,7,6
8234,8234,8235,7,4,-3
8235,8235,8236,4,8,4
8236,8236,8237,8,6,-2
8237,8237,8238,6,2,-4
8238,8238,8239,2,1,-1
8239,8239,8240,1,6,5
8240,8240,8241,6,8,2
8241,8241,8242,8,8,0
8242,8242,8243,8,0,-8
8243,8243,8244,0,1,1
8244,8244,8245,1,2,1
8245,8245,8246,2,3,1
8246,8246,8247,3,4,1
8247,8247,8248,4,7,3
8248,8248,8249,7,8,1
8249,8249,8250,8,9,1
8250,8250,8251,9,0,-9
8251,8251,8252,0,1,1
8252,8252,8253,1,2,1
8253,8253,8254,2,3,1
8254,8254,8255,3,4,1
8255,8255,8256,4,6,2
8256,8256,8257,6,7,1
8257,8257,8258,7,8,1
8258,8258,8259,8,9,1
8259,8259,8260,9,0,-9
8260,8260,8261,0,1,1
8261,8261,8262,1,2,1
8262,8262,8263,2,3,1
8263,8263,8264,3,4,1
8264,8264,8265,4,7,3
8265,8265,8266,7,8,1
8266,8266,8267,8,9,1
8267,8267,8268,9,1,-8
8268,8268,8269,1,4,3
8269,8269,8270,4,5,1
8270,8270,8271,5,3,-2
8271,8271,8272,3,3,0
8272,8272,8273,3,0,-3
8273,8273,8274,0,9,9
8274,8274,8275,9,5,-4
8275,8275,8276,5,4,-1
8276,8276,8277,4,3,-1
8277,8277,8278,3,0,-3
8278,8278,8279,0,8,8
8279,8279,8280,8,4,-4
8280,8280,8281,4,6,2
8281,8281,8282,6,7,1
8282,8282,8283,7,0,-7
8283,8283,8284,0,7,7
8284,8284,8285,7,7,0
8285,8285,8286,7,1,-6
8286,8286,8287,1,6,5
8287,8287,8288,6,9,3
8288,8288,8289,9,1,-8
8289,8289,8290,1,3,2
8290,8290,8291,3,6,3
8291,8291,8292,6,2,-4
8292,8292,8293,2,3,1
8293,8293,8294,3,8,5
8294,8294,8295,8,2,-6
8295,8295,8296,2,3,1
8296,8296,8297,3,8,5
8297,8297,8298,8,9,1
8298,8298,8299,9,5,-4
8299,8299,8300,5,8,3
8300,8300,8301,8,8,0
8301,8301,8302,8,7,-1
8302,8302,8303,7,1,-6
8303,8303,8304,1,7,6
8304,8304,8305,7,1,-6
8305,8305,8306,1,1,0
8306,8306,8307,1,0,-1
8307,8307,8308,0,3,3
8308,8308,8309,3,4,1
8309,8309,8310,4,2,-2
8310,8310,8311,2,6,4
8311,8311,8312,6,4,-2
8312,8312,8313,4,7,3
8313,8313,8314,7,4,-3
8314,8314,8315,4,2,-2
8315,8315,8316,2,7,5
8316,8316,8317,7,4,-3
8317,8317,8318,4,2,-2
8318,8318,8319,2,9,7
8319,8319,8320,9,2,-7
8320,8320,8321,2,7,5
8321,8321,8322,7,9,2
8322,8322,8323,9,2,-7
8323,8323,8324,2,1,-1
8324,8324,8325,1,0,-1
8325,8325,8326,0,6,6
8326,8326,8327,6,5,-1
8327,8327,8328,5,3,-2
8328,8328,8329,3,4,1
8329,8329,8330,4,8,4
8330,8330,8331,8,5,-3
8331,8331,8332,5,9,4
8332,8332,8333,9,6,-3
8333,8333,8334,6,9,3
8334,8334,8335,9,0,-9
8335,8335,8336,0,6,6
8336,8336,8337,6,3,-3
8337,8337,8338,3,0,-3
8338,8338,8339,0,8,8
8339,8339,8340,8,1,-7
8340,8340,8341,1,6,5
8341,8341,8342,6,0,-6
8342,8342,8343,0,0,0
8343,8343,8344,0,1,1
8344,8344,8345,1,2,1
8345,8345,8346,2,3,1
8346,8346,8347,3,4,1
8347,8347,8348,4,5,1
8348,8348,8349,5,6,1
8349,8349,8350,6,7,1
8350,8350,8351,7,0,-7
8351,8351,8352,0,1,1
8352,8352,8353,1,2,1
8353,8353,8354,2,3,1
8354,8354,8355,3,4,1
8355,8355,8356,4,7,3
8356,8356,8357,7,8,1
8357,8357,8358,8,9,1
8358,8358,8359,9,0,-9
8359,8359,8360,0,1,1
8360,8360,8361,1,2,1
8361,8361,8362,2,3,1
8362,8362,8363,3,4,1
8363,8363,8364,4,7,3
8364,8364,8365,7,2,-5
8365,8365,8366,2,5,3
8366,8366,8367,5,1,-4
8367,8367,8368,1,6,5
8368,8368,8369,6,4,-2
8369,8369,8370,4,3,-1
8370,8370,8371,3,9,6
8371,8371,8372,9,9,0
8372,8372,8373,9,0,-9
8373,8373,8374,0,9,9
8374,8374,8375,9,7,-2
8375,8375,8376,7,1,-6
8376,8376,8377,1,6,5
8377,8377,8378,6,4,-2
8378,8378,8379,4,3,-1
8379,8379,8380,3,6,3
8380,8380,8381,6,2,-4
8381,8381,8382,2,0,-2
8382,8382,8383,0,9,9
8383,8383,8384,9,8,-1
8384,8384,8385,8,6,-2
8385,8385,8386,6,5,-1
8386,8386,8387,5,7,2
8387,8387,8388,7,0,-7
8388,8388,8389,0,0,0
8389,8389,8390,0,1,1
8390,8390,8391,1,7,6
8391,8391,8392,7,4,-3
8392,8392,8393,4,3,-1
8393,8393,8394,3,2,-1
8394,8394,8395,2,4,2
8395,8395,8396,4,1,-3
8396,8396,8397,1,3,2
8397,8397,8398,3,7,4
8398,8398,8399,7,6,-1
8399,8399,8400,6,4,-2
8400,8400,8401,4,7,3
8401,8401,8402,7,7,0
8402,8402,8403,7,7,0
8403,8403,8404,7,9,2
8404,8404,8405,9,8,-1
8405,8405,8406,8,4,-4
8406,8406,8407,4,3,-1
8407,8407,8408,3,8,5
8408,8408,8409,8,2,-6
8409,8409,8410,2,8,6
8410,8410,8411,8,3,-5
8411,8411,8412,3,5,2
8412,8412,8413,5,8,3
8413,8413,8414,8,0,-8
8414,8414,8415,0,5,5
8415,8415,8416,5,4,-1
8416,8416,8417,4,7,3
8417,8417,8418,7,1,-6
8418,8418,8419,1,3,2
8419,8419,8420,3,1,-2
8420,8420,8421,1,7,6
8421,8421,8422,7,9,2
8422,8422,8423,9,6,-3
8423,8423,8424,6,2,-4
8424,8424,8425,2,0,-2
8425,8425,8426,0,9,9
8426,8426,8427,9,1,-8
8427,8427,8428,1,7,6
8428,8428,8429,7,3,-4
8429,8429,8430,3,3,0
8430,8430,8431,3,9,6
8431,8431,8432,9,1,-8
8432,8432,8433,1,6,5
8433,8433,8434,6,4,-2
8434,8434,8435,4,3,-1
8435,8435,8436,3,9,6
8436,8436,8437,9,8,-1
8437,8437,8438,8,2,-6
8438,8438,8439,2,1,-1
8439,8439,8440,1,8,7
8440,8440,8441,8,6,-2
8441,8441,8442,6,4,-2
8442,8442,8443,4,1,-3
8443,8443,8444,1,5,4
8444,8444,8445,5,5,0
8445,8445,8446,5,6,1
8446,8446,8447,6,5,-1
8447,8447,8448,5,0,-5
8448,8448,8449,0,1,1
8449,8449,8450,1,2,1
8450,8450,8451,2,3,1
8451,8451,8452,3,4,1
8452,8452,8453,4,5,1
8453,8453,8454,5,6,1
8454,8454,8455,6,7,1
8455,8455,8456,7,8,1
8456,8456,8457,8,9,1
8457,8457,8458,9,0,-9
8458,8458,8459,0,1,1
8459,8459,8460,1,2,1
8460,8460,8461,2,3,1
8461,8461,8462,3,4,1
8462,8462,8463,4,5,1
8463,8463,8464,5,6,1
8464,8464,8465,6,7,1
8465,8465,8466,7,8,1
8466,8466,8467,8,9,1
8467,8467,8468,9,0,-9
8468,8468,8469,0,1,1
8469,8469,8470,1,2,1
8470,8470,8471,2,3,1
8471,8471,8472,3,4,1
8472,8472,8473,4,5,1
8473,8473,8474,5,6,1
8474,8474,8475,6,7,1
8475,8475,8476,7,8,1
8476,8476,8477,8,9,1
8477,8477,8478,9,6,-3
8478,8478,8479,6,9,3
8479,8479,8480,9,7,-2
8480,8480,8481,7,0,-7
8481,8481,8482,0,2,2
8482,8482,8483,2,3,1
8483,8483,8484,3,4,1
8484,8484,8485,4,3,-1
8485,8485,8486,3,8,5
8486,8486,8487,8,5,-3
8487,8487,8488,5,1,-4
8488,8488,8489,1,3,2
8489,8489,8490,3,0,-3
8490,8490,8491,0,1,1
8491,8491,8492,1,2,1
8492,8492,8493,2,1,-1
8493,8493,8494,1,3,2
8494,8494,8495,3,2,-1
8495,8495,8496,2,0,-2
8496,8496,8497,0,7,7
8497,8497,8498,7,2,-5
8498,8498,8499,2,6,4
8499,8499,8500,6,4,-2
8500,8500,8501,4,0,-4
8501,8501,8502,0,5,5
8502,8502,8503,5,9,4
8503,8503,8504,9,9,0
8504,8504,8505,9,8,-1
8505,8505,8506,8,9,1
8506,8506,8507,9,5,-4
8507,8507,8508,5,3,-2
8508,8508,8509,3,1,-2
8509,8509,8510,1,7,6
8510,8510,8511,7,4,-3
8511,8511,8512,4,7,3
8512,8512,8513,7,0,-7
8513,8513,8514,0,0,0
8514,8514,8515,0,6,6
8515,8515,8516,6,6,0
8516,8516,8517,6,6,0
8517,8517,8518,6,3,-3
8518,8518,8519,3,7,4
8519,8519,8520,7,4,-3
8520,8520,8521,4,2,-2
8521,8521,8522,2,8,6
8522,8522,8523,8,9,1
8523,8523,8524,9,8,-1
8524,8524,8525,8,7,-1
8525,8525,8526,7,1,-6
8526,8526,8527,1,4,3
8527,8527,8528,4,0,-4
8528,8528,8529,0,4,4
8529,8529,8530,4,8,4
8530,8530,8531,8,5,-3
8531,8531,8532,5,2,-3
8532,8532,8533,2,3,1
8533,8533,8534,3,9,6
8534,8534,8535,9,0,-9
8535,8535,8536,0,1,1
8536,8536,8537,1,9,8
8537,8537,8538,9,1,-8
8538,8538,8539,1,5,4
8539,8539,8540,5,1,-4
8540,8540,8541,1,7,6
8541,8541,8542,7,6,-1
8542,8542,8543,6,1,-5
8543,8543,8544,1,2,1
8544,8544,8545,2,1,-1
8545,8545,8546,1,6,5
8546,8546,8547,6,8,2
8547,8547,8548,8,0,-8
8548,8548,8549,0,1,1
8549,8549,8550,1,2,1
8550,8550,8551,2,3,1
8551,8551,8552,3,4,1
8552,8552,8553,4,5,1
8553,8553,8554,5,6,1
8554,8554,8555,6,7,1
8555,8555,8556,7,8,1
8556,8556,8557,8,9,1
8557,8557,8558,9,0,-9
8558,8558,8559,0,1,1
8559,8559,8560,1,2,1
8560,8560,8561,2,3,1
8561,8561,8562,3,4,1
8562,8562,8563,4,5,1
8563,8563,8564,5,6,1
8564,8564,8565,6,7,1
8565,8565,8566,7,8,1
8566,8566,8567,8,0,-8
8567,8567,8568,0,1,1
8568,8568,8569,1,2,1
8569,8569,8570,2,3,1
8570,8570,8571,3,5,2
8571,8571,8572,5,6,1
8572,8572,8573,6,7,1
8573,8573,8574,7,8,1
8574,8574,8575,8,1,-7
8575,8575,8576,1,0,-1
8576,8576,8577,0,4,4
8577,8577,8578,4,5,1
8578,8578,8579,5,6,1
8579,8579,8580,6,6,0
8580,8580,8581,6,3,-3
8581,8581,8582,3,4,1
8582,8582,8583,4,4,0
8583,8583,8584,4,2,-2
8584,8584,8585,2,8,6
8585,8585,8586,8,1,-7
8586,8586,8587,1,0,-1
8587,8587,8588,0,6,6
8588,8588,8589,6,4,-2
8589,8589,8590,4,9,5
8590,8590,8591,9,7,-2
8591,8591,8592,7,2,-5
8592,8592,8593,2,9,7
8593,8593,8594,9,2,-7
8594,8594,8595,2,0,-2
8595,8595,8596,0,9,9
8596,8596,8597,9,3,-6
8597,8597,8598,3,3,0
8598,8598,8599,3,9,6
8599,8599,8600,9,1,-8
8600,8600,8601,1,5,4
8601,8601,8602,5,2,-3
8602,8602,8603,2,3,1
8603,8603,8604,3,1,-2
8604,8604,8605,1,6,5
8605,8605,8606,6,7,1
8606,8606,8607,7,3,-4
8607,8607,8608,3,7,4
8608,8608,8609,7,8,1
8609,8609,8610,8,4,-4
8610,8610,8611,4,0,-4
8611,8611,8612,0,2,2
8612,8612,8613,2,4,2
8613,8613,8614,4,0,-4
8614,8614,8615,0,2,2
8615,8615,8616,2,4,2
8616,8616,8617,4,7,3
8617,8617,8618,7,8,1
8618,8618,8619,8,0,-8
8619,8619,8620,0,7,7
8620,8620,8621,7,0,-7
8621,8621,8622,0,6,6
8622,8622,8623,6,9,3
8623,8623,8624,9,3,-6
8624,8624,8625,3,2,-1
8625,8625,8626,2,4,2
8626,8626,8627,4,8,4
8627,8627,8628,8,6,-2
8628,8628,8629,6,0,-6
8629,8629,8630,0,5,5
8630,8630,8631,5,7,2
8631,8631,8632,7,5,-2
8632,8632,8633,5,1,-4
8633,8633,8634,1,0,-1
8634,8634,8635,0,8,8
8635,8635,8636,8,1,-7
8636,8636,8637,1,6,5
8637,8637,8638,6,7,1
8638,8638,8639,7,2,-5
8639,8639,8640,2,9,7
8640,8640,8641,9,7,-2
8641,8641,8642,7,9,2
8642,8642,8643,9,5,-4
8643,8643,8644,5,6,1
8644,8644,8645,6,5,-1
8645,8645,8646,5,2,-3
8646,8646,8647,2,6,4
8647,8647,8648,6,2,-4
8648,8648,8649,2,8,6
8649,8649,8650,8,1,-7
8650,8650,8651,1,7,6
8651,8651,8652,7,5,-2
8652,8652,8653,5,5,0
8653,8653,8654,5,7,2
8654,8654,8655,7,3,-4
8655,8655,8656,3,5,2
8656,8656,8657,5,0,-5
8657,8657,8658,0,1,1
8658,8658,8659,1,1,0
8659,8659,8660,1,3,2
8660,8660,8661,3,8,5
8661,8661,8662,8,4,-4
8662,8662,8663,4,9,5
8663,8663,8664,9,4,-5
8664,8664,8665,4,5,1
8665,8665,8666,5,1,-4
8666,8666,8667,1,8,7
8667,8667,8668,8,6,-2
8668,8668,8669,6,8,2
8669,8669,8670,8,9,1
8670,8670,8671,9,0,-9
8671,8671,8672,0,1,1
8672,8672,8673,1,2,1
8673,8673,8674,2,3,1
8674,8674,8675,3,4,1
8675,8675,8676,4,5,1
8676,8676,8677,5,6,1
8677,8677,8678,6,7,1
8678,8678,8679,7,8,1
8679,8679,8680,8,9,1
8680,8680,8681,9,0,-9
8681,8681,8682,0,1,1
8682,8682,8683,1,2,1
8683,8683,8684,2,3,1
8684,8684,8685,3,4,1
8685,8685,8686,4,5,1
8686,8686,8687,5,6,1
8687,8687,8688,6,7,1
8688,8688,8689,7,8,1
8689,8689,8690,8,9,1
8690,8690,8691,9,0,-9
8691,8691,8692,0,1,1
8692,8692,8693,1,2,1
8693,8693,8694,2,3,1
8694,8694,8695,3,4,1
8695,8695,8696,4,5,1
8696,8696,8697,5,6,1
8697,8697,8698,6,7,1
8698,8698,8699,7,8,1
8699,8699,8700,8,9,1
8700,8700,8701,9,3,-6
8701,8701,8702,3,5,2
8702,8702,8703,5,3,-2
8703,8703,8704,3,2,-1
8704,8704,8705,2,9,7
8705,8705,8706,9,3,-6
8706,8706,8707,3,2,-1
8707,8707,8708,2,1,-1
8708,8708,8709,1,4,3
8709,8709,8710,4,5,1
8710,8710,8711,5,5,0
8711,8711,8712,5,2,-3
8712,8712,8713,2,3,1
8713,8713,8714,3,2,-1
8714,8714,8715,2,1,-1
8715,8715,8716,1,3,2
8716,8716,8717,3,9,6
8717,8717,8718,9,7,-2
8718,8718,8719,7,2,-5
8719,8719,8720,2,1,-1
8720,8720,8721,1,2,1
8721,8721,8722,2,8,6
8722,8722,8723,8,9,1
8723,8723,8724,9,1,-8
8724,8724,8725,1,8,7
8725,8725,8726,8,8,0
8726,8726,8727,8,7,-1
8727,8727,8728,7,8,1
8728,8728,8729,8,1,-7
8729,8729,8730,1,0,-1
8730,8730,8731,0,0,0
8731,8731,8732,0,6,6
8732,8732,8733,6,7,1
8733,8733,8734,7,7,0
8734,8734,8735,7,8,1
8735,8735,8736,8,7,-1
8736,8736,8737,7,5,-2
8737,8737,8738,5,0,-5
8738,8738,8739,0,6,6
8739,8739,8740,6,1,-5
8740,8740,8741,1,5,4
8741,8741,8742,5,7,2
8742,8742,8743,7,4,-3
8743,8743,8744,4,6,2
8744,8744,8745,6,1,-5
8745,8745,8746,1,2,1
8746,8746,8747,2,5,3
8747,8747,8748,5,0,-5
8748,8748,8749,0,7,7
8749,8749,8750,7,9,2
8750,8750,8751,9,9,0
8751,8751,8752,9,0,-9
8752,8752,8753,0,3,3
8753,8753,8754,3,4,1
8754,8754,8755,4,4,0
8755,8755,8756,4,8,4
8756,8756,8757,8,4,-4
8757,8757,8758,4,1,-3
8758,8758,8759,1,8,7
8759,8759,8760,8,6,-2
8760,8760,8761,6,5,-1
8761,8761,8762,5,9,4
8762,8762,8763,9,0,-9
8763,8763,8764,0,0,0
8764,8764,8765,0,0,0
8765,8765,8766,0,3,3
8766,8766,8767,3,7,4
8767,8767,8768,7,1,-6
8768,8768,8769,1,6,5
8769,8769,8770,6,4,-2
8770,8770,8771,4,6,2
8771,8771,8772,6,0,-6
8772,8772,8773,0,4,4
8773,8773,8774,4,5,1
8774,8774,8775,5,4,-1
8775,8775,8776,4,1,-3
8776,8776,8777,1,3,2
8777,8777,8778,3,8,5
8778,8778,8779,8,6,-2
8779,8779,8780,6,3,-3
8780,8780,8781,3,9,6
8781,8781,8782,9,9,0
8782,8782,8783,9,5,-4
8783,8783,8784,5,9,4
8784,8784,8785,9,3,-6
8785,8785,8786,3,7,4
8786,8786,8787,7,8,1
8787,8787,8788,8,5,-3
8788,8788,8789,5,6,1
8789,8789,8790,6,4,-2
8790,8790,8791,4,7,3
8791,8791,8792,7,6,-1
8792,8792,8793,6,2,-4
8793,8793,8794,2,2,0
8794,8794,8795,2,0,-2
8795,8795,8796,0,9,9
8796,8796,8797,9,4,-5
8797,8797,8798,4,0,-4
8798,8798,8799,0,1,1
8799,8799,8800,1,2,1
8800,8800,8801,2,3,1
8801,8801,8802,3,4,1
8802,8802,8803,4,5,1
8803,8803,8804,5,6,1
8804,8804,8805,6,7,1
8805,8805,8806,7,8,1
8806,8806,8807,8,9,1
8807,8807,8808,9,0,-9
8808,8808,8809,0,1,1
8809,8809,8810,1,2,1
8810,8810,8811,2,3,1
8811,8811,8812,3,4,1
8812,8812,8813,4,5,1
8813,8813,8814,5,6,1
8814,8814,8815,6,7,1
8815,8815,8816,7,8,1
8816,8816,8817,8,9,1
8817,8817,8818,9,0,-9
8818,8818,8819,0,1,1
8819,8819,8820,1,2,1
8820,8820,8821,2,3,1
8821,8821,8822,3,4,1
8822,8822,8823,4,5,1
8823,8823,8824,5,6,1
8824,8824,8825,6,7,1
8825,8825,8826,7,8,1
8826,8826,8827,8,9,1
8827,8827,8828,9,6,-3
8828,8828,8829,6,4,-2
8829,8829,8830,4,2,-2
8830,8830,8831,2,6,4
8831,8831,8832,6,4,-2
8832,8832,8833,4,7,3
8833,8833,8834,7,5,-2
8834,8834,8835,5,5,0
8835,8835,8836,5,4,-1
8836,8836,8837,4,7,3
8837,8837,8838,7,2,-5
8838,8838,8839,2,9,7
8839,8839,8840,9,3,-6
8840,8840,8841,3,9,6
8841,8841,8842,9,3,-6
8842,8842,8843,3,8,5
8843,8843,8844,8,2,-6
8844,8844,8845,2,0,-2
8845,8845,8846,0,9,9
8846,8846,8847,9,5,-4
8847,8847,8848,5,6,1
8848,8848,8849,6,0,-6
8849,8849,8850,0,1,1
8850,8850,8851,1,0,-1
8851,8851,8852,0,6,6
8852,8852,8853,6,5,-1
8853,8853,8854,5,3,-2
8854,8854,8855,3,5,2
8855,8855,8856,5,3,-2
8856,8856,8857,3,8,5
8857,8857,8858,8,0,-8
8858,8858,8859,0,0,0
8859,8859,8860,0,3,3
8860,8860,8861,3,4,1
8861,8861,8862,4,1,-3
8862,8862,8863,1,5,4
8863,8863,8864,5,3,-2
8864,8864,8865,3,0,-3
8865,8865,8866,0,8,8
8866,8866,8867,8,3,-5
8867,8867,8868,3,0,-3
8868,8868,8869,0,6,6
8869,8869,8870,6,2,-4
8870,8870,8871,2,7,5
8871,8871,8872,7,8,1
8872,8872,8873,8,1,-7
8873,8873,8874,1,7,6
8874,8874,8875,7,1,-6
8875,8875,8876,1,3,2
8876,8876,8877,3,8,5
8877,8877,8878,8,5,-3
8878,8878,8879,5,4,-1
8879,8879,8880,4,2,-2
8880,8880,8881,2,0,-2
8881,8881,8882,0,9,9
8882,8882,8883,9,7,-2
8883,8883,8884,7,6,-1
8884,8884,8885,6,7,1
8885,8885,8886,7,4,-3
8886,8886,8887,4,1,-3
8887,8887,8888,1,6,5
8888,8888,8889,6,2,-4
8889,8889,8890,2,6,4
8890,8890,8891,6,7,1
8891,8891,8892,7,1,-6
8892,8892,8893,1,9,8
8893,8893,8894,9,8,-1
8894,8894,8895,8,0,-8
8895,8895,8896,0,6,6
8896,8896,8897,6,9,3
8897,8897,8898,9,4,-5
8898,8898,8899,4,9,5
8899,8899,8900,9,9,0
8900,8900,8901,9,6,-3
8901,8901,8902,6,2,-4
8902,8902,8903,2,3,1
8903,8903,8904,3,7,4
8904,8904,8905,7,1,-6
8905,8905,8906,1,9,8
8906,8906,8907,9,2,-7
8907,8907,8908,2,2,0
8908,8908,8909,2,5,3
8909,8909,8910,5,3,-2
8910,8910,8911,3,7,4
8911,8911,8912,7,8,1
8912,8912,8913,8,0,-8
8913,8913,8914,0,1,1
8914,8914,8915,1,2,1
8915,8915,8916,2,3,1
8916,8916,8917,3,4,1
8917,8917,8918,4,7,3
8918,8918,8919,7,8,1
8919,8919,8920,8,9,1
8920,8920,8921,9,0,-9
8921,8921,8922,0,1,1
8922,8922,8923,1,2,1
8923,8923,8924,2,3,1
8924,8924,8925,3,4,1
8925,8925,8926,4,7,3
8926,8926,8927,7,8,1
8927,8927,8928,8,9,1
8928,8928,8929,9,0,-9
8929,8929,8930,0,1,1
8930,8930,8931,1,7,6
8931,8931,8932,7,8,1
8932,8932,8933,8,9,1
8933,8933,8934,9,8,-1
8934,8934,8935,8,9,1
8935,8935,8936,9,2,-7
8936,8936,8937,2,6,4
8937,8937,8938,6,1,-5
8938,8938,8939,1,3,2
8939,8939,8940,3,5,2
8940,8940,8941,5,4,-1
8941,8941,8942,4,8,4
8942,8942,8943,8,2,-6
8943,8943,8944,2,6,4
8944,8944,8945,6,4,-2
8945,8945,8946,4,3,-1
8946,8946,8947,3,4,1
8947,8947,8948,4,5,1
8948,8948,8949,5,9,4
8949,8949,8950,9,2,-7
8950,8950,8951,2,0,-2
8951,8951,8952,0,3,3
8952,8952,8953,3,9,6
8953,8953,8954,9,4,-5
8954,8954,8955,4,9,5
8955,8955,8956,9,7,-2
8956,8956,8957,7,3,-4
8957,8957,8958,3,8,5
8958,8958,8959,8,7,-1
8959,8959,8960,7,4,-3
8960,8960,8961,4,4,0
8961,8961,8962,4,9,5
8962,8962,8963,9,8,-1
8963,8963,8964,8,5,-3
8964,8964,8965,5,8,3
8965,8965,8966,8,2,-6
8966,8966,8967,2,6,4
8967,8967,8968,6,6,0
8968,8968,8969,6,2,-4
8969,8969,8970,2,3,1
8970,8970,8971,3,1,-2
8971,8971,8972,1,3,2
8972,8972,8973,3,2,-1
8973,8973,8974,2,7,5
8974,8974,8975,7,3,-4
8975,8975,8976,3,1,-2
8976,8976,8977,1,9,8
8977,8977,8978,9,0,-9
8978,8978,8979,0,1,1
8979,8979,8980,1,1,0
8980,8980,8981,1,3,2
8981,8981,8982,3,5,2
8982,8982,8983,5,0,-5
8983,8983,8984,0,7,7
8984,8984,8985,7,8,1
8985,8985,8986,8,1,-7
8986,8986,8987,1,5,4
8987,8987,8988,5,1,-4
8988,8988,8989,1,4,3
8989,8989,8990,4,6,2
8990,8990,8991,6,0,-6
8991,8991,8992,0,0,0
8992,8992,8993,0,4,4
8993,8993,8994,4,9,5
8994,8994,8995,9,1,-8
8995,8995,8996,1,6,5
8996,8996,8997,6,6,0
8997,8997,8998,6,9,3
8998,8998,8999,9,0,-9
8999,8999,9000,0,7,7
9000,9000,9001,7,6,-1
9001,9001,9002,6,1,-5
9002,9002,9003,1,1,0
9003,9003,9004,1,0,-1
9004,9004,9005,0,1,1
9005,9005,9006,1,2,1
9006,9006,9007,2,3,1
9007,9007,9008,3,4,1
9008,9008,9009,4,7,3
9009,9009,9010,7,2,-5
9010,9010,9011,2,3,1
9011,9011,9012,3,4,1
9012,9012,9013,4,5,1
9013,9013,9014,5,6,1
9014,9014,9015,6,7,1
9015,9015,9016,7,0,-7
9016,9016,9017,0,1,1
9017,9017,9018,1,2,1
9018,9018,9019,2,7,5
9019,9019,9020,7,8,1
9020,9020,9021,8,6,-2
9021,9021,9022,6,3,-3
9022,9022,9023,3,9,6
9023,9023,9024,9,7,-2
9024,9024,9025,7,1,-6
9025,9025,9026,1,9,8
9026,9026,9027,9,3,-6
9027,9027,9028,3,9,6
9028,9028,9029,9,6,-3
9029,9029,9030,6,1,-5
9030,9030,9031,1,7,6
9031,9031,9032,7,2,-5
9032,9032,9033,2,4,2
9033,9033,9034,4,4,0
9034,9034,9035,4,5,1
9035,9035,9036,5,7,2
9036,9036,9037,7,0,-7
9037,9037,9038,0,0,0
9038,9038,9039,0,1,1
9039,9039,9040,1,6,5
9040,9040,9041,6,6,0
9041,9041,9042,6,8,2
9042,9042,9043,8,2,-6
9043,9043,9044,2,7,5
9044,9044,9045,7,7,0
9045,9045,9046,7,2,-5
9046,9046,9047,2,4,2
9047,9047,9048,4,2,-2
9048,9048,9049,2,1,-1
9049,9049,9050,1,6,5
9050,9050,9051,6,1,-5
9051,9051,9052,1,0,-1
9052,9052,9053,0,6,6
9053,9053,9054,6,9,3
9054,9054,9055,9,8,-1
9055,9055,9056,8,3,-5
9056,9056,9057,3,9,6
9057,9057,9058,9,6,-3
9058,9058,9059,6,3,-3
9059,9059,9060,3,0,-3
9060,9060,9061,0,1,1
9061,9061,9062,1,2,1
9062,9062,9063,2,3,1
9063,9063,9064,3,4,1
9064,9064,9065,4,5,1
9065,9065,9066,5,6,1
9066,9066,9067,6,7,1
9067,9067,9068,7,8,1
9068,9068,9069,8,9,1
9069,9069,9070,9,0,-9
9070,9070,9071,0,1,1
9071,9071,9072,1,2,1
9072,9072,9073,2,3,1
9073,9073,9074,3,4,1
9074,9074,9075,4,5,1
9075,9075,9076,5,6,1
9076,9076,9077,6,7,1
9077,9077,9078,7,8,1
9078,9078,9079,8,9,1
9079,9079,9080,9,0,-9
9080,9080,9081,0,1,1
9081,9081,9082,1,2,1
9082,9082,9083,2,3,1
9083,9083,9084,3,4,1
9084,9084,9085,4,5,1
9085,9085,9086,5,6,1
9086,9086,9087,6,7,1
9087,9087,9088,7,8,1
9088,9088,9089,8,9,1
9089,9089,9090,9,1,-8
9090,9090,9091,1,6,5
9091,9091,9092,6,8,2
9092,9092,9093,8,9,1
9093,9093,9094,9,9,0
9094,9094,9095,9,0,-9
9095,9095,9096,0,1,1
9096,9096,9097,1,2,1
9097,9097,9098,2,4,2
9098,9098,9099,4,4,0
9099,9099,9100,4,3,-1
9100,9100,9101,3,7,4
9101,9101,9102,7,4,-3
9102,9102,9103,4,4,0
9103,9103,9104,4,4,0
9104,9104,9105,4,0,-4
9105,9105,9106,0,3,3
9106,9106,9107,3,8,5
9107,9107,9108,8,7,-1
9108,9108,9109,7,5,-2
9109,9109,9110,5,8,3
9110,9110,9111,8,2,-6
9111,9111,9112,2,1,-1
9112,9112,9113,1,7,6
9113,9113,9114,7,5,-2
9114,9114,9115,5,3,-2
9115,9115,9116,3,8,5
9116,9116,9117,8,5,-3
9117,9117,9118,5,2,-3
9118,9118,9119,2,5,3
9119,9119,9120,5,1,-4
9120,9120,9121,1,1,0
9121,9121,9122,1,6,5
9122,9122,9123,6,2,-4
9123,9123,9124,2,1,-1
9124,9124,9125,1,3,2
9125,9125,9126,3,8,5
9126,9126,9127,8,6,-2
9127,9127,9128,6,4,-2
9128,9128,9129,4,2,-2
9129,9129,9130,2,6,4
9130,9130,9131,6,2,-4
9131,9131,9132,2,5,3
9132,9132,9133,5,5,0
9133,9133,9134,5,0,-5
9134,9134,9135,0,2,2
9135,9135,9136,2,8,6
9136,9136,9137,8,0,-8
9137,9137,9138,0,6,6
9138,9138,9139,6,8,2
9139,9139,9140,8,1,-7
9140,9140,9141,1,7,6
9141,9141,9142,7,9,2
9142,9142,9143,9,1,-8
9143,9143,9144,1,9,8
9144,9144,9145,9,2,-7
9145,9145,9146,2,6,4
9146,9146,9147,6,7,1
9147,9147,9148,7,6,-1
9148,9148,9149,6,6,0
9149,9149,9150,6,8,2
9150,9150,9151,8,7,-1
9151,9151,9152,7,4,-3
9152,9152,9153,4,9,5
9153,9153,9154,9,2,-7
9154,9154,9155,2,1,-1
9155,9155,9156,1,3,2
9156,9156,9157,3,3,0
9157,9157,9158,3,0,-3
9158,9158,9159,0,5,5
9159,9159,9160,5,5,0
9160,9160,9161,5,8,3
9161,9161,9162,8,0,-8
9162,9162,9163,0,3,3
9163,9163,9164,3,7,4
9164,9164,9165,7,9,2
9165,9165,9166,9,7,-2
9166,9166,9167,7,0,-7
9167,9167,9168,0,2,2
9168,9168,9169,2,7,5
9169,9169,9170,7,9,2
9170,9170,9171,9,1,-8
9171,9171,9172,1,7,6
9172,9172,9173,7,8,1
9173,9173,9174,8,0,-8
9174,9174,9175,0,3,3
9175,9175,9176,3,5,2
9176,9176,9177,5,3,-2
9177,9177,9178,3,6,3
9178,9178,9179,6,0,-6
9179,9179,9180,0,1,1
9180,9180,9181,1,2,1
9181,9181,9182,2,3,1
9182,9182,9183,3,4,1
9183,9183,9184,4,5,1
9184,9184,9185,5,6,1
9185,9185,9186,6,7,1
9186,9186,9187,7,8,1
9187,9187,9188,8,9,1
9188,9188,9189,9,0,-9
9189,9189,9190,0,1,1
9190,9190,9191,1,2,1
9191,9191,9192,2,3,1
9192,9192,9193,3,4,1
9193,9193,9194,4,5,1
9194,9194,9195,5,6,1
9195,9195,9196,6,7,1
9196,9196,9197,7,8,1
9197,9197,9198,8,9,1
9198,9198,9199,9,0,-9
9199,9199,9200,0,1,1
9200,9200,9201,1,2,1
9201,9201,9202,2,3,1
9202,9202,9203,3,4,1
9203,9203,9204,4,7,3
9204,9204,9205,7,8,1
9205,9205,9206,8,9,1
9206,9206,9207,9,6,-3
9207,9207,9208,6,4,-2
9208,9208,9209,4,2,-2
9209,9209,9210,2,6,4
9210,9210,9211,6,4,-2
9211,9211,9212,4,7,3
9212,9212,9213,7,8,1
9213,9213,9214,8,9,1
9214,9214,9215,9,2,-7
9215,9215,9216,2,9,7
9216,9216,9217,9,3,-6
9217,9217,9218,3,9,6
9218,9218,9219,9,3,-6
9219,9219,9220,3,0,-3
9220,9220,9221,0,0,0
9221,9221,9222,0,1,1
9222,9222,9223,1,0,-1
9223,9223,9224,0,4,4
9224,9224,9225,4,2,-2
9225,9225,9226,2,6,4
9226,9226,9227,6,3,-3
9227,9227,9228,3,5,2
9228,9228,9229,5,3,-2
9229,9229,9230,3,0,-3
9230,9230,9231,0,3,3
9231,9231,9232,3,4,1
9232,9232,9233,4,1,-3
9233,9233,9234,1,5,4
9234,9234,9235,5,3,-2
9235,9235,9236,3,0,-3
9236,9236,9237,0,8,8
9237,9237,9238,8,3,-5
9238,9238,9239,3,0,-3
9239,9239,9240,0,6,6
9240,9240,9241,6,1,-5
9241,9241,9242,1,7,6
9242,9242,9243,7,8,1
9243,9243,9244,8,0,-8
9244,9244,9245,0,9,9
9245,9245,9246,9,2,-7
9246,9246,9247,2,6,4
9247,9247,9248,6,7,1
9248,9248,9249,7,1,-6
9249,9249,9250,1,9,8
9250,9250,9251,9,6,-3
9251,9251,9252,6,9,3
9252,9252,9253,9,4,-5
9253,9253,9254,4,9,5
9254,9254,9255,9,9,0
9255,9255,9256,9,6,-3
9256,9256,9257,6,7,1
9257,9257,9258,7,1,-6
9258,9258,9259,1,2,1
9259,9259,9260,2,5,3
9260,9260,9261,5,3,-2
9261,9261,9262,3,7,4
9262,9262,9263,7,8,1
9263,9263,9264,8,0,-8
9264,9264,9265,0,1,1
9265,9265,9266,1,2,1
9266,9266,9267,2,4,2
9267,9267,9268,4,5,1
9268,9268,9269,5,6,1
9269,9269,9270,6,7,1
9270,9270,9271,7,8,1
9271,9271,9272,8,9,1
9272,9272,9273,9,0,-9
9273,9273,9274,0,1,1
9274,9274,9275,1,3,2
9275,9275,9276,3,4,1
9276,9276,9277,4,5,1
9277,9277,9278,5,6,1
9278,9278,9279,6,7,1
9279,9279,9280,7,8,1
9280,9280,9281,8,0,-8
9281,9281,9282,0,1,1
9282,9282,9283,1,3,2
9283,9283,9284,3,4,1
9284,9284,9285,4,7,3
9285,9285,9286,7,8,1
9286,9286,9287,8,9,1
9287,9287,9288,9,7,-2
9288,9288,9289,7,5,-2
9289,9289,9290,5,5,0
9290,9290,9291,5,1,-4
9291,9291,9292,1,9,8
9292,9292,9293,9,9,0
9293,9293,9294,9,7,-2
9294,9294,9295,7,1,-6
9295,9295,9296,1,0,-1
9296,9296,9297,0,0,0
9297,9297,9298,0,5,5
9298,9298,9299,5,9,4
9299,9299,9300,9,7,-2
9300,9300,9301,7,1,-6
9301,9301,9302,1,7,6
9302,9302,9303,7,2,-5
9303,9303,9304,2,2,0
9304,9304,9305,2,3,1
9305,9305,9306,3,6,3
9306,9306,9307,6,8,2
9307,9307,9308,8,3,-5
9308,9308,9309,3,2,-1
9309,9309,9310,2,0,-2
9310,9310,9311,0,0,0
9311,9311,9312,0,6,6
9312,9312,9313,6,1,-5
9313,9313,9314,1,7,6
9314,9314,9315,7,5,-2
9315,9315,9316,5,8,3
9316,9316,9317,8,6,-2
9317,9317,9318,6,2,-4
9318,9318,9319,2,9,7
9319,9319,9320,9,4,-5
9320,9320,9321,4,8,4
9321,9321,9322,8,8,0
9322,9322,9323,8,7,-1
9323,9323,9324,7,1,-6
9324,9324,9325,1,0,-1
9325,9325,9326,0,8,8
9326,9326,9327,8,7,-1
9327,9327,9328,7,7,0
9328,9328,9329,7,5,-2
9329,9329,9330,5,8,3
9330,9330,9331,8,5,-3
9331,9331,9332,5,3,-2
9332,9332,9333,3,4,1
9333,9333,9334,4,6,2
9334,9334,9335,6,1,-5
9335,9335,9336,1,1,0
9336,9336,9337,1,5,4
9337,9337,9338,5,5,0
9338,9338,9339,5,0,-5
9339,9339,9340,0,7,7
9340,9340,9341,7,2,-5
9341,9341,9342,2,3,1
9342,9342,9343,3,6,3
9343,9343,9344,6,4,-2
9344,9344,9345,4,1,-3
9345,9345,9346,1,2,1
9346,9346,9347,2,4,2
9347,9347,9348,4,1,-3
9348,9348,9349,1,5,4
9349,9349,9350,5,4,-1
9350,9350,9351,4,2,-2
9351,9351,9352,2,0,-2
9352,9352,9353,0,4,4
9353,9353,9354,4,8,4
9354,9354,9355,8,6,-2
9355,9355,9356,6,1,-5
9356,9356,9357,1,9,8
9357,9357,9358,9,0,-9
9358,9358,9359,0,2,2
9359,9359,9360,2,5,3
9360,9360,9361,5,6,1
9361,9361,9362,6,9,3
9362,9362,9363,9,3,-6
9363,9363,9364,3,6,3
9364,9364,9365,6,3,-3
9365,9365,9366,3,6,3
9366,9366,9367,6,0,-6
9367,9367,9368,0,1,1
9368,9368,9369,1,2,1
9369,9369,9370,2,3,1
9370,9370,9371,3,4,1
9371,9371,9372,4,5,1
9372,9372,9373,5,6,1
9373,9373,9374,6,7,1
9374,9374,9375,7,8,1
9375,9375,9376,8,9,1
9376,9376,9377,9,0,-9
9377,9377,9378,0,1,1
9378,9378,9379,1,2,1
9379,9379,9380,2,3,1
9380,9380,9381,3,4,1
9381,9381,9382,4,5,1
9382,9382,9383,5,6,1
9383,9383,9384,6,7,1
9384,9384,9385,7,8,1
9385,9385,9386,8,9,1
9386,9386,9387,9,0,-9
9387,9387,9388,0,1,1
9388,9388,9389,1,2,1
9389,9389,9390,2,3,1
9390,9390,9391,3,5,2
9391,9391,9392,5,6,1
9392,9392,9393,6,7,1
9393,9393,9394,7,8,1
9394,9394,9395,8,1,-7
9395,9395,9396,1,0,-1
9396,9396,9397,0,9,9
9397,9397,9398,9,5,-4
9398,9398,9399,5,7,2
9399,9399,9400,7,5,-2
9400,9400,9401,5,1,-4
9401,9401,9402,1,8,7
9402,9402,9403,8,6,-2
9403,9403,9404,6,9,3
9404,9404,9405,9,0,-9
9405,9405,9406,0,4,4
9406,9406,9407,4,1,-3
9407,9407,9408,1,9,8
9408,9408,9409,9,3,-6
9409,9409,9410,3,8,5
9410,9410,9411,8,4,-4
9411,9411,9412,4,4,0
9412,9412,9413,4,7,3
9413,9413,9414,7,0,-7
9414,9414,9415,0,1,1
9415,9415,9416,1,9,8
9416,9416,9417,9,2,-7
9417,9417,9418,2,8,6
9418,9418,9419,8,7,-1
9419,9419,9420,7,8,1
9420,9420,9421,8,2,-6
9421,9421,9422,2,5,3
9422,9422,9423,5,9,4
9423,9423,9424,9,6,-3
9424,9424,9425,6,0,-6
9425,9425,9426,0,6,6
9426,9426,9427,6,5,-1
9427,9427,9428,5,5,0
9428,9428,9429,5,3,-2
9429,9429,9430,3,3,0
9430,9430,9431,3,3,0
9431,9431,9432,3,9,6
9432,9432,9433,9,8,-1
9433,9433,9434,8,1,-7
9434,9434,9435,1,1,0
9435,9435,9436,1,0,-1
9436,9436,9437,0,6,6
9437,9437,9438,6,1,-5
9438,9438,9439,1,0,-1
9439,9439,9440,0,0,0
9440,9440,9441,0,6,6
9441,9441,9442,6,2,-4
9442,9442,9443,2,1,-1
9443,9443,9444,1,1,0
9444,9444,9445,1,3,2
9445,9445,9446,3,2,-1
9446,9446,9447,2,7,5
9447,9447,9448,7,7,0
9448,9448,9449,7,8,1
9449,9449,9450,8,8,0
9450,9450,9451,8,7,-1
9451,9451,9452,7,8,1
9452,9452,9453,8,4,-4
9453,9453,9454,4,6,2
9454,9454,9455,6,0,-6
9455,9455,9456,0,2,2
9456,9456,9457,2,0,-2
9457,9457,9458,0,7,7
9458,9458,9459,7,0,-7
9459,9459,9460,0,3,3
9460,9460,9461,3,6,3
9461,9461,9462,6,8,2
9462,9462,9463,8,7,-1
9463,9463,9464,7,1,-6
9464,9464,9465,1,5,4
9465,9465,9466,5,9,4
9466,9466,9467,9,9,0
9467,9467,9468,9,3,-6
9468,9468,9469,3,7,4
9469,9469,9470,7,2,-5
9470,9470,9471,2,4,2
9471,9471,9472,4,9,5
9472,9472,9473,9,4,-5
9473,9473,9474,4,3,-1
9474,9474,9475,3,6,3
9475,9475,9476,6,2,-4
9476,9476,9477,2,2,0
9477,9477,9478,2,5,3
9478,9478,9479,5,3,-2
9479,9479,9480,3,2,-1
9480,9480,9481,2,5,3
9481,9481,9482,5,5,0
9482,9482,9483,5,9,4
9483,9483,9484,9,4,-5
9484,9484,9485,4,1,-3
9485,9485,9486,1,7,6
9486,9486,9487,7,2,-5
9487,9487,9488,2,0,-2
9488,9488,9489,0,1,1
9489,9489,9490,1,2,1
9490,9490,9491,2,3,1
9491,9491,9492,3,4,1
9492,9492,9493,4,5,1
9493,9493,9494,5,6,1
9494,9494,9495,6,7,1
9495,9495,9496,7,8,1
9496,9496,9497,8,9,1
9497,9497,9498,9,0,-9
9498,9498,9499,0,1,1
9499,9499,9500,1,2,1
9500,9500,9501,2,3,1
9501,9501,9502,3,4,1
9502,9502,9503,4,5,1
9503,9503,9504,5,6,1
9504,9504,9505,6,7,1
9505,9505,9506,7,8,1
9506,9506,9507,8,9,1
9507,9507,9508,9,0,-9
9508,9508,9509,0,1,1
9509,9509,9510,1,2,1
9510,9510,9511,2,3,1
9511,9511,9512,3,4,1
9512,9512,9513,4,5,1
9513,9513,9514,5,6,1
9514,9514,9515,6,7,1
9515,9515,9516,7,8,1
9516,9516,9517,8,9,1
9517,9517,9518,9,1,-8
9518,9518,9519,1,0,-1
9519,9519,9520,0,1,1
9520,9520,9521,1,2,1
9521,9521,9522,2,7,5
9522,9522,9523,7,5,-2
9523,9523,9524,5,3,-2
9524,9524,9525,3,4,1
9525,9525,9526,4,4,0
9526,9526,9527,4,0,-4
9527,9527,9528,0,0,0
9528,9528,9529,0,6,6
9529,9529,9530,6,9,3
9530,9530,9531,9,6,-3
9531,9531,9532,6,6,0
9532,9532,9533,6,5,-1
9533,9533,9534,5,7,2
9534,9534,9535,7,2,-5
9535,9535,9536,2,3,1
9536,9536,9537,3,4,1
9537,9537,9538,4,4,0
9538,9538,9539,4,9,5
9539,9539,9540,9,1,-8
9540,9540,9541,1,4,3
9541,9541,9542,4,0,-4
9542,9542,9543,0,7,7
9543,9543,9544,7,9,2
9544,9544,9545,9,5,-4
9545,9545,9546,5,7,2
9546,9546,9547,7,2,-5
9547,9547,9548,2,3,1
9548,9548,9549,3,1,-2
9549,9549,9550,1,4,3
9550,9550,9551,4,4,0
9551,9551,9552,4,0,-4
9552,9552,9553,0,9,9
9553,9553,9554,9,9,0
9554,9554,9555,9,6,-3
9555,9555,9556,6,1,-5
9556,9556,9557,1,8,7
9557,9557,9558,8,3,-5
9558,9558,9559,3,3,0
9559,9559,9560,3,7,4
9560,9560,9561,7,3,-4
9561,9561,9562,3,9,6
9562,9562,9563,9,8,-1
9563,9563,9564,8,8,0
9564,9564,9565,8,4,-4
9565,9565,9566,4,7,3
9566,9566,9567,7,7,0
9567,9567,9568,7,6,-1
9568,9568,9569,6,2,-4
9569,9569,9570,2,1,-1
9570,9570,9571,1,9,8
9571,9571,9572,9,8,-1
9572,9572,9573,8,7,-1
9573,9573,9574,7,8,1
9574,9574,9575,8,8,0
9575,9575,9576,8,7,-1
9576,9576,9577,7,2,-5
9577,9577,9578,2,2,0
9578,9578,9579,2,3,1
9579,9579,9580,3,9,6
9580,9580,9581,9,3,-6
9581,9581,9582,3,3,0
9582,9582,9583,3,5,2
9583,9583,9584,5,5,0
9584,9584,9585,5,0,-5
9585,9585,9586,0,7,7
9586,9586,9587,7,9,2
9587,9587,9588,9,5,-4
9588,9588,9589,5,6,1
9589,9589,9590,6,5,-1
9590,9590,9591,5,1,-4
9591,9591,9592,1,4,3
9592,9592,9593,4,1,-3
9593,9593,9594,1,1,0
9594,9594,9595,1,2,1
9595,9595,9596,2,8,6
9596,9596,9597,8,2,-6
9597,9597,9598,2,6,4
9598,9598,9599,6,1,-5
9599,9599,9600,1,5,4
9600,9600,9601,5,0,-5
9601,9601,9602,0,1,1
9602,9602,9603,1,2,1
9603,9603,9604,2,3,1
9604,9604,9605,3,4,1
9605,9605,9606,4,5,1
9606,9606,9607,5,6,1
9607,9607,9608,6,7,1
9608,9608,9609,7,8,1
9609,9609,9610,8,9,1
9610,9610,9611,9,0,-9
9611,9611,9612,0,1,1
9612,9612,9613,1,2,1
9613,9613,9614,2,3,1
9614,9614,9615,3,4,1
9615,9615,9616,4,5,1
9616,9616,9617,5,6,1
9617,9617,9618,6,7,1
9618,9618,9619,7,8,1
9619,9619,9620,8,9,1
9620,9620,9621,9,0,-9
9621,9621,9622,0,1,1
9622,9622,9623,1,2,1
9623,9623,9624,2,3,1
9624,9624,9625,3,4,1
9625,9625,9626,4,5,1
9626,9626,9627,5,6,1
9627,9627,9628,6,7,1
9628,9628,9629,7,8,1
9629,9629,9630,8,8,0
9630,9630,9631,8,0,-8
9631,9631,9632,0,6,6
9632,9632,9633,6,0,-6
9633,9633,9634,0,0,0
9634,9634,9635,0,2,2
9635,9635,9636,2,3,1
9636,9636,9637,3,7,4
9637,9637,9638,7,9,2
9638,9638,9639,9,4,-5
9639,9639,9640,4,7,3
9640,9640,9641,7,1,-6
9641,9641,9642,1,9,8
9642,9642,9643,9,1,-8
9643,9643,9644,1,7,6
9644,9644,9645,7,1,-6
9645,9645,9646,1,4,3
9646,9646,9647,4,0,-4
9647,9647,9648,0,0,0
9648,9648,9649,0,1,1
9649,9649,9650,1,7,6
9650,9650,9651,7,5,-2
9651,9651,9652,5,7,2
9652,9652,9653,7,1,-6
9653,9653,9654,1,3,2
9654,9654,9655,3,3,0
9655,9655,9656,3,3,0
9656,9656,9657,3,1,-2
9657,9657,9658,1,6,5
9658,9658,9659,6,9,3
9659,9659,9660,9,7,-2
9660,9660,9661,7,1,-6
9661,9661,9662,1,3,2
9662,9662,9663,3,0,-3
9663,9663,9664,0,2,2
9664,9664,9665,2,6,4
9665,9665,9666,6,0,-6
9666,9666,9667,0,8,8
9667,9667,9668,8,9,1
9668,9668,9669,9,4,-5
9669,9669,9670,4,3,-1
9670,9670,9671,3,5,2
9671,9671,9672,5,4,-1
9672,9672,9673,4,8,4
9673,9673,9674,8,1,-7
9674,9674,9675,1,5,4
9675,9675,9676,5,9,4
9676,9676,9677,9,0,-9
9677,9677,9678,0,6,6
9678,9678,9679,6,6,0
9679,9679,9680,6,3,-3
9680,9680,9681,3,8,5
9681,9681,9682,8,1,-7
9682,9682,9683,1,4,3
9683,9683,9684,4,7,3
9684,9684,9685,7,5,-2
9685,9685,9686,5,2,-3
9686,9686,9687,2,0,-2
9687,9687,9688,0,0,0
9688,9688,9689,0,1,1
9689,9689,9690,1,7,6
9690,9690,9691,7,8,1
9691,9691,9692,8,9,1
9692,9692,9693,9,6,-3
9693,9693,9694,6,8,2
9694,9694,9695,8,8,0
9695,9695,9696,8,2,-6
9696,9696,9697,2,3,1
9697,9697,9698,3,6,3
9698,9698,9699,6,1,-5
9699,9699,9700,1,2,1
9700,9700,9701,2,9,7
9701,9701,9702,9,5,-4
9702,9702,9703,5,2,-3
9703,9703,9704,2,0,-2
9704,9704,9705,0,1,1
9705,9705,9706,1,2,1
9706,9706,9707,2,3,1
9707,9707,9708,3,4,1
9708,9708,9709,4,5,1
9709,9709,9710,5,6,1
9710,9710,9711,6,7,1
9711,9711,9712,7,8,1
9712,9712,9713,8,9,1
9713,9713,9714,9,0,-9
9714,9714,9715,0,1,1
9715,9715,9716,1,2,1
9716,9716,9717,2,3,1
9717,9717,9718,3,4,1
9718,9718,9719,4,5,1
9719,9719,9720,5,6,1
9720,9720,9721,6,7,1
9721,9721,9722,7,8,1
9722,9722,9723,8,9,1
9723,9723,9724,9,0,-9
9724,9724,9725,0,1,1
9725,9725,9726,1,2,1
9726,9726,9727,2,3,1
9727,9727,9728,3,4,1
9728,9728,9729,4,5,1
9729,9729,9730,5,6,1
9730,9730,9731,6,7,1
9731,9731,9732,7,8,1
9732,9732,9733,8,9,1
9733,9733,9734,9,7,-2
9734,9734,9735,7,4,-3
9735,9735,9736,4,6,2
9736,9736,9737,6,1,-5
9737,9737,9738,1,4,3
9738,9738,9739,4,0,-4
9739,9739,9740,0,9,9
9740,9740,9741,9,9,0
9741,9741,9742,9,3,-6
9742,9742,9743,3,7,4
9743,9743,9744,7,8,1
9744,9744,9745,8,4,-4
9745,9745,9746,4,7,3
9746,9746,9747,7,5,-2
9747,9747,9748,5,8,3
9748,9748,9749,8,5,-3
9749,9749,9750,5,3,-2
9750,9750,9751,3,2,-1
9751,9751,9752,2,2,0
9752,9752,9753,2,0,-2
9753,9753,9754,0,5,5
9754,9754,9755,5,8,3
9755,9755,9756,8,6,-2
9756,9756,9757,6,0,-6
9757,9757,9758,0,3,3
9758,9758,9759,3,8,5
9759,9759,9760,8,1,-7
9760,9760,9761,1,0,-1
9761,9761,9762,0,3,3
9762,9762,9763,3,0,-3
9763,9763,9764,0,4,4
9764,9764,9765,4,7,3
9765,9765,9766,7,4,-3
9766,9766,9767,4,9,5
9767,9767,9768,9,2,-7
9768,9768,9769,2,9,7
9769,9769,9770,9,5,-4
9770,9770,9771,5,7,2
9771,9771,9772,7,1,-6
9772,9772,9773,1,7,6
9773,9773,9774,7,1,-6
9774,9774,9775,1,6,5
9775,9775,9776,6,6,0
9776,9776,9777,6,5,-1
9777,9777,9778,5,6,1
9778,9778,9779,6,2,-4
9779,9779,9780,2,8,6
9780,9780,9781,8,7,-1
9781,9781,9782,7,6,-1
9782,9782,9783,6,4,-2
9783,9783,9784,4,9,5
9784,9784,9785,9,9,0
9785,9785,9786,9,5,-4
9786,9786,9787,5,3,-2
9787,9787,9788,3,7,4
9788,9788,9789,7,4,-3
9789,9789,9790,4,3,-1
9790,9790,9791,3,0,-3
9791,9791,9792,0,4,4
9792,9792,9793,4,6,2
9793,9793,9794,6,6,0
9794,9794,9795,6,1,-5
9795,9795,9796,1,1,0
9796,9796,9797,1,3,2
9797,9797,9798,3,2,-1
9798,9798,9799,2,1,-1
9799,9799,9800,1,0,-1
9800,9800,9801,0,0,0
9801,9801,9802,0,1,1
9802,9802,9803,1,2,1
9803,9803,9804,2,3,1
9804,9804,9805,3,4,1
9805,9805,9806,4,7,3
9806,9806,9807,7,8,1
9807,9807,9808,8,9,1
9808,9808,9809,9,0,-9
9809,9809,9810,0,1,1
9810,9810,9811,1,2,1
9811,9811,9812,2,3,1
9812,9812,9813,3,4,1
9813,9813,9814,4,5,1
9814,9814,9815,5,6,1
9815,9815,9816,6,7,1
9816,9816,9817,7,8,1
9817,9817,9818,8,0,-8
9818,9818,9819,0,1,1
9819,9819,9820,1,2,1
9820,9820,9821,2,3,1
9821,9821,9822,3,4,1
9822,9822,9823,4,7,3
9823,9823,9824,7,8,1
9824,9824,9825,8,9,1
9825,9825,9826,9,0,-9
9826,9826,9827,0,8,8
9827,9827,9828,8,3,-5
9828,9828,9829,3,9,6
9829,9829,9830,9,5,-4
9830,9830,9831,5,5,0
9831,9831,9832,5,2,-3
9832,9832,9833,2,6,4
9833,9833,9834,6,8,2
9834,9834,9835,8,4,-4
9835,9835,9836,4,1,-3
9836,9836,9837,1,7,6
9837,9837,9838,7,1,-6
9838,9838,9839,1,2,1
9839,9839,9840,2,3,1
9840,9840,9841,3,5,2
9841,9841,9842,5,6,1
9842,9842,9843,6,9,3
9843,9843,9844,9,1,-8
9844,9844,9845,1,1,0
9845,9845,9846,1,1,0
9846,9846,9847,1,2,1
9847,9847,9848,2,1,-1
9848,9848,9849,1,2,1
9849,9849,9850,2,0,-2
9850,9850,9851,0,7,7
9851,9851,9852,7,7,0
9852,9852,9853,7,5,-2
9853,9853,9854,5,8,3
9854,9854,9855,8,2,-6
9855,9855,9856,2,9,7
9856,9856,9857,9,8,-1
9857,9857,9858,8,6,-2
9858,9858,9859,6,7,1
9859,9859,9860,7,3,-4
9860,9860,9861,3,4,1
9861,9861,9862,4,6,2
9862,9862,9863,6,8,2
9863,9863,9864,8,7,-1
9864,9864,9865,7,0,-7
9865,9865,9866,0,4,4
9866,9866,9867,4,2,-2
9867,9867,9868,2,7,5
9868,9868,9869,7,7,0
9869,9869,9870,7,5,-2
9870,9870,9871,5,4,-1
9871,9871,9872,4,3,-1
9872,9872,9873,3,4,1
9873,9873,9874,4,2,-2
9874,9874,9875,2,8,6
9875,9875,9876,8,1,-7
9876,9876,9877,1,5,4
9877,9877,9878,5,1,-4
9878,9878,9879,1,0,-1
9879,9879,9880,0,2,2
9880,9880,9881,2,3,1
9881,9881,9882,3,3,0
9882,9882,9883,3,5,2
9883,9883,9884,5,7,2
9884,9884,9885,7,0,-7
9885,9885,9886,0,6,6
9886,9886,9887,6,8,2
9887,9887,9888,8,6,-2
9888,9888,9889,6,3,-3
9889,9889,9890,3,9,6
9890,9890,9891,9,9,0
9891,9891,9892,9,8,-1
9892,9892,9893,8,2,-6
9893,9893,9894,2,7,5
9894,9894,9895,7,7,0
9895,9895,9896,7,1,-6
9896,9896,9897,1,0,-1
9897,9897,9898,0,1,1
9898,9898,9899,1,7,6
9899,9899,9900,7,8,1
9900,9900,9901,8,9,1
9901,9901,9902,9,0,-9
9902,9902,9903,0,1,1
9903,9903,9904,1,2,1
9904,9904,9905,2,3,1
9905,9905,9906,3,4,1
9906,9906,9907,4,5,1
9907,9907,9908,5,6,1
9908,9908,9909,6,7,1
9909,9909,9910,7,8,1
9910,9910,9911,8,0,-8
9911,9911,9912,0,1,1
9912,9912,9913,1,2,1
9913,9913,9914,2,3,1
9914,9914,9915,3,4,1
9915,9915,9916,4,7,3
9916,9916,9917,7,8,1
9917,9917,9918,8,9,1
9918,9918,9919,9,7,-2
9919,9919,9920,7,8,1
9920,9920,9921,8,6,-2
9921,9921,9922,6,4,-2
9922,9922,9923,4,1,-3
9923,9923,9924,1,9,8
9924,9924,9925,9,3,-6
9925,9925,9926,3,8,5
9926,9926,9927,8,4,-4
9927,9927,9928,4,4,0
9928,9928,9929,4,7,3
9929,9929,9930,7,0,-7
9930,9930,9931,0,1,1
9931,9931,9932,1,9,8
9932,9932,9933,9,2,-7
9933,9933,9934,2,8,6
9934,9934,9935,8,7,-1
9935,9935,9936,7,8,1
9936,9936,9937,8,2,-6
9937,9937,9938,2,6,4
9938,9938,9939,6,0,-6
9939,9939,9940,0,6,6
9940,9940,9941,6,5,-1
9941,9941,9942,5,3,-2
9942,9942,9943,3,3,0
9943,9943,9944,3,3,0
9944,9944,9945,3,9,6
9945,9945,9946,9,1,-8
9946,9946,9947,1,4,3
9947,9947,9948,4,0,-4
9948,9948,9949,0,6,6
9949,9949,9950,6,1,-5
9950,9950,9951,1,0,-1
9951,9951,9952,0,0,0
9952,9952,9953,0,6,6
9953,9953,9954,6,2,-4
9954,9954,9955,2,1,-1
9955,9955,9956,1,1,0
9956,9956,9957,1,7,6
9957,9957,9958,7,7,0
9958,9958,9959,7,8,1
9959,9959,9960,8,4,-4
9960,9960,9961,4,6,2
9961,9961,9962,6,0,-6
9962,9962,9963,0,7,7
9963,9963,9964,7,0,-7
9964,9964,9965,0,3,3
9965,9965,9966,3,6,3
9966,9966,9967,6,8,2
9967,9967,9968,8,7,-1
9968,9968,9969,7,1,-6
9969,9969,9970,1,5,4
9970,9970,9971,5,2,-3
9971,9971,9972,2,4,2
9972,9972,9973,4,9,5
9973,9973,9974,9,4,-5
9974,9974,9975,4,3,-1
9975,9975,9976,3,6,3
9976,9976,9977,6,4,-2
9977,9977,9978,4,1,-3
9978,9978,9979,1,7,6
9979,9979,9980,7,2,-5
9980,9980,9981,2,6,4
9981,9981,9982,6,5,-1
9982,9982,9983,5,0,-5
9983,9983,9984,0,1,1
9984,9984,9985,1,2,1
9985,9985,9986,2,3,1
9986,9986,9987,3,4,1
9987,9987,9988,4,5,1
9988,9988,9989,5,6,1
9989,9989,9990,6,7,1
9990,9990,9991,7,8,1
9991,9991,9992,8,9,1
9992,9992,9993,9,0,-9
9993,9993,9994,0,1,1
9994,9994,9995,1,2,1
9995,9995,9996,2,3,1
9996,9996,9997,3,4,1
9997,9997,9998,4,5,1
9998,9998,9999,5,6,1
